,Output,ID,Sequences,A,U,G,C,length
0,1,ABEF01007799.1/1141-1268,CACCAGCAUCAGGAGCGACCCAUUAGGGUCCGGCAACCUAGCAACGGAGAUAGCUAAGGUGCCUUGAGAGUGAACAAUCAUUCUCGAUGUGCGGGUUCCAGUUGAGCCCGAAACAGAAACUCCGACGG,36,22,36,34,128
1,1,BAAX01001997.1/1769-1874,UCGAAACAUCAAGAGCAGUAUUAAUCUGCACCAACCGAGCACGACAGCCACGGUGGUCAAGAUACGAUGUGGAAAUAAGUUUAAUUUCAAAAAUAAGUCUUUAUGA,40,25,21,20,106
2,1,ABEF01026777.1/1438-1540,AACCAGCAUCAAGAGCAGGGUUGACGCCCUCGCCAACCUGCCCUGUCCGGGCAAGGUGGUUCCCGAAAGGGGAUGCGGCCACAAGGCAACAAAGCGGGCCCAU,26,12,32,33,103
3,1,AACY020331037.1/853-942,GCUUUGCAUAAAGAGAGGGAAGCCUCAGCAACCUAGAAUGCCAACUAAGGUGCUUUUUGAUGUGGUUAUUACAACAAAAAAUGGCUUUUU,29,26,20,15,90
4,1,AACY020251371.1/791-877,AAGUUGCAUAGAGAGAGGAAUUCCUCAGCAACCUAGUUGCCAACUAAGGUGCUUUUUGAUGUGGUUAUACAACAAAAAUUGGCGUUC,27,25,20,15,87
5,1,AACY020473630.1/833-747,UGAAUGCAUAGAGAGAGGAAUUCCUCAGCAACCUAGUUGCCAACUAAGGUGCUUUUUGAUGUGGUUAUACAACAAAAAAUGGCGUUC,28,24,20,15,87
6,1,AACY020357342.1/559-467,AAUAAGCAUAAAGAGAAGGUUAAGACCUCGGCAACCUGGAUGACUAUCCAAGGUGCUAGAAAAUGUGGCAGAAAUGCAACUAAAUAGUCAAAA,40,17,21,15,93
7,1,AACY020554034.1/791-702,GUUUUGCAUAAAGAGAGGGAAGCCUCAGCAACCUAGAUUGCCAACUAAGGUGCUUUUUGAUGUGGUUAUUACAACAAAAAAUGGCUUUUU,28,28,20,14,90
8,1,AACY023471425.1/1443-1530,UAAAUGCAUAGAGAGAGGAAUUCCUCAGCAACCUAGAUGCCAACUAAGGUGCUUUUUGAUGUGGUUAUACAACAAAAAAUGGCGUUCC,30,23,19,16,88
9,1,AACY021769818.1/232-138,CAUUGUCAUCAAGAGUUGGGAUGACACCCACACCAACCUGCUUACCGAGCAAGGUGGUCAAACGAUGUGGCCUUAGGGCAACCAAUCGCGUGUCA,26,19,24,26,95
10,1,AACY022292471.1/307-208,AUUAAGCAUCAGGAGUGAAUAAGAAAUUAUUCUGCCAACCUGCUUUGAGGAAAGUAAGGUGGAGUAGGAUGUGGUCUUAAUGACAAUUAAGUUCCUCAUC,33,29,24,14,100
11,1,AACY020250700.1/987-1093,GAAUAUCAUUAAGAGUUCCGUGAAAGUCACGGAUGCCAACCGAUCCUUCGCAGGGCACGGUGGAAAAAAAAGAUGAGAGGCUCGCACCUAAAAACAAAUAGCGAAUC,40,18,26,23,107
12,1,AACY020289175.1/1718-1630,AAAAAGCAUGGAGAGAGGUUAAGCCUCAGCAACCUAGAAAGCUAACUAAGGUGCUUUAAGUAUGUGGUUUGAAACAAAAAAUAGCUUUU,35,22,20,12,89
13,1,AACY020436349.1/1266-1356,AAGAUGCAUUAGGAAAGGGGUUAUCCCUGCCAACCUGCAUACCGUGCGAAGGUGGUAAUAUAUGCGGCCAAAAGGCAAAAAUUAGGUCUCA,30,19,24,18,91
14,1,AACY022194140.1/224-333,UCAUCAGGAGAGGUUUCUUACUUGAAACCCACCAACCGAACUUAAAAGUUACGGUGGUUAGUUCCAUUAAACGGGAGAUGUGCCUUGAAAAAGGAAAAAUAGAACCGCCU,38,26,24,22,110
15,1,AACY020691912.1/807-704,UCGCUACAUCACGAGCGACCAACUGGUCCGGCAACCGGGAAUCCACGGUGCCAAGUCACUUCGGUGACGAUGUGGCCCCGCAAGGGGCAACGGACCCGUGACUC,23,15,31,35,104
16,1,AACY020553512.1/101-193,AUUAAGCAUAAAGAGAAGGUUAAGACCUCGGCAACCUGGAUGGCUAUCCAAGGUGCUAGAAAAUGUGGCAGAAAUGCAACUAAAUAGUCAAAU,37,19,22,15,93
17,1,CP000873.1/467570-467678,ACCGCACAUCCAGAGUUGGGGCGACGCCCAACGCCAACCUGCCGUUCCGGGCAAGGUGGUACUCCCCGAAAGGGAGGAUGUGGCCGAACCGGCAAUUAUACGGAUGAAG,27,15,35,32,109
18,1,AACY020784198.1/120-213,AGAAAGCAUCAAGAACACAUAAUUGUGUACCAACCGACCUUCCGAGGCACGGUGGUUUAGAAUGCGGGACAAUCGUUCAAAAGUUUCGGAAAUC,32,20,22,20,94
19,1,AACY020281887.1/114-202,UAUUUGCAUAUAGAGAGGGAAACCUCAGCAACCUAGAAUGCCAACUAAGGUGCUUUUUGAUGUGGUUUUACAACAAAAAAUGGCUUUUU,29,28,18,14,89
20,1,AACY023696825.1/714-806,AAUAAGCAUAUAGAGAAGGUUAAGACCUCAGCAACCUGGAAGACUAUCCAAGGUGCUUGAAGAUGUGGCAGAAAUGCAACUAAAUAGUCAGAA,38,18,22,15,93
21,1,AACY023507554.1/1049-1148,AUUAAGCAUCAGGAGUGAAUAAGAAAUUAUUCUGCCAACCUGCUUUGAGGAAAGUAAGGUGGAGUAGGAUGUGGUCUUAAUGACAAUUAAGUUCCUCAUC,33,29,24,14,100
22,1,AACY020176386.1/887-1007,AUCCUGUAUGUAGAGUGCCUCUCGAUAGGGGCCACCAGACCGAGCAACUCCACAAGUAGCCACGGUGGUUAGAAUCGCAAGAUUCCAUACGUAGGAGACAACCUAAAAAAUGGAGGUGCCC,37,22,31,31,121
23,1,AACY020430151.1/744-648,AAAAAGCAUCAAGAGCAGAGUUAAGUCUCUCUCCAACCUGCCAACUCCGGCAAGGUGGAACAAAUGAUGCGGUUGUUCAACAAAUAAUGGAGAUAAA,37,19,21,20,97
24,1,AACY022771515.1/120-17,GCGCUACAUCACGAGCGACCAAACGGUCCGGCAACCGGGAAUCCACGGUGCCAAGUCACUUCGGUGACGAUGUGGCCCCGCAAGGGGCAACGGAUCGCAUGGUG,24,14,34,32,104
25,1,AACY020114415.1/340-432,UUAAAACAUAAAGAGAAGGUUAAGACCUCGGCAACCUGGAUGACUAUCCAAGGUGCUAGAAAAUGUGGCAGAAAUGCAACUAAAUAGUCAAAA,40,18,20,15,93
26,1,AACY021536907.1/438-344,UCAAAAUAUCACGAGAAGGGUUUGCAUCCUCUCCAACCUGCCAACUCCGGCAAGGUGGAAAAAUGAUAUGGCGUUCAGCAAACAUAGGAGAAUAG,33,19,22,21,95
27,1,AACY022508868.1/93-196,UUAUAACAUCAAGACAAGGGCCGACGCCCUGACCAACCUGCCCCCCGGGCAAGGUGGACGCGAAAGCGGAUGUGGCCUAAAGUUUAGGCAACCAAGCGGGAGUA,30,14,31,29,104
28,1,AACY021479654.1/475-585,AAUCAGCAUCUAGAAACACCUCGCAAGAGGUGUGGCAACCGAGCCCACCAGGCCACGGUGCCUCCCAACAAAUGGGGAUGCGGCGCGACGAGCGCAAAAGAACUGGUGCUC,32,13,32,34,111
29,1,AACY023698657.1/321-413,AAUAAGCAUAUAGAGAAGGUAAAGACCUCAGCAACCUGGAAGACUAUCCAAGGUGCUAGAAGAUGUGGCAGAAAUGCAACUAAAUAGUCAGAA,40,16,22,15,93
30,1,AACY020556356.1/9293-9389,AAACUACAUUUUGAGAGGGAGUAAUCCCUGCCAACCUGCAAUAACCUGCGAAGGUGGUAACUUUAAUGUGGCUUAAUAAGCAAAAAAAGGUUCUUUC,33,26,20,18,97
31,1,AACY020173786.1/742-856,CGACGACAUCACGAGCGACCCUCACGGGUCCGGCAACCGGGAUCGCCACUCGGUGCCAUCUCGCCGCGAGGCGGGGAUGUGGUCCCGCGACGGCGGGACAAGGAGGUGACAUGGC,21,13,43,38,115
32,1,AACY023398704.1/1264-1169,AAAAAUCAUCAAGAGUGAGAUUAGGUUCUCCUCCAACCUGCCAACUCCGGCAAGGUGGAAAAAAGAUGAGGUUAAUCAACAAGUAUAGGAGUGUUA,36,21,22,17,96
33,1,AACY020554374.1/5481-5389,AUUAAGCAUAAAGAGAAGGUUAAGACCUCGGCAACCUGGAUGACUAUCCAAGGUGCUAGAAAAUGUGGCAGAAAUGCAACUAAAUAGUCAAAA,39,18,21,15,93
34,1,AACY023713997.1/222-314,UAGGAACAUAAAGAGAAGGUUAAGACCUCGGCAACCUGGAAGACUAUCCAAGGUGCUUGUAGAUGUGGCAGUAAUGCAACUAAGUAGUCGUAU,32,21,25,15,93
35,1,AACY021580150.1/451-351,CCUCAGCAUUAAGAGAGGGCUGACGCCCCGCCAACCUGCAGCUGUGCAAGGUGGUCUCCCGCCAGGGAAAUGUGGCCUUCAAGGCAACAACAGCGUCGGCC,23,15,30,33,101
36,1,AACY020744244.1/368-464,UUUAUGCAUUAAGAGCAGGAUUAAUUUCCUCUCCAACCUGCCAACUCCGGUAAGGUGGAAAAAAUGAUGCGGUUAACCAACAACUAUAGGAGCUAAA,34,24,19,20,97
37,1,AACY020106543.1/2258-2159,AUUAAGCAUCAGGAGUGAAUAAGAAAUUAUUCUGCCAACCUGCUUUGAGGAAAGUAAGGUGGAGUAGGAUGUGGUCUUAAUGACAAUUAAGUUCCUCAUC,33,29,24,14,100
38,1,AACY023366624.1/990-898,ACAGUGCAUCAAGAACGCAAUGCGUACCAACCGACACACUCGAUGCACGGUGGUUUAGAAUGCGGAGAACAACUCUCAAAUUAAUCGAGUAAU,33,18,20,22,93
39,1,AACY022380554.1/353-444,GUAUAGCAUCAAGAACGCAAUGCGUACCAACCGACACACUCGAUGCACGGUGGUUUAGAAUGUGGAGAUAUUUCUCAAAGAUUCGAGUAAUC,30,22,21,19,92
40,1,AACY021048897.1/409-545,CUUUGGCAUCCAGAGUCCCACGCGACCUCUUGAAGCGUGGGCGGCAACCGGGUCAAGCGCGAUCACGGUGCCGAGGUCAGCCCUUCUGGGGUGAUGCGGCACGCAAGGCCAUGCCUUGUGCAGCAACAUCAGCGCUC,25,24,44,44,137
41,1,AACY022728072.1/92-211,ACAGUACAUCAAGAGUUGUUCAUUAAUGAACACGGCAACCUGGGAUUGACACCCAAGGUGCCACUAGCCGAAGGGUUAGGAUGGGGUUUAGCCGAAAGCUAAGCAAAAAAGUGUGAGAAA,42,23,33,22,120
42,1,AACY020588692.1/445-537,UAGAAGCAUAAAGAGAAGGUUAAGACCUCGGCAACCUGGAUGACUAUCCAAGGUGCUUGAAGAUGUGGCAGAAAUGCAACUAAGUAGUCAAAC,35,18,24,16,93
43,1,AACY020048217.1/3548-3456,AAUAUACAUUAAGAGAAGGUUAAGACCUCAGCAACCUGGAUGACUAUCCAAGGUGCUUGAAGAUGUGGCAGAAAUGCAACUAACUAGUCAAAA,37,20,20,16,93
44,1,AACY023738170.1/418-505,GUUUUGCAUAAAGAGAGGAAAUCCUCAGCAACCUAGAUACCAACUAAGGUGCUAUUUGAUGUGGUUUUACAACAAAAAAUGGUAUUUC,31,26,17,14,88
45,1,AACY020148119.1/839-753,UGAGUGCAUAUAGAGAGGAAUACCUCAGCAACCUAGUUGCCAACUAAGGUGCUUUUUGAUGUGGUUAUACAACAAAAAAUGGCGUUC,28,24,20,15,87
46,1,AACY020516216.1/1635-1543,AGUAAGCAUAUUGAGAAGGUUAAGACCUCAGCAACCUGGAAGACUAUCCAAGGUGCUUGAAGAUGUGGCAGAAAUGCAACUAAAUAGUCAGAA,36,19,23,15,93
47,1,AACY023587568.1/603-501,ACCCAUCAUUAAGAGAGGACUGACGUCCCGCCAACCUGCCUUUUCCGGCAAGGUGGUAGCCUUAGUUAGGCGAUGAGACCCUUGGGUAACUAAUGGAUCAUCA,26,24,26,27,103
48,1,AACY023449939.1/987-888,AUUAAGCAUCAGGAGUGAAUAAGAAAUUAUUCUGCCAACCUGCUUUGAGGAAAGUAAGGUGGAGUAGGAUGUGGUCUUAAUGACAAUUAAGUUCCUCAUC,33,29,24,14,100
49,1,AAFX01070226.1/249-124,CGAAGACAUCCCGAGUGGCCUCGUCUGGUGACGAGGCGCAGCAACCUGCCAACGACCGGCAAGGUGCUUGUGCGCAGCGGCGCAGAUGUGGCCACGCAAGGUUGCGAGGCAACGAACAGUCGCCCC,27,16,43,40,126
50,1,AACY022632962.1/263-367,UCCGGACAUCAAGAGUAGGGCUGACGCCCUCACCAACCUGCCGACCCGGCAAGGUGGUGUCCCAAAAGGGAGAUGUGGCCAAGGACGGCAACUAAGGGGUCCAAC,28,13,33,31,105
51,1,AACY020251371.1/2025-2117,AAGAAGCAUAUAGAGAAGGUUUAGACCUCGGCAACCUGGAUGACUAUCCAAGGUGCUAAUAGAUGUGGCAGAAAUGCAACUAAUUAGUCAAAC,35,20,22,16,93
52,1,AACY023315004.1/1135-1237,CAGAUUCAUCAAGAGAGGGCUGACGCCCCGCCAACCUGCUGUUUGAGCAAGGUGGUUAUUCCGUAAGGAAGAUGUGGCUUAUUCAGCAACCUCAAGCGUCACC,26,23,27,27,103
53,1,CP000959.1/1018491-1018388,AUCAAGCAUCCAGAGUCGGGUUUCCCGACGCCAACCUGCCCUCCCGGGCAAGGUGGACGCCCUCGAGGCGAUGCGGCCGAUUGACGGCAACGAAACGGGAGCAG,23,13,34,34,104
54,1,AACY020409173.1/538-450,AAAAAGCAUGGAGAGAGGUUAAAACCUCAGCAACCUAGAAAGCUAACUAAGGUGCUUAAAUAUGUGGUUUGUAACAAAAAACAGCUUUC,37,20,18,14,89
55,1,AACY020929092.1/724-820,AAAGUUCAUCAAGAGUGAGAUUAAGUUCUCCUCCAACCUGCCAACUCCGGCAAGGUGGAAAAAAUGAUGUGGUUAAUCAACAAAUAAUGGAGAUGCA,36,22,21,18,97
56,1,AACY023621099.1/135-40,UAUAAGCAUCAAGAGCGAGAUUAAUUUCUCCUCCAACCUGCCAACUCCGGCAAGGUGGAAAAGUGAUGCGGUUAUUCAACAAUUAAAGGAGUAGAA,34,22,21,19,96
57,1,AACY023403796.1/1244-1130,UGACAGCAUCAGGAGAGAUUUCUAAAAAGAAAUCCACCAACCGAGCUUAAAAGCUACGGUGGUUAGUUCCAUUAAACGGAAGAUGUGCCUCAAUAGAGGAAAAAUGGAACCGCCU,43,23,26,23,115
58,1,AACY021710656.1/616-530,UGAGUGCAUAUAGAGAGGAAUACCUCAGCAACCUAGUUGCCAACUAAGGUGCUUUUUGAUGUGGUUAUACAACAAAAAAUGGCGUUC,28,24,20,15,87
59,1,AACY020505932.1/3030-3122,UAGAAGCAUAAAGAGAAGGUUAAGACCUCGGCAACCUGGAUGACUAUCCAAGGUGCUUGAAGAUGUGGCAGAAAUGCAACUAAGUAGUCAAAC,35,18,24,16,93
60,1,AACY023898889.1/1101-1196,UUCUGGCAUCUAGAGCGAGAUUAAAUUCUCCUCCAACCUGCCAACUCCGGCAAGGUGGAAAAAUGAUGCGGUUAACCAACAAAUAAAGGAGUUAAA,34,21,20,21,96
61,1,AACY020101119.1/425-514,GCGCUACAUCAAGAAUACUUAAUUGUAUACCAACCGGACGAUAACGGUGGUUUAGCGAUGUGGGCAUCACAGUCAAAAUCGAUUCUCAUA,29,23,19,19,90
62,1,AACY022924688.1/248-340,AAGAAGCAUAUAGAGAAGGUUAAGACCUCGGCAACCUGGAUGACUAUCCAAGGUGCUUGAAGAUGUGGCAGAAAUGCAACUAAGUAGUCAAAC,35,18,24,16,93
63,1,AACY020491193.1/1967-2053,UAAAUGCAUAGAGAGAGGAAUUCCUCAGCAACCUAGUUGCCAACUAAGGUGCUUUUUGAUGUGGUUAUACAACAAAAAAUGGCGUUC,29,24,19,15,87
64,1,AACY020494659.1/3034-2942,UUAUGACAUAAAGAGAAGGUUAAGACCUCGGCAACCUGGAAGACUAUCCAAGGUGCUUGUAGAUGUGGCAGUAAUGCAACCAAGUAGUCGUAC,31,21,24,17,93
65,1,AACY021344802.1/341-455,UUAUCUCAUCAUGAGCGGUUUCUCUCACAAACCCGCCAACCGAGCCUAAAAGCCACGGUGGUCAGUUCCGCUAAAAGGAAUGAUGUGCCUUUUAUUAGGAAAAAGUGGAACCGCC,33,27,25,30,115
66,1,AAOW01000005.1/152632-152735,AUUUAACAUCAAGAGUAGGGCUGACGUCCUCACCAACCUGCCAACCUGGGCAAGGUGGUUGCUAUAAAGCGAUGUGGUCGAUUCCGACAACGAAUCAGGUAGAC,30,22,27,25,104
67,1,AACY020433596.1/2634-2542,UAAUAACAUAAAGAGAAGGUUAAGGCCUCGGCAACCUGGAAGACUAUCCAAGGUGCUUGUAGAUGUGGCAGUAAUGCAACCAAGUAGUCGUAU,32,21,24,16,93
68,1,AACY020272341.1/1114-976,UCCAAGCAUCAGGAGUGGCCUUGCGAAAGCGGGGUCCGGCAACCUGGUUUGGAGAAGCCAAGGUGCCUUGGAUGCUGUGACAGAAUUCUGUUACGGUGACCGAUGUGCGAAUGUUUACAUUCGAACAGAAUUUCUCUCG,32,35,42,30,139
69,1,AACY021231107.1/205-108,ACAAUGUAUUAAGAGUGAGAUUAAGUUCUCCUCCAACCUGCCAACUCCGGCAAGGUGGAAAAAUGAUACGGUUUUUAUUAACAACAAAUGGAGGUUCA,34,26,20,18,98
70,1,AACY020892474.1/179-271,AAUAUACAUAAAGAGAAGGUUAAGACCUCAGCAACCUGGAUGACUAUCCAAGGUGCUUGAAGAUGUGGCAGGAAUGCAACUAAAUAGUCAAAA,38,19,21,15,93
71,1,CP000709.1/441133-441241,ACCGCACAUCCAGAGUUGGGGCGACGCCCAACGCCAACCUGCCGUUCCGGGCAAGGUGGUACUCCCCGAAAGGGAGGAUGUGGCCGAACCGGCAAUUAUACGGAUGAAG,27,15,35,32,109
72,1,AACY020098227.1/1332-1240,CAUAAGCAUCAAGAACACUAAUUGUGUACCAACCGAUCUUCCGAGACACGGUGGUUUAGAAUGCGGGACAAUCGUUCAAAAGAUUCGGAAAUC,32,21,20,20,93
73,1,AACY021071265.1/759-845,UAAUUGCAUAGAGAGAGGAAUACCUCAGCAACCUAGUUGCCAACUAAGGUGCUUUUUGAUGUGGUUAUACAACAAAAAUUGGCGUUC,28,25,19,15,87
74,1,AACY020477250.1/717-631,UAAAUGCAUAGAGAGAGGAAUUCCUCAGCAACCUAGUUGCCAACCAAGGUGCUUUUUGAUGUGGUUAUACAACAAAAAAUGGCGUUC,29,23,19,16,87
75,1,AACY020293165.1/279-372,AUCUUGCAUCCCGAACCCUUUAGUGGGUGCCAACCGAGCAGAGAAGCCACGGUGGCAAAACGAUGCGGGCAUUAUGCCAAAACAUAUUCCGAGA,28,17,24,25,94
76,1,AACY020492046.1/519-605,UAAAUGCAUAGAGAGAGGAUUUCCUCAGCAACCUAGUUGCCAACUAAGGUGCUUUUUGAUGUGGUUAUACAACAAAAAAUGGCUUUC,28,26,18,15,87
77,1,AAEW02000015.1/42526-42659,ACCAUGCAUUAAGAGAGGCGUGGCGGCAUGAGCCAAGCGCCCGGCAACCUGACAACCAAGGUGCCAGCAUGUUUUGUGAACACGGUGUUUGCAAAACAGCGAUGCGCCCCGUAAGGGGAAAGUUGACCUACCGU,36,23,40,35,134
78,1,AACY020208399.1/1640-1726,UGAGUGCAUAUAGAGAGGAAUACCUCAGCAACCUAGUUGCCAACUAAGGUGCUUUUUGAUGUGGUUAUACAACAAAAAAUGGCGUUC,28,24,20,15,87
79,1,AACY020068969.1/866-767,AUUAAGCAUCAGGAGUGAAUAAGUAAUUAUUCUGCCAACCUGCUUUGAGGAAAGUAAGGUGGAUUAAGAUGUGGUCUUAAUGACAAUUAAGUUCCUCAUC,33,31,22,14,100
80,1,AACY024064010.1/1047-955,GUAAAGCAUAAAGAGAAGGUUAAGACCUCGGCAACCUGGAUGACUAUCCAAGGUGCUUGAAAAUGUGGCAGAAAUGCAACUAAAUAGUCAAAA,38,18,22,15,93
81,1,AACY020561147.1/40418-40521,AUCAAGCAUCCAGAGUCGGAUUCUCCGACGCCAACCUGCCCUCCCGGGCAAGGUGGACGCCUCCAAGGCGAUGCGGCCGAUUUACGGCAACGAAACGGGAGCAG,25,14,31,34,104
82,1,AACY020181329.1/1342-1222,AUCCUGUAUGUAGAGUGCCUCUCGAUAGGGGCCACCAAACCGAGCAACUCCACAAGUAGCCACGGUGGUUAGAAUCGCAAGAUUCCAUAUGUAGGAGACAACCUAAAAAAUGGAGGUGCCC,38,23,30,30,121
83,1,AACY023505660.1/626-720,AAGAUACAUCAAGAGUGAGAUUAAGUUCUCCUCCAACCUGCCACUCCGGCAAGGUGGAAAAAAGAUGUGGUUAACCAACAAUUAAAGGAGUUAAA,37,20,20,18,95
84,1,AACY020243063.1/177-88,GUUUUGCAUAAAGAGAGGGAAGCCUCAGCAACCUAGAUUGCCAACUAAGGUGCUUUUUGAUGUGGUUAUUACAACAAAAAAUGGCUUUUU,28,28,20,14,90
85,1,AACY020181346.1/9550-9431,UAGAGGUAUGAGGAUUGCCUCACUAACCCCAAGGUGAGGCUGCCAACCGAGCACAUGCCACGGUGGCCGAAUCUUAAUGAGAUUCCAUACGUUGGAUUAACCAGAAAAAGGAGCCCUGUG,35,24,32,29,120
86,1,AACY020800775.1/440-319,AUUUUGUAUGUAGAGUGCCUCUCGAUAGAGGCCACCAGACCGAGCAACUCCAAACAGUAGCCACGGUGGUUAGAAUCGCAAGAUUCCAUACGUAGGAGACAACCUAAAAAAUGGAGGUGCCC,39,24,30,29,122
87,1,AACY023494623.1/1058-962,AAAUAACAUUUCGAGAGGGAGCAAUCCCUGCCAACCUGCAUUAACCUGCGAAGGUGGUAACUUUAAUGUGGCUUAUUAAGCAAAAAAAGGUUUCUCC,32,25,20,20,97
88,1,AACY022669929.1/401-309,AAUAAGCAUAUAGAGAAGGUUUAGACCUCGGCAACCUGGAAGACUAUCCAAGGUGCCUGAAGAUGUGGCAGAAAUGCAACUAAAUAGUCAAAG,36,18,23,16,93
89,1,AACY021621762.1/356-449,ACUGAGCAUCAGGAGUGGGCGCAAGCCCCGCCAACCUGCUUACCCAAGCAAGGUGGUUCGAGAAUGUGGCCGUAAGGCAACCAAGUGGGUUCUC,23,16,29,26,94
90,1,AACY020175566.1/301-414,CGACGACAUCAGGAGCGACCCUCACGGGUCCGGCAACCGGGAUCGCCACUCGGUGCCUUCCGCCUCACGGCGGAGAUGUGGUCCCGCGAGCGCGGGACAAGGAGGUGACAUGGC,21,14,41,38,114
91,1,AACY022940092.1/322-421,AUCAAGCAUCAGGAGUGAAUAAGAAAUUAUUCUGCCAACCUGCUUAGAGGAAAGUAAGGUGGAGUAGGAUGUGGUCUUAAUGACAAUUAAGUUCCUCAUC,34,27,24,15,100
92,1,AACY020408240.1/227-137,AAGGUGCAUUAAGAAAGGGGUUAUCCCUGCCAACCUGCAUACCGUGCGAAGGUGGUAAUAUAUGCGGCCAAAAGGCAAAAGUUAGGUCUCA,29,19,25,18,91
93,1,AACY023068576.1/606-514,AAGAAGCAUAAAGAGAAGGUUAAGACCUCGGCAACCUGGAUGGCUAUCCAAGGUGCUUGAAGAUGUGGCAGGAAUGCAACUAAGUAGUCAAAC,34,17,26,16,93
94,1,AACY022117635.1/301-399,CCGCAACAUUAAGAGAGGGCUGACGCCCCGCCAACCUGCAGCUGUGCAAGGUGGUACCCCGAAAGGGAAUGUGGCCUUAAGGCAACGACAGCGUCAGCC,26,13,30,30,99
95,1,AACY023099908.1/98-208,UACAUGCAUCAAGAUAGGUCUUUUUUAAAGACCUGCCAACCGAGCUUCAAAGCCACGAUGGUAAGUUCCAACAAAAGGAAGAUGUGUCCGUAAAGGAAAAAACGAUCAACC,42,23,22,24,111
96,1,AACY023669787.1/612-524,AAAAAGCAUGGAGAGAGGUAAAAUCCUCAGCAACCUAGAAAGCUAACUAAGGUGCUUAAAUAUGUGGUUUAUAACAAAAAAUAGCUUUU,38,22,17,12,89
97,1,AACY020477924.1/1643-1551,UAGGAACAUAAAGAGAAGGUUAAGACCUCGGCAACCUGGAAGACUAUCCAAGGUGCUUGAAGAUGUGGCAGAAAUGCAACUAAGUAGUCAAAU,36,18,24,15,93
98,1,AACY022504339.1/418-316,AAUGAUCAUUAAGAGAGGACUGACGUCCCGCCAACCUGCCUUAUCCGGUAAGGUGGUAACCUCAUAUGAGGGAUGAGACCUAAGGGUAACCAAAGGAUCAUUG,32,22,27,22,103
99,1,AACY021272089.1/454-550,ACAAAACAUCAAGAAAGAGUGAUGACACUCUUACCAACCUGCCAACUCCGGCAAGGUGGUUUAAACGAUGUGGCUUUCAGCAACUAAAGGAGGUAAU,35,20,21,21,97
100,1,AACY020375700.1/1515-1609,AAUAUAUAUCAUGAGAAGGAUUUAUUUCCUCUCCAACCUGCCAACUCCGGCAAGGUGGAAAAAAGAUAUGGCGUUCAGCAAAUAAUGGAGGUGUG,32,24,22,17,95
101,1,AACY022269084.1/174-77,UAAUUGUAUCAAGAGCAGAGUUAAUUCUCUCUCCAACCUGCUAGCUUCUAGCAAGGUGGAACAAAUGAUACGGCUAUUCACGCAACUAAAAGGAGAUC,33,25,19,21,98
102,1,AACY022902937.1/198-306,UUCAAUCAUCCCGAGCGAUUCGGUCCCACAAGCCCGAAUCCACCAACCUGUCCAAGGCGGAUAAGGUGGUUCUCAUGAUGAGCCCGUUCUGGGAAGCCGUCCACGCACG,25,21,27,36,109
103,1,CP000699.1/636052-635945,AUGCAGCAUCAAGAGUUGGGCCGGCGCCCAACGCCAACCUGCCGAUCCGGGCAAGGUGGCGCUCCCGCGAGGGGGGAUGUGGCCGAUCCGGCAACCAAGCGGACCAAG,23,11,39,35,108
104,1,AACY020132046.1/1210-1087,AAACAACAUCAGGAGUGGUUUCAUAUUUGAAACCCGCCAACCGAGCCCAGAUAAAUCAAGGCUACGGUGGUUUGAUCCUUAAACGGUAGAUGUGCCUAGGAAAAUAGGAAACAUAGUAAGCCGC,43,26,29,26,124
105,1,AACY023286370.1/297-205,CUUAUACAUUAAGAGAAGGUUAAGACCUCAGCAACCUGGAUGACUAUCCAAGGUGCUUGAAGAUGUGGCAGAAAUGCAACUAACUAGUCAAAA,35,21,20,17,93
106,1,AACY023872706.1/1205-1109,AUUUUACAUCUAUAGAGAAGGGUGACCUUCACCAACCAGCCAGACUUGGCAACGGUGGUUCAACGAUGUGGCUUUUGAAGCAACAAUAAAGUCAGAU,31,24,22,20,97
107,1,AACY020548058.1/648-734,UAAAUGCAUAGAGAGAGGAAAUCCUCAGCAACCUAGUUGCCAACUAAGGUGCUUUUUGAUGUGGUGAUACAACAAAAAAUGGCGUUC,30,22,20,15,87
108,1,AACY020184636.1/1250-1336,UAAAUGCAUAGAGAGAGGGAUACCUCAGCAACCUAGUUGCCAACUAAGGUGCUUUUUGAUGUGGUUAUACAACAAAAAAUGGCGUUC,29,23,20,15,87
109,1,AACY021425142.1/531-429,UAUAAUCAUUCAGAGAGGACUGACGUCCUGCCAACCUGCAUUUUCCGGCAAGGUGGUUACCUCAUUUGAGGGAUGAGACCGUAGGGUAACCAAAGGAUCAUUG,28,26,27,22,103
110,1,AACY023996159.1/385-293,AAUAAGCAUAAAGAGAAGGUUAAGACCUCGGCAACCUGGAUGACUAUCCAAGGUGCUAGAAAAUGUGGCAGAAAUGCAACUAAAUAGUCAAAA,40,17,21,15,93
111,1,AACY020760933.1/589-481,AAGGAACAUUAAGAGAGGUCCAAUAUUGGGCCCGGCAACCUAGGACGGACACCCAAGGUGCUUCCCAGAAAUGGGGAUGUGGUACGAAAGUACAAGUAAUUGUCCACAC,36,19,30,24,109
112,1,AACY020471545.1/1557-1444,GUAGUACAUCACGAGCGACCAACAGGUCCGGCAACCGGGAUUUCCCACGGUGCCAUUUCGCGAAAUGCGAAAGAUGUGGCUACGCCAACAGGCGUAGCAACGGGCUGGCUCAGU,29,19,34,32,114
113,1,AACY020758038.1/271-176,AUCUAGCAUCAGGAGUGAGCGAAAGCUCCGCCAACCUGCCCUCCCAGGCAAGGUGGCGCAGAAUGUGGCCUCAUUGAGGCAAUCAACUGGGAUUCA,25,17,27,27,96
114,1,AACY023841578.1/259-157,CCCAAGCAUCAAGAGAGGGGCCCUCGCCCCCACCAACCUGCCCAACCCGGCAAGGUGGUCGUCCUUCGGGAGAUGUGGCCGAUCCGGCAACAAACGGGUGCAG,23,12,31,37,103
115,1,AACY022716110.1/377-469,AAGAGGCAUAAAGAGAAGGUUAAGACCUCGGCAACCUGGAUGACUAUCCAAGGUGCUUGAAGAUGUGGCAGAAAUGCAACUAAGUAGUCAAAC,35,17,25,16,93
116,1,AACY020515115.1/1918-2010,ACUAAGCAUAAAGAGAAGGUUAAGACCUCGGCAACCUGGAAGGCUAUCCAAGGUGCUUGAAGAUGUGGCAGAAAUGCAACUAAUUAGUCAAAA,36,18,23,16,93
117,1,AACY020340651.1/1065-973,GAGAAGCAUUUAGAGAAGGUUAAGACCUCGGCAACCUGGAUGACUAUCCAAGGUGCUUGAAGAUGUGGCAGCAAUGCAACUAAGUAGUCAAAG,32,19,26,16,93
118,1,AACY023512723.1/650-561,UUUCAACAUCAAGAAUACUUAAAUGUAUACCAACCGAACGAUAGCGGUGGUUUAGUGAUGUGGGCAUCCAAGUCAAAAUCGAUUCUCAUA,31,25,17,17,90
119,1,AACY023996530.1/508-416,UUAAAGCAUAAAGAGAAGGUUAAGACCUCGGCAACCUGGAUGGCUAUCCAAGGUGCUAGAAAAUGUGGCAGAAAUGCAACUAAAUAGUCAAAA,38,18,22,15,93
120,1,AACY020495019.1/245-331,UGAGUGCAUAUAGAGAGGAAUACCUCAGCAACCUAGUUGCCAACUAAGGUGCUUUUUGAUGUGGUUAUACAACAAAAAAUGGCGUUC,28,24,20,15,87
121,1,AACY023014452.1/536-447,AAGAUGCAUUAAGAAAGGGGUUAUCCCUGCCAACCUGCAUACCGUGCGAAGGUGGUAAUAUAUGCGGCCAAAAGGCAAAAAUAGGUCUCA,31,18,23,18,90
122,1,AACY022006392.1/340-429,GGGUCGCAUCAAGAACGCUAAGGCGUACCAACCGACAGCUCGUUGCACGGUGGUUUAGAAUGCGGGGAUCUUCCCAAACAAACGAGAAAU,27,16,25,22,90
123,1,AACY021125113.1/499-592,AUUAUUCAUCAAGAGUAAGAUUAAUUUCUUCUCCAACCUGCCAGCUCCGGCAAGGUGGAAAAAUGAUGAGGCAAUCAGCAAUAUAGGAGAAAGG,34,22,21,17,94
124,1,AACY020098447.1/1122-1000,UUUUAUCAUCAGGAGUGGUUUCAUAAUGAAACCCGCCAACCGAGCUUAGAAAAAUCAAAGUUACGGUGGUUUGAUCCUUAAACGGUAGAUGUGCCUAGGAAAAUAGGAAACAUGAUUAGCCGC,41,32,28,22,123
125,1,AACY020327880.1/953-857,AUAGAGCAUUAAGAGCAGGGUUAAAUCCCUCUCCAACCUGCCAACUCCGGCAAGGUGGAAAAAAUGAUGCGGUUAACCAACAAACAUAGGAGUACAA,37,17,21,22,97
126,1,AACY020411818.1/3750-3838,AAAAAGCAUGGAGAGAGGGUAAAACCUCAGCAACCUAGAAAGCUAACUAAGGUGCUUAAAUAUGUGGUUUAUAACAAAAAAUAGCUCUC,38,19,18,14,89
127,1,AACY020317023.1/234-331,ACACAACAUGAAGAGUAACUGAAUUAGGUUCACCAACCUGCAAAUGUAAGGUGGUUUCCUCAAGGGCAUGUGACCGUAAGGUAAUAUACAUGCCUCCU,32,24,21,21,98
128,1,AACY020414565.1/1377-1469,UAAAAGCAUAAAGAGAAGGUUAAGACCUCGGCAACCUGGAUGACUAUCCAAGGUGCUAGAAAAUGUGGCAGAAAUGCAACUAAAUAGUCAAAA,40,17,21,15,93
129,1,AACY020532609.1/3243-3139,ACUCAGCAUCAAGAGAAGGGCCUCGGCCCGCACCAACCUGCCAACACCCGGCAAGGUGGUCGCCCGAAAGGGGAUGCGGCCAAACCGGCAACUAAAGGGCAGGCC,29,8,32,36,105
130,1,AACY020029910.1/1636-1728,GAUAUACAUAUAGAGAAGGUUAAGACCUCAGCAACCUGGAAGACUAUCCAAGGUGCUAGAAAAUGUGGCAGAAAUGCAACUAACUAGUCAAAA,39,18,20,16,93
131,1,AACY022543694.1/437-345,CAUAAGCAUAUAGAGAAGGUUAAGACCUCGGCAACCUGGAAGACUAUCCAAGGUGCCUGAAGAUGUGGCAGAAAUGCAACUAAAUAGUCAAAG,36,17,23,17,93
132,1,AACY022869497.1/434-342,UUGAAGCAUAAAGAGAAGGUUAAGACCUCGGCAACCUGGAUGGCUAUCCAAGGUGCUAGAAAAUGUGGCAGAAAUGCAACUAAGUAGUCAAAA,36,18,24,15,93
133,1,AACY020492046.1/1757-1849,AAGAAGCAUAAAGAGAAGGUUAAGACCUCGGCAACCUGGAUGACUAUCCAAGGUGCUUGAAGAUGUGGCAGAAAUGCAACUAAGUAGUCAAAC,36,17,24,16,93
134,1,AACY020031148.1/475-383,GAUAUACAUAUAGAGAAGGUUAAGACCUCAGCAACCUGGAAGACUAUCCAAGGUGCUAGAAAAUGUGGCAGAAAUGCAACUAACUAGUCAAAA,39,18,20,16,93
135,1,AACY023655795.1/998-903,AUUGAACAUCAAGAGUGGGAUUAAGUUCUCCUCCAACCUGCCAACUCCGGCAAGGUGGAAAAGCGAUGUGGUUAACCAACAACUAAAGGAGAAAAA,36,18,22,20,96
136,1,AACY022879010.1/492-584,AAGAAGCAUGUAGAGAAGGUUAAGACCUCAGCAACCUGGAAGACUAUCCAAGGUGCUUGAAGAUGUGGCAGAAAUGCAACUAAAUAGUCAGAA,37,17,24,15,93
137,1,AACY023493356.1/1222-1127,GGUUUGAAUCUAGAGCAGGAUUAAAUUCCUCUCCAACCUGCCCUCUCCGGCAAGGUGGAAAAGUGAUUCGGUUAACCAACAAAUAAAGGAGUUAAA,32,23,21,20,96
138,1,AACY023286370.1/1537-1449,AUUAUGCAUGAAGAGAGGGCAACCUCAGCAACCUAGAAAGCAAACAAAGGUGCUAAAGAUGCGGUUUUUUAAACAAAAAAUAUGCUUAU,37,20,18,14,89
139,1,AACY020444019.1/956-835,CGUCGUUAUCAAGAGCGGCGCACAUUCGUGUGCCCAGCAACCUGGGGUGGACACCCAAGGUGCUUUCCUACUUUGUAGGGAUAUGGCGACGGCUCUAAGUCGGCGCAACAAAGUGUCCCAUG,26,27,36,33,122
140,1,AACY020490313.1/636-544,UAGGAACAUAAAGAGAAGGUUAAGACCUCGGCAACCUGGAAGACUAUCCAAGGUGCUUGUAGAUGUGGCAGUAAUGCAACUAAUUAGUCGUAC,32,21,24,16,93
141,1,AACY023572833.1/528-430,AUCCUGUAUCAAGAGCAGAGUUAAUUCUCUCUCCAACCUGCUAACUUCUAGCAAGGUGGAACAAAUGAUACGGCUAUUCACGCAACUAAAAGGAGAUCA,34,24,18,23,99
142,1,AACY022364730.1/503-404,AUUAAGCAUCAGGAGUGAAUAAGUAAUUAUUCUGCCAACCUGCUUAGAGGAAAGUAAGGUGGAGUAGGAUGUGGUCUUAAUGACAAUUAAGUUCCUCAUC,33,29,24,14,100
143,1,CP000533.1/31707-31598,GUUCAACAUCAGGAGUUGGACAGUAGUGUCCACGCCAACCUGCCUACUCGGGCAAGGUGGUAUCGCUUAUGCAGAUGGGGCCUUUAAACAAGGUAACCAAACGAGUCCCU,29,24,29,28,110
144,1,AACY022756908.1/132-29,GCGCUACAUCACGAGCGACCAUACGGUCCGGCAACCGGGAAUCCACGGUGCCAAGUCACUUCGGUGACGAUGUGGCCCCGCAAGGGGCAACGGAUCGCAUGGUG,23,15,34,32,104
145,1,AACY022689574.1/326-418,AAGGAACAUAAAGAGAAGGUUAAGACCUCGGCAACCUGGAUGACUAUCCAAGGUGCUUGAAGAUGUGGCAGAAAUGCAACUAAGUAGUCAAAC,36,17,24,16,93
146,1,AACY022809384.1/289-381,AUUAAGCAUAAAGAGAAGGUUAAGACCUCGGCAACCUGGAUGGCUAUCCAAGGUGCUAGAAAAUGUGGCAGAAAUGCAACUAAAUAGUCAAAA,38,18,22,15,93
147,1,AACY020290243.1/3798-3706,AUUAAGCAUAAAGAGAAGGUUAAGACCUCGGCAACCUGGAAGGCUAUCCAAGGUGCUUGAAGAUGUGGCAGAAAUGCAACUAAUUAGUCAAAA,36,19,23,15,93
148,1,AACY020219775.1/1020-1116,CAUCAACAUCAAGAGAAAGAUUGGGUUCUUCUCCAACCUGCUAACUCAGGCAAGGUGGAAUAAAAGAUGUGGUUAACCAACAAUUAAAUGAGGUAAU,37,23,20,17,97
149,1,AACY020401066.1/1365-1271,UAUGUAUAUCAUGAGAAGGAUUUAUUUCCUCUCCAACCUGCCAACUCCGGCAAGGUGGAAAAAAGAUAUGGCGUUCGGCAAAUAAAGGAGGAAAG,33,22,23,17,95
150,1,AACY022955029.1/106-192,UAAAUGCAUAGAGAGAGGAAUUCCUCAGCAACCUAGUUGCCAACCAAGGUGCUUUUUGAUGUGGUUAUACAACAAAAAAUGGCGUUC,29,23,19,16,87
151,1,AACY023730967.1/1126-1215,UAAAAGCAUUAAGAGAGGGUAAUUACCUCAGCAACCUGGAAGGCUACCAAGGUGCUAAGAAGAUGUGGCUUUAAGCAAAAAAGAGCCAAU,36,17,22,15,90
152,1,AACY020838872.1/555-460,UUAAUGUAUCAAGAGAAGGAUUAAAUUCCUCUCCAACCUGCCAACUCCGGUAAGGUGGAAAAAAGAUGCGGUUAACCAACAAUUAAAGGAGUUAAA,38,22,19,17,96
153,1,CP000360.1/5414708-5414585,UUCCAGCAUCAGGAGUGUCCUGGCCGCUUUAAGCCAGGUCCGGCAACCGAGCUUUGGAGACGCUACGGUGCCACGAGUCGCAAGACUCAAUGUGCGGACGAAAGUCCGAAAGGAUGUCUCCCGA,29,23,37,35,124
154,1,AACY020495403.1/2582-2676,UAUGUAUAUCAUGAGAAGGAUUUAUUUCCUCUCCAACCUGCCAACUCCGGCAAGGUGGAAAAAAGAUAUGGCGUUCGGCAAAUAAAGGAGGAAAG,33,22,23,17,95
155,1,AACY021913758.1/688-597,GUUUAGCAUCAAGAACGCUUAUGCGUACCAACCGACACGCUCGUUGCACGGUGGUUUAGAAUGCGGGGCUCCUCCCAAAAAAACGAGAAAUC,27,19,22,24,92
156,1,AACY020195299.1/11-103,AAUGAGCAUAAAGAGAAGGUUAAGACCUCGGCAACCUGGAUGGCUAUCCAAGGUGCUAGAACAUGUGGCAGAAAUGCAACUAAAUAGUCAAAA,37,17,23,16,93
157,1,AACY023064355.1/203-105,GAACAACAUCUAUAGAGAAGCUUAUGCUUCACCAACCUGCCAAGAUCUGGCAAAGGUGGUUCAACGAUGUGGCUUUAAUUAGCAACAAUAAGAUCGUAG,34,24,21,20,99
158,1,AACY023328494.1/1231-1341,AUCCAACAUCAAGAGUGACUCAGCAAUGAGUACAGCAACCGAGCCAGCCAGGCCGCGGUGCUUCCCGCCAGGGGAUGUGAUGCACGAAAGUGUAUAAAAACUUCUGGCCCU,32,19,29,31,111
159,1,AACY023384040.1/1454-1362,UUAAAGCAUAAAGAGAAGGUUAAGACCUCGGCAACCUGGAUGGCUAUCCAAGGUGCUAGAAAAUGUGGCAGAAAUGCAACUAAAUAGUCAAAA,38,18,22,15,93
160,1,AACY023968756.1/852-755,UAUCAUCAUCAGGACGGGAGAAAUCCCACCAACCGAGCUUAGGCCACGGUGGUUUGUCAAGUGACAGAUGAGCAGCAAUGCUGAAAAUAUCUGAAACC,32,19,24,23,98
161,1,AACY022418261.1/564-678,AUGUAUCAUCAGGAGCGGUUUCAGGAAAGAAACCCACCAACCGAGCCUCAAAGCUACGGUGGUUAGUUCCAUUAAACGGGAGAUGUGCCUUGAAAAAGGAAAAAUGGAGCCGCCU,38,22,30,25,115
162,1,AACY021029522.1/357-450,AUCUUGCAUCCCGAACCCUUUAGUGGGUGCCAACCGAGCAGAGAAGCCACGGUGGCAAAACGAUGCGGGCAUUAUGCCAAAACAUAUUCCGAGA,28,17,24,25,94
163,1,AACY020465783.1/343-252,ACAGUGCAUGAAGAGAGGGAAACCUCAGCAACCUAGAAAGCAAACAAAGGUGCUUCAAAUGCGGUUUUUUAUAGACAAAAAAAUAUGCUAUU,38,20,19,15,92
164,1,AACY020097780.1/583-491,AAUAAGCAUAAAGAGAAGGUUAAGACCUCGGCAACCUGGAUGACUAUCCAAGGUGCUUGAAGAUGUGGCAGAAAUGCAACUAAAUAGUCAAAC,37,18,22,16,93
165,1,AACY020495310.1/1138-1046,AAGAAGCAUAAAGAGAAGGUUAAGACCUCGGCAACCUGGAUGACUAUCCAAGGUGCUUGAAGAUGUGGCAGAAAUGCAACUAAGUAGUCAAAC,36,17,24,16,93
166,1,AACY023483956.1/181-273,CAUAAGCAUAUAGAGAAGGUUAAGACCUCGGCAACCUGGAAGACUAUCCAAGGUGCCUGAAGAUGUGGCAGAAAUGCAACUAAAUAGUCAAAG,36,17,23,17,93
167,1,AACY023164875.1/482-386,AAAAAGCAUCAAGAGCAGAGUUAAGUCUCUCUCCAACCUGCCAACUCCGGCAAGGUGGAACAAAUGAUGCGGUUGUUCAACAAAUAAUGGAGAUAAA,37,19,21,20,97
168,1,AACY022012118.1/281-394,AUUCAACAUCAGGAGCGGUUUCAAAACUGUAACCCGCCAACCGACCCAAAUGGGCACGGUGGUUAGAUCCUUAAGCGGUAGAUGUGCCUUUGAUUAGGAAAUCUUAAAAGCUGC,34,27,27,26,114
169,1,AACY020498997.1/1130-1217,UAAUUGCAUAAAGAGAGGGAAACCUCAGCAACCUAGUUGCCAACUAAGGUGCUUUUUGAUGUGGUUAAAUAACAAAAAAUGGCUUCUU,31,25,18,14,88
170,1,AACY020277418.1/1687-1600,AAAAAGCAUGGAGAGAGGUAAAGCCUCAGCAACCUAGAAAGCUAACUAAGGUGCUUUAAUAUGUGGUUUAAAACAAAAAAUAGCUUUU,37,21,18,12,88
171,1,AACY020084959.1/695-784,GCGUCACAUCAAGAAUACUUAAGUGUAUACCAACCGGACGAUAACGGUGGUUUAGCGAUGUGGGCAUCACAGUCAAAAUCGAUUCUCAUA,29,22,20,19,90
172,1,AACY024060958.1/479-571,AGUAGACAUAAAGAGAAGGUUAAGACCUCAGCAACCUGGAUGACUAUCCAAGGUGCUUGAAGAUGUGGCAGAAAUGCAACUAAAUAGUCAGAA,37,18,23,15,93
173,1,AACY020146386.1/1428-1520,GAGGAACAUAAAGAGAAGGUAAAGACCUCGGCAACCUGGAAGACUAUCCAAGGUGCUUGAAGAUGUGGCAGAGAUGCAACUAAGUAGUCAAAA,37,15,26,15,93
174,1,AACY023656688.1/97-2,AAUAUGCAUUAAGAGUGAGAUUAAUUUCUCCUCCAACCUGCCAACUCCGGCAAGGUGGAAAAGUGAUGCGGUUAUUCAACAAUAAAGGAGUAGAAA,35,23,21,17,96
175,1,AACY021071260.1/590-498,AAGAAGCAUAAAGAGAAGGUUAAGACCUCGGCAACCUGGAUGACUAUCCAAGGUGCUUGAAGAUGUGGCAGAAAUGCAACUAAGUAGUCAAAC,36,17,24,16,93
176,1,CP000759.1/851733-851842,ACAUCACAUCAAGAGUUGGGGAGACGCCCAACGCCAACCUGCCUCUCCGGGCAAGGUGGUACUCUCUGUAAAGAGAGGAUGUGGCCAAACCGGCAAAUAUACGGACAAAG,34,17,30,29,110
177,1,AACY021667883.1/657-543,UGUCAUCAUCAGGAGUGAUCUUUAAGUAAAGAUCCACCAACCGAGCCUAAAAGCUACGGUGGUUAGUUCCAUUAAACGGAGGAUGUGCCUUGAAGAAGGAAAAAGUGGAACCGCC,38,25,29,23,115
178,1,AACY021285989.1/46-140,AAUAUAUAUCAUGAGAAGGAUUUAUUUCCUCUCCAACCUGCCAACUCCGGCAAGGUGGAAAAAAGAUAUGGCGUUCAGCAAAUAAAGGAGGUAUG,34,23,21,17,95
179,1,AACY023441040.1/452-343,AAUCAGCAUCUAGAAGCACCUCGAAAGAGGUGUGGCAACCGAGCCCACCAGGCCACGGUGCCUCCCAACAACGGGGAUGCGGCGCGACGAGCGCAAAAGAACUGGUGCUC,31,12,33,34,110
180,1,AACY023871234.1/221-126,AUCGAACAUCAAGAGUGAGAUUAAGUUCUCCUCCAACCUGCCAACUCCGGCAAGGUGGAAUAAAGAUGUGGUUAAUCAACAAAUAUAGGAGUAAAC,36,21,20,19,96
181,1,AACY020516175.1/1516-1608,AGUAAGCAUAUAGAGAAGGUUAAGACCUCAGCAACCUGGAAGACUAUCCAAGGUGCUUGAAGAUGUGGCAGAAAUGCAACUAAAUAGUCAGAA,37,18,23,15,93
182,1,AACY021320796.1/390-273,UAAAGGCAUUACGAGUGGUCUGGUUAAAACUAGAUCCGGCAACCUGGGAGGACACCCAAGGUGCCCGCUCAUCCGCAAGGAAGAGGAUGUGGCCUGAAAGGGCAACAAAGUGUCCGGU,34,20,37,27,118
183,1,AACY023285819.1/1291-1383,UGUAAGCAUAUAGAGAAGGUUAAGACCUCGGCAACCUGGAAGACUAUCCAAGGUGCCUGAAGAUGUGGCAGAAAUGCAACUAAAUAGUCAAAG,35,18,24,16,93
184,1,AACY023113558.1/484-580,AAAAAGCAUCAAGAGCAGAGUUAAGUCUCUCUCCAACCUGCCAACUCCGGCAAGGUGGAACAAAUGAUGCGGUUGUUCAACAAAUAAUGGAGAUAAA,37,19,21,20,97
185,1,AACY022004743.1/542-637,ACCCUGUAUCUUGAGCAGGAUUUAAUUCCUCUCCAACCUGCCUACUCCGGCAAGGUGGAAAAACGAUACGGUUAAUCAACAAUUAAAGGAGAGAAA,33,22,19,22,96
186,1,AACY023720466.1/280-394,UUGCGUUAUCAAGAGCGGUGCACUUCCGUGCACCCGGCAACCUGGGGUGGACACCCAAGGUGCUUUCCUACUUUGUAGGGAUAUGGCUGAGGUCUACGACCAAAGCAACAAAGUG,27,26,33,29,115
187,1,AACY023630570.1/819-723,UAUUGGUAUCAAGAGCGGGAUUAAAUUCUCCUCCAACCUGCCAACUCCGGCAAGGUGGAAAAAAUGAUGCGGUUAACCAACAACCAAAGGAGUCUAA,34,20,21,22,97
188,1,AACY020145665.1/933-841,ACUAGACAUAAAGAGAAGGUUAAGACCUCAGCAACCUGGAUGGCUAUCCAAGGUGCUUGAAGAUGUGGCAGAAAUGCAACUAAAUAGUCAAAA,37,18,22,16,93
189,1,AACY020253539.1/634-726,AUUAAGCAUAAAGAGAAGGUUAAGACCUCGGCAACCUGGAAGACUAUCCAAGGUGCUUGAAGAUGUGGCAGAAAUGCAACUAAUUAGUCAAAA,37,19,22,15,93
190,1,AACY020183603.1/425-534,AACCAGCAUCUAGAAACACCUCGAAAGAGGUGUGGCAACCGAGCCCACCAGGCCACGGUGCCUCCCGACAACGGGGAUGCGGCGCGACGAGCGCAAAAGAACUGGUGCUC,31,11,33,35,110
191,1,AACY021642302.1/326-240,UGAAUGCAUAGAGAGAGGAAUUCCUCAGCAACCUAGUUGCCAACUAAGGUGCUUUUUGAUGUGGUUAUACAACAAAAAAUGGCGUUC,28,24,20,15,87
192,1,AACY020117021.1/502-410,UAAAAGCAUAAAGAGAAGGUUAAGACCUCGGCAACCUGGAUGACUAUCCAAGGUGCUAGAAAAUGUGGCAGAGAUGCAACUAAAUAGUCAAAA,39,17,22,15,93
193,1,AACY023618809.1/135-43,UUAAAGCAUAAAGAGAAGGUUAAGACCUCGGCAACCUGGAUGACUAUCCAAGGUGCCCGGAAAUGUGGCAGUGAUGCAACUAAAUAGUCAAAA,35,18,23,17,93
194,1,AACY022004864.1/199-318,UAGAGGUAUGAGGAUUGCCUCGCUAACCCGAAGGUGAGGCUGCCAACCGAGCACGUGCCACGGUGGCCGAAUCUUAAUGAGAUUCCAUAUGUUGGAUUAACCAAAAAAAGGAGCCCUAUG,35,25,33,27,120
195,1,AACY023370451.1/640-734,GCCAUGCAUCCAGAGUAGGAGCUAGCUCCUCGCCAACCUGCAACUCCAAAGCAAGGUGGCCAAAUGAUGCGGCAAUCGCAACCAAUUGGAGAACA,30,14,23,28,95
196,1,AACY020315257.1/171-263,UUACGACAUCAAGAACGCAUAUGCGUACCAACCGACUAUCUCGAAGCACGGUGGUUUAGAAUGUGGGUAGCUCUACCAAAAAUUCGAGCAAUC,30,21,20,22,93
197,1,AACY023285819.1/50-138,UAUUUGCAUAAAGAGAGGGAAACCUCAGCAACCUAGAAUGCCAACCAAGGUGCUUUUUGAUGUGGUUUUACAACAAAAAAUGGUAAUUA,33,24,18,14,89
198,1,AACY020806376.1/43-140,GCUCUGCAUCAAGAGCCGACUUGUCGGCGCCAACCUGCCUCCCCGGGCAAGGUGGCUAGCGAAAGCGGAUGCGGCCUUGAGGCAACCAAGCGGGAGCA,21,13,33,31,98
199,1,AACY020587818.1/348-440,CAUAAGCAUAUAGAGAAGGUUAAGACCUCGGCAACCUGGAAGACUAUCCAAGGUGCCUGAAGAUGUGGCAGAAAUGCAACUAAAUAGUCAAAG,36,17,23,17,93
200,1,AACY023404581.1/902-810,UAGAAGCAUAAAGAGAAGGUUAAGACCUCGGCAACCUGGAUGACUAUCCAAGGUGCUAGAAAAUGUGGCAGAGAUGCAACUAAGUAGUCAAAA,37,17,24,15,93
201,1,AACY020099146.1/973-881,UCUAAGCAUAAAGAGAAGGUUAAGACCUCGGCAACCUGGAUGGCUAUCCAAGGUGCUAGAAAAUGUGGCAGAAAUGCAACUAAAUAGUCAAUA,36,19,22,16,93
202,1,AACY020281887.1/1346-1438,CAUAAGCAUAUAGAGAAGGUUAAGACCUCGGCAACCUGGAUGACUAUCCAAGGUGCCUGAACAUGUGGCAGAAAUGCAACUAAUUAGUCGAAG,33,19,23,18,93
203,1,AACY020641585.1/375-271,GAUGAGCAUCAAGAGCGUCGUCGGGAUGGUCCCGACACCACCAACCGGUCCUCCAUCCGGUGGUUCCCAUCUUGGGGAUGCGGCCCUUAGGGCAAAGGAGGCCAU,21,19,33,32,105
204,1,AACY021235322.1/323-221,ACCACGCAUUAAGAGAGGACUGAUGUCCCGCCAACCUGCGUGUUCCAGCAAGGUGGUUGCCUUAAUUAGGCGAUGAGACCUAAGGGUAACCAACGGGUCAUCA,28,21,28,26,103
205,1,AACY023418101.1/1085-1180,UUUUUGUAUCUUGAGCAGGAUUUAAUUCCUCUCCAACCUGCCUACUCCGGCAAGGUGGAAAAACGAUACGGUUAAUCAACAAUUUAAGGAGAAAAA,32,27,18,19,96
206,1,AACY020430580.1/2307-2395,AAAAUGCAUGGAGAGAGGACAAAUCCUCAGCAACCUAGAGAGCUAACUAAGGUGCUUAAAUAUGUGGUUUAUAACAAAAAAUAGCUUUC,36,21,18,14,89
207,1,AE017224.1/745625-745733,ACCGCACAUCCAGAGUUGGGGCGACGCCCAACGCCAACCUGCCGUUCCGGGCAAGGUGGUACUCCCCGAAAGGGAGGAUGUUGCCGAACCGGCAAUUAUACGGAUGAAG,27,16,34,32,109
208,1,CP000248.1/722861-722994,CCCCAACAUCGAGAGUUGGGGUGACGCUCCAACGCCAACCUGCCGUUCCGGGCAAGGUGGUACCCGAUCCGCAAGGCGGCCCCGGCCGAAUUGCGAAAGGGGAUGUGGCCGAUCCGGCAACCAAACGGACACGG,30,16,44,44,134
209,1,AACY023474639.1/280-367,UAAAUGCAUAGAGAGAGGAAUUCCUCAGCAACCUAGAUGCCAACUAAGGUGCUUUUUGAUGUGGUUAUACAACAAAAAAUGGCGUUCC,30,23,19,16,88
210,1,AACY020490715.1/511-419,AUAAAGCAUAAAGAGAAGGUUAAGACCUCGGCAACCUAGAUGACUAUCCAAGGUGCUCAGAAAUGUGGCAGAAAUGCAACUAAAUAGUCAAAA,40,17,20,16,93
211,1,AACY021211837.1/282-374,UCUAAGCAUAAAGAGAAGGUUAAGACCUCGGCAACCUGGAUGACUAUCCAAGGUGCUUGGAAAUGUGGCAGAAAUGCAACUAAAUAGUCAAAA,36,19,22,16,93
212,1,AACY020050185.1/855-953,AUUAAGCAUCAGGAGUGAAUAAGCAAUUAUUCUGCCAACCUGCUUGAGGAAAGUAAGGUGGAAUACGAUGUGGUCUUAAUGACAAUUAAGUUCCUCAUC,33,28,22,16,99
213,1,AACY021824918.1/619-528,UAUUAGCAUCAAGAACGCUUAGCGUACCAACCGACUAUUUCGAAGCACGGUGGUUUAGAAUGUGGGUAGCUCUGCCAAAUUUUCGAGCAAUC,26,25,21,20,92
214,1,AACY023374497.1/754-846,ACUUUGCAUCAAGAACGCAAUGCGUACCAACCGACAUACUCGAUGCACGGUGGUUUAGAAUGCGGAGAAUAACUCUCAAAUUUUCGAGUAAUC,30,23,19,21,93
215,1,AACY023933995.1/1174-1268,CCAGUGUAUCAAGAGUGAGAUUAAAUUCUCCUCCAACCUGCCCACUCCGGUAAGGUGGAAAAACGAUACGGCAAUCUGCAAUACAAGGAGGAAAC,33,18,21,23,95
216,1,CP000533.1/62361-62468,GCUCAUCAUUAAGAGAUGGGUUGACGCCCACACCAACCUGCCAUUCGGGGCAAGGUGGUUUGCUUUCAAGCAGAUGUGGCUCCUCGAAGAGCAACCAAGCCGGCAGCG,26,21,31,30,108
217,1,AACY020146386.1/192-278,UAAAUGCAUAGAGAGAGGAAUACCUCAGCAACCUAGUAGCCAACUAAGGUGCUUUUUGAUGUGGUUAAACAACAAAAAUUGGCGUUC,31,22,19,15,87
218,1,AACY020195427.1/941-1036,UAUCAGCAUCAAGAGUAGGAUUAAAUUCCUCUCCAACCUGCCACUCCGGCAAGGUGGAAAAAAUGAUGUGGUUAACCAACAACUAAAGGAGUUAAA,36,21,19,20,96
219,1,AACY021970555.1/127-221,UUUGUACAUCAAGAGUGAGAUUAAGUUCUCCUCCAACCUGCCACUCCGGCAAGGUGGAAAAAAGAUGUGGUUAACCAACAAUUAAAGGAGUUAAA,34,23,20,18,95
220,1,AACY021623362.1/963-874,GCGCUACAUCAAGAAUACUUAAGUGUAUACCAACCGAACGAUAACGGUGGUUUAACGAUGUGGGCAUCCUAGUCAAAGUCGAUUCUCAUA,29,23,19,19,90
221,1,AACY022325607.1/259-357,AUAGUACAUCAGGAGUGAAUAAGAAAUUAUUCCGCCAACCUGCUUGAGGAAGUAAGGUGGCAGAGAAUGUGGUCUUAAUUGACAAUUUGGUUCCUCGUU,30,29,25,15,99
222,1,AACY023427826.1/25-137,CUUCAGCAUCACGAGUGACCGGGAAACCGGUCCGGCAACCGGGGUUGGUCCACGGUGCCAGCUCAAUCGGCAACGGUUGGGGAUGUGGCGGGAAACCGCAACGGGCCCGGUCC,22,16,41,34,113
223,1,AACY020342180.1/1693-1601,GAGAAGCAUAUAGAGAAGGUUAAGACCUCGGCAACCUGGAUGACUAUCCAAGGUGCUUGAAGAUGUGGCAGCAAUGCAACUAAGUAGUCAAAG,33,18,26,16,93
224,1,AACY020160892.1/861-956,AAUGUGUAUCUAGAGCAGGAUUAAAUUCCUCUCCAACCUGCCUACUCCGGCAAGGUGGAAAAAUGAUGCGGUUAACCAACAAUUAAUGGAGUUAUA,32,25,20,19,96
225,1,AACY020443119.1/958-870,GGUUUGCAUAAAGAGAGGGAAUCCUCAGCAACCUAGAUUACCAACUAAGGUGCUUUUUGAUGUGGUUUAACGACAAAAAAUGGUAUUUU,29,27,20,13,89
226,1,AACY023449668.1/862-748,AAUUAUCAUCAGGAGUGAUCUUUAAGUAAAGAUCCACCAACCGAGCCUAAAAGCUACGGUGGUUAGUUCCAUUAAACGGAGGAUGUGCCUUGAAAAAGGAAAAAGUGGAACCGCC,41,25,27,22,115
227,1,AACY023089372.1/160-256,GAGAAGCAUUAAGAGCAGAGUUAAGCCUCUCUCCAACCUGCCAACUCCGGCAAGGUGGAACAAAUGAUGCGGUUGUUCAACAAAUAAUGGAGAUAAA,35,19,23,20,97
228,1,AACY021754793.1/61-153,AUAAAGCAUAAAGAGAAGGUUAAGACCUCGGCAACCUGGAUGACUAUCCAAGGUGCUCGGAAAUGUGGCAGAAAUGCAACUAAGUAGUCAACA,36,17,23,17,93
229,1,AACY023360051.1/671-573,AUAAUGCAUCAAGAGUGGAUAAUAAAUUAUUCCGCCAACCUGCUUGAGGAAGUAAGGUGGCAGAGAAUGUGGUCUUAAUUGACAAUUAGGUUCCUCGUU,31,29,24,15,99
230,1,AACY023913045.1/570-665,CAAUAGCAUCAAGAGCAGGAUUAAAUUCCUCUCCAACCUGCCACUCCGGCAAGGUGGAAAAAAUGAUGUGGUUAACCAACAACUAAAGGAGUUAAA,37,19,19,21,96
231,1,AACY023273183.1/156-55,UCCACGCAUUAAGACUUGGGAGACCAAGCCAACCUGCCGGUCCAGGCAAGGUGGUUACGAGAAAUCGGAUGUGAGCUAUUUCAAGCUAACAAAUGGACUCUC,30,21,26,25,102
232,1,AACY020104876.1/245-370,AGUUAAUAUCAAGAGCAGUUCAUAUUUAAGAACUCACCAACCGGGCUCAGAUCAAUCAGAGAAUCGGUGGUAUUAGCCUUAAUCGCUAGAUGUGCCCAGGAAAAUGGGAAAUGUAAAGCCGCAAUU,44,30,28,24,126
233,1,AACY020188276.1/838-930,AAGAAGCAUAAAGAGAAGGUUAAGACCUCGGCAACCUGGAUGACUAUCCAAGGUGCUUGAAGAUGUGGCAGAAAUGCAACUAAGUAGUCAAAC,36,17,24,16,93
234,1,AACY023700707.1/1037-950,UAGUUGCAUAAAGAGAGGGAAACCUCAGCAACCUAGUUGCCAACUAAGGUGCUUUUUGAUGUGGUUUAACAGCAAAAAAUGGCAUCCC,29,22,20,17,88
235,1,AACY023108908.1/316-224,AGUAGACAUAAAGAGAAGGUUAAGACCUCAGCAACCUGGAUGACUAUCCAAGGUGCUUGAAGAUGUGGCAGAAAUGCAACUAAAUAGUCAAAA,38,18,22,15,93
236,1,AACY023737247.1/614-523,AAGAUGCAUUAAGAAAGGGGUUAUCCCUGCCAACCUGCAUACCGUGCGAAGGUGGUAAUAUAUGCGGCCAAAAAGGCAAAAAUUAGGUCUCA,32,19,23,18,92
237,1,AACY021860279.1/473-572,AUUAAGCAUCAGGAGUGAAUAAGAAAUUAUUCUGCCAACCUGCUUUGAGGAAAGUAAGGUGGAGUAGGAUGUGGUCUUAAUGACAAUUAAGUUCCUCAUC,33,29,24,14,100
238,1,AACY023370035.1/1421-1515,AAUGCGUAUCUAGAGCAGGAUUAAAUUCCUCUCCAACCUGCCACUCCGGCAAGGUGGAAAAAUGAUGCGGUUAACCAACAAUUAAUGGAGUUAUA,32,23,20,20,95
239,1,AACY021424810.1/386-491,AAGAUACAUGAAGAGAGGACUGACGUCCCGCCAACCUGCUAGAUCCGGCAAGGUGGUUUCCUUUUUUAAAAAGGCAUGUGACCUUCGGGUAACAAUGGGGUCCAUG,29,25,29,23,106
240,1,AACY020505932.1/1795-1882,UAAAUGCAUAGAGAGAGGGAUACCUCAGCAACCUAGAUGCCAACUAAGGUGCUUUUUGAUGUGGUUAUACAACAAAAAAUGGCGUUCC,30,22,20,16,88
241,1,AACY023537168.1/911-823,GGUUUGCAUAAAGAGAGGAAAUCCUCAGCAACCUAGAAUACCAACUAAGGUGCUUUUUGAUGUGGUUUUACAACAAAAGAUGGUAUUUC,30,26,19,14,89
242,1,AACY023909420.1/125-3,AUAAAGCAUCAGGAGCGGUUUCAAGUUGAAACCCGCCAACCGAACUUAGAAAAAUCAAAGUUACGGUGGUUUGAUCCUUAAACGGUAGAUGUGCCUAGGAAAAUAGGAAACAUGAUUAGCCGC,44,27,29,23,123
243,1,AACY020249953.1/1780-1874,GUCGAAUAUCACGAGAAGGAUUUAUAUCCUCUCCAACCUGCCAACUCCGGCAAGGUGGAAAAAUGAUAUGGCGUUCAGCAAUCAUAGGAGGAAAU,32,21,22,20,95
244,1,AACY020048217.1/4787-4698,AUCUUGCAUGAAGAGAGGGUAACCUCAGCAACCUAGAAAGCAAACAAAGGUGCUAGAGAUGCGGUUUUUUAAAACAAAAAAUAUGCUACC,36,19,19,16,90
245,1,AAFX01125835.1/348-230,UUGGUGCAUCCAGAGCGGCUCGCCCGACGCGGUGAGCCCGGCAACCUGCCCGGACCGGCAAGGUGCUUCGCGCAAACCCAGCGCAGAUGUGGCCCAUAGCGGCAACACGAGGUCCAGCC,23,14,39,43,119
246,1,AM421808.1/441618-441728,GCGCUGCAUUAAGAGUUGGGAAUUCCAUGCCAACCUGCUUUUCAAAAGGAAAAGUAAGGUGGACGGUUGAAAAGCCGAUGUGGCUCACCAGAGCAAUCCAAACCCGCUUGA,34,23,29,25,111
247,1,AACY023277031.1/313-409,AGGAUUCAUCAAGAGUGGGAUUAAGUUCUCCUCCAACCUGCCAACUCCGGCAAGGUGGAACAAGUGAUGAGGUUAACCAACAACUAAUGGAGUUACA,32,21,23,21,97
248,1,AACY020517867.1/661-753,AGUAAGCAUAUUGAGAAGGUUAAGACCUCAGCAACCUGGAAGACUAUCCAAGGUGCUUGAAGAUGUGGCAGAAAUGCAACUAAAUAGUCAGAA,36,19,23,15,93
249,1,AACY023474639.1/1515-1607,AAGAAGCAUAAAGAGAAGGUUAAGACCUCGGCAACCGUGGAUGACUAUCCAAGGUGCUUGAAGAUGUGGCAGAAAUGCAACUAAGUAGUCAAA,36,17,25,15,93
250,1,AACY020151691.1/305-217,AAAAAGCAUGGAGAGAGGUCAAAACCUCAGCAACCUAGAAAGCUAACUAAGGUGCUUAAAUAUGUGGUUUAUAACAAAAAAUAGCUUUC,38,20,17,14,89
251,1,AACY024062246.1/396-491,GAUAUUCAUCAAGAGUGAGAUUAAAUUCUCCUCCAACCUGCCAACUCCGGCAAGGUGGAAAAAUGAUGGGGUUAAUCAACAAUUAAAGGAGUAAGA,36,22,21,17,96
252,1,AACY022716812.1/476-599,UAAUAUCAUCAGGAGCGGUUUCGUAUUUGAAACCCACCAACCGAGCCCAGAUAAAUCAUGGUCACGGUGGUUAGAGCCUUAAACGCUAGAUGCGCCCAGGAAAAUGGGAAACAUGAUUAGCCGC,39,26,30,29,124
253,1,AACY022857067.1/564-478,UGAGUGCAUAUAGAGAGGAAUACCUCAGCAACCUAGUUGCCAACUAAGGUGCUUUUUGAUGUGGUUAUACAACAAAAAAUGGCGUUC,28,24,20,15,87
254,1,AACY022335763.1/106-11,AAAUUGUAUCAAGAGCAGGAUUUAAUUCCUCUCCAACCUACCUACUCCGGCAAGGUGGAAAAAUGAUGCGGUUAAUCAACAAUUAAUGGAGGUAAC,34,24,19,19,96
255,1,AACY020212291.1/117-209,ACUAAGCAUAAAGAGAAGGUUAAGACCUCGGCAACCUGGAUGGCUAUCCAAGGUGCUAGAAAAUGUGGCAGAAAUGCAACUAAAUAGUCAAAA,38,17,22,16,93
256,1,AACY022092685.1/448-536,AAAAAGCAUGGAGAGAGGGUAAAACCUCAGCAACCUAGAUAGCUAACUAAGGUGCUUAAAUAUGUGGUUUAUAACAAAAAAUAGCUUUU,37,22,18,12,89
257,1,AACY020516175.1/278-365,AAAAAGCAUGGAGAGAGGUAAAGCCUCAGCAACCUAGAAAGCUAACUAAGGUGCUUUAAUAUGUGGUUUAUAACAAAAAAUAGCUUUU,36,22,18,12,88
258,1,AACY020475741.1/547-639,GUUUUGCAUCAAGAACGCUAAUGCGUACCAACCGACACGCUCGUUGCACGGUGGUUUAGAAUGCGGGUAGCUCUACCAAACAAAUCGAGCUAA,27,21,22,23,93
259,1,AACY020353810.1/1121-1029,UUUAAGCAUAAAGAGAAGGUUAAGACCUCGGCAACCUGGAUGGCUAUCCAAGGUGCCUAAAGAUGUGGCAGAAAUGCAACUAAGUAGUCAAAA,35,19,23,16,93
260,1,AAOA01000009.1/175160-175267,AAGGGGCAUCAAGAGGGGUUCGUCCCCACCAACCGCCCACUCCGGGAACGGUGGUUAAUCGAUGCGCCAUAGGCCCUGCUGCGCAGGUAUGGAACAAAAAGGAGAUAU,29,17,33,29,108
261,1,AACY021228520.1/864-751,UGAUAACAUCAGGAGAGAUUUCUAAGUAGAAAUCCACCAACCGAGCUAAAAGCUACGGUGGUUAGUUCCAUUAAACGGAGGAUGUGCCUUGAAAAAGGAAAAAGUGGAACCGCC,42,23,28,21,114
262,1,CP000459.1/271286-271389,AUCAAGCAUCCAGAGUCGGGUUUCCCGACGCCAACCUGCCCUCCCGGGCAAGGUGGACGCCCUCGAGGCGAUGCGGCCGAUUGACGGCAACGAAACGGGAGCAG,23,13,34,34,104
263,1,AACY023455732.1/308-395,UAAAUGCAUAAAGAGAGGGAUACCUCAGCAACCUAGUUGCCAACUAAGGUGCUUUUUGAUGUGGUUAUACAACAAAAAAUGGCGUUCC,30,23,19,16,88
264,1,AAGA01001063.1/1368-1271,AUAAAUUAUCAAGAAUCUCAAUAAAAGGAGAUAGCAACCUGCAAUAACAAGCAAGGUGCUAAAUAGAUAAGCCAAGUAAUUGGAACAAAUGUUAAAUC,47,21,16,14,98
265,1,AACY020259813.1/1669-1756,UAGUUGCAUAAAGAGAAGGAAACUUCAGCAACCUAGUAGCCAACUAAGGUGCUUUUUGAUGUGGUUAAAUAACAAAAAAUGGCUUCUU,32,25,18,13,88
266,1,AACY023410360.1/1196-1313,UAAUAUCAUCAGGAGUGGUUUCGUAGUUGAAACCCGCCAACCGUGCCCAGAUAAAUCAGGGAAGCGGUGGUUAGAGCCUUAAACGCUAGAUGUGCCUAGGAAAAUAGGAAACACAAAG,40,24,31,23,118
267,1,AACY021255928.1/715-620,UAAUCACAUCAAGAGAGGGUGAAAGCCCCGCCAACCAGCCUAAUCGGGCAACGGUGGUCUUAAGAUGCGACCCUUAGGGUAACAAUUCGAUUAAGG,30,18,25,23,96
268,1,AACY020492511.1/566-474,CAUAAGCAUAUAGAGAAGGUUAAGACCUCGGCAACCUGGAAGACUAUCCAAGGUGCCUGAAGAUGUGGCAGAAAUGCAACUAAAUAGUCAAAG,36,17,23,17,93
269,1,AACY020700407.1/737-642,AAUUUGCAUCAAGAGUGAGAUUAAUUUCUCCUCCAACCUGCCAACUCCGGCAAGGUGGAAAAGUGAUGCGGUUAUUCAACAAUUAAAGGAGUAGAA,33,24,21,18,96
270,1,AACY021067675.1/98-221,UAUCAACAUCAGGAGUGGUUUCAUAGUUGAAACCCACCAACCGAGCCUAGAUAAAUCAGGGAUCCGGUGGUUAGACCUCUAAAUGGUAGAUGUGCCCAGGAAAAUGGGAAACAUAAUAAGCCAC,43,26,29,26,124
271,1,AACY021918427.1/327-240,UAAAUGCAUAGAGAGAGGGAUACCUCAGCAACCUAGAUGCCAACUAAGGUGCUUUUUGAUGUGGUUAUACAACAAAAAAUGGCGUUCC,30,22,20,16,88
272,1,AACY022859046.1/406-504,GCAAUACAUCAUGAGUGAAUAAGAAAUUAUUCCGCCAACCUGCUUGAGGAAGUAAGGUGGCAGAGAAUGUGGUCUUAAUUGACAAUUAGGUUCCUCGUU,31,28,24,16,99
273,1,AACY023408551.1/1374-1279,AAUUAGUAUCAAGAGCAGAGUUAAGUCUCUCUCCAACCUGCCAACUCCGGUAAGGUGGAAAAAUUGAUGCGGCAUUCUGCAAUACAAGGAGAAAGA,34,21,22,19,96
274,1,AACY023567589.1/257-349,ACUUUGCAUCAAGAACGCAAUGCGUACCAACCGACAUACUCGAUGCACGGUGGUUUAGAAUGCGGAGAAUAACUCUCAAAUUUUCGAGUAAUC,30,23,19,21,93
275,1,AACY020047005.1/1120-1212,GAGGAGCAUAAAGAGAAGGUUAAGACCUCGGCAACCUGGAUGACUAUCCAAGGUGCUUGAAAAUGUGGCAGCAAUGCAACUAAGUAGUCAAAC,34,17,25,17,93
276,1,AACY023073430.1/619-524,UGCCAACAUCAAGAGAAGAGUAAAACUCUCGCCAACCUGCUGCUCCAGUAAGGUGGUACAAAAAGAUGAGGUCAUUCGACAAUGAUAGGAGUGUCA,34,19,23,20,96
277,1,AACY021750064.1/438-530,AUUAGACAUAAAGAGAAGGUUAAGACCUCAGCAACCUGGAUGACUAUCCAAGGUGCUUGAAGAUGUGGCAGAAAUGCAACUAAAUAGUCAAAA,38,19,21,15,93
278,1,CP000113.1/1123541-1123419,GCGCAGCAUCAAGAGCGGCCGCCGCCUCGCGCGGUGGCCCGACAACCUGGAGUCGGACCUCCAAGGUGUCCAAACGAUGCGGUUCGAGGAGCAGGGGCUCCCCGAGCAAUCCAAGCGUCCGAA,26,14,41,42,123
279,1,AACY023438706.1/681-781,CACCAUCAUCAAGAAUGCAGAAGAACACUGCAUACCAACCGAGCAGCCAAGCAGCGGUGGUCAAUCGAUGAGGACCAAAAACGUCAAAAAAAUGGAAAUCA,43,12,21,25,101
280,1,AACY023453966.1/898-811,UAAAUGCAUAGAGAGAGGGAUACCUCAGCAACCUAGAUGCCAACUAAGGUGCUUUUUGAUGUGGUUAUACAACAAAAAAUGGCGUUCC,30,22,20,16,88
281,1,AACY023562779.1/750-661,ACACUACAUCAAGAAUACUUAAAUGUAUACCAACCGAACGAUAGCGGUGGUUAAGCGAUGUGGGCAUCACAGUCAAAAUCGAUUCUCAUA,33,21,17,19,90
282,1,AACY023110182.1/387-483,AAGUGGUAUCAAGAGCAGAGUUAAGUCUCUCUCCAACCUGCCAACUCCGGCAAGGUGGAACAAAUGAUGCGGUUGUUCAACAAUUAAAGGAGAUAAA,34,21,23,19,97
283,1,AACY020114069.1/1282-1374,CGUAAGCAUAAAGAGAAGGUUAAGACCUCGGCAACCUGGAAGACUAUCCAAGGUGCCUAAAGAUGUGGCAAAAUUGCAACUAAGUAGUCAAAA,37,17,22,17,93
284,1,AACY020277418.1/449-357,AGUAAGCAUAUUGAGAAGGUUAAGACCUCAGCAACCUGGAAGACUAUCCAAGGUGCUUGAAGAUGUGGCAGAAAUGCAACUAAAUAGUCAGAA,36,19,23,15,93
285,1,AACY020347367.1/1189-1095,UACAGAUAUCAAGAGCAGGAUUAAAUUCCUCUCCAACCUGCCCUCUCUGGCAAGGUGGAAAAAUGAUAUGGCUUUCAGCAACUAAAGGAGGAAAA,34,21,20,20,95
286,1,AACY020597859.1/342-437,CAAUUGCAUCAGGAAUCCCAAAUGGGUACCAACCGAGAGAACAUACUCCACGGUGGUAAAACGAUGCGGACCGGAAGGUCAAAAUAAAAGUAAUCU,37,16,22,21,96
287,1,AACY022787147.1/309-190,GAAUUGCAUUUAGAGCGGUCGGAGUCGUAGUGCUCUUGGCCCGGCAACCUGGGUUCGCCCCCAAGGUGCUUGCACACGAUGUGCGAUGCGGUCGGAUACCCGGCAAACCGGCGCCGAUUC,21,25,39,35,120
288,1,AAOA01000016.1/47143-47251,CGACUGCAUCAAGAGGGGCAUAGCCCCACCAACCGCCCACUCCGGGAACGGUGGUCCAAAUGAUGCGCCAAUGGCUCUGCAUUGCAGACAUGGAACAUAAAGGAGACCU,31,16,29,33,109
289,1,AACY020515115.1/670-757,UAAUUGCAUAAAGAGAGGAAAGCCUCAGCAACCUAGUUGCCAACUAAGGUGCUUUUUGAUGUGGUUUAACAGCAAAAAAUGGCAUCAC,31,22,19,16,88
290,1,AACY022543696.1/466-554,GGUUUGCAUAAAGAGAGGAAAUCCUCAGCAACCUAGAAUACCAACUAAGGUGCUUUUUGAUGUGGUUUUACAACAAAAAAUGGUAUUUC,31,26,18,14,89
291,1,AACY021762775.1/443-351,CAUAAGCAUAUAGAGAAGGUUAAGACCUCGGCAACCUGGAAGACUAUCCAAGGUGCCUGAAGAUGUGGCAGAAAUGCAACUAAAUAGUCAAAG,36,17,23,17,93
292,1,AACY024079331.1/447-570,AGUUAACAUCAGGAGUGGUUUCGUAGUUGAAACCCGCCAACCGAGCCCAGAUAAAUCAUGGUCACGGUGGUUAGAGCCUUAAACGCUAGAUGUGCCUAGGAAAAUAGGAAACAUAAAGCCGCCU,40,26,31,27,124
293,1,AACY024005133.1/481-378,GCGCUACAUCACGAGCGACCAUACGGUCCGGCAACCGGGAAUCCACGGUGCCAAGUCACUUCGGUGACGAUGUGGCCCCGCAAGGGGCAACGGAUCGCAUGGUG,23,15,34,32,104
294,1,AACY020167686.1/1628-1731,GCGCUACAUCACGAGCGACCAUACGGUCCGGCAACCGGGAAUCCACGGUGCCAAGUCACUUCGGUGACGAUGUGGCCCCGCAAGGGGCAACGGAUCGCAUGGCG,23,14,34,33,104
295,1,AACY020430580.1/3543-3635,AAUAUACAUUAAGAGAAGGUUAAGACCUCAGCAACCUGGAUGACUAUCCAAGGUGCUUGAAGAUGUGGCAGAAAUGCAACUAAAUAGUCAGAA,37,20,21,15,93
296,1,AACY020691148.1/68-191,AAACAUCAUCAGGAGUGGUUUCAUAGUUGAAACCCGCCAACCGAGCCCAGAUAAAUCAGGGAAGCGGUGGUUAGAGCCUUAAACGCUAGAUGUGCCUAGGAAAAUAGGAAACACAAAGCCGCCU,43,22,31,28,124
297,1,AACY020289175.1/479-387,AGUAAGCAUAUUGAGAAGGUUAAGACCUCAGCAACCUGGAAGACUAUCCAAGGUGCUUGAAGAUGUGGCAGAAAUGCAACUAAAUAGUCAGAA,36,19,23,15,93
298,1,AACY023933740.1/780-878,AAAAAGCAUCAGGAGUGAAUAAGAAAUUAUUCUGCCAACCUGCUUGAGGAAAGUAAGGUGGAAUACGAUGUGGUCUUAAUGACAAUUAAGUUCCUCAUC,36,26,22,15,99
299,1,AACY024004693.1/41-150,AACCAGCAUCUAGAAACACCUCGCAAGAGGUGUGGCAACCGAGCCCACCAGGCCACGGUGCCUCCCAACAACGGGGAUGCGGCGCGACGAGCGCAAAAGAACUGGUGCUC,31,11,32,36,110
300,1,AACY021201900.1/462-346,GAAGUACAUCAAGAGAGGCUCAAAUUUGGGUCCGGCAACCUGGGAUGGACACCCAAGGUGCUCGCUUGCCUAGUAGGUGAGGAUGCGGUUUCGGAAGAAACAAUGAAGUGUCCGGCG,31,23,39,24,117
301,1,AACY020280463.1/1762-1661,AUCACACAUGAAGAGAGGACUGACGUCCCGCCAACCUGCCCGGACCGGCAAGGUGGUUCCCCUCCCGGGGCAUGCGACCAAAGGGUAACCAAGUGUCCAUGA,26,14,29,33,102
302,1,CP000529.1/4203375-4203271,AGACAACAUCAAGACUGGAUAGAAAUAUUCAGACCAACCUGCCAACUCGGGCAAGGUGGUUAGCGAAAGCAGAUGGGGCUUCUCGAAGCAACCAAACGAGCCAUU,37,17,26,25,105
303,1,AACY022721140.1/632-540,UAAGAACAUAAAGAGAAGGUUAAGACCUCGGCAACCUGGAAGACUAUCCAAGGUGCUUGAAGAUGUGGCAAAAAUGCAACUAAGUAGUCAAAU,38,18,22,15,93
304,1,AACY024102763.1/297-205,GAGAAGCAUAAAGAGAAGGUUAAGACCUCGGCAACCUGGAUGACUAUCCAAGGUGCUUGAAAAUGUGGCAGCAAUGCAACUAAGUAGUCAAAC,35,17,24,17,93
305,1,AACY020554743.1/6070-6188,UAAAGGUAUGAGGAUUGCCUCACUAACCCCAAGGUGAGGCUGCCAACCGAGCACGUGCCACGGUGGCCGAAUCUUAAUGAGAUUCCAUAUGUUGGAUUAACCAAAAAAGGAGCCCUAUG,36,25,30,28,119
306,1,AACY020374006.1/456-551,AUCGAACAUCAAGAGUGAGAUUAAGUUCUCCUCCAACCUGCCAACUCCGGCAAGGUGGAAAAGUGAUGUGGUUAAUCAACAAAUAAAGGAGAAAAA,38,19,21,18,96
307,1,AACY020516796.1/1643-1520,AGAUUACAUCAGGAGUGGUCUCAGUAAUGAAACCCACCAACCGAACCCAGAUAAAUCGAGGUUACGGUGGUUUGAUCCUUAAACGGUAGAUGUGCCCAGGAAGAUGGGAAACAUGAUUAGCCGC,40,26,32,26,124
308,1,AACY020719763.1/201-82,AAAGAACAUUAAGAGAAGUUUGGUGAAAACUAAGCUCAGCAACCUGGGAAAGGCACCCAAGGUGCUUCCAGUAUUUACUGGGAUGAGGCCCGAUAGAAUUGGGCAACAAAGUGUCUGAGU,41,25,33,21,120
309,1,AACY020099425.1/760-666,AAGAUACAUCAAGAGCAGGAUUAAGUUCCUCUCCAACCUGCCACUCCGGCAAGGUGGAAAAAAGAUGUGGUUAACCAACAAUUAAAGGAGUUAAA,37,19,20,19,95
310,1,AACY021738328.1/622-497,GGGCGUCAUCAAGAAGUGCCGUGCCUCGUCGGCCCGGCAUGCCAACCUGAUCCGAAGUUCAAGGUGGUUUCUCUGGCCUUCCAGAGAGAUGCGCGUCGGAAGAACCGACGAACAAACCUUCGACUC,28,24,36,38,126
311,1,AACY020487706.1/863-955,AAGAAGCAUAAAGAGAAGGUUAAGACCUCGGCAACCUGGAUGACUAUCCAAGGUGCUUGAAGAUGUGGCAGAAAUGCAACUAAGUAGUCAAAC,36,17,24,16,93
312,1,AACY023407370.1/1041-1133,UUAAAGCAUAAAGAGAAGGUUAAGACCUCGGCAACCUGGAUGGCUAUCCAAGGUGCUAGAAAAUGUGGCAGAAAUGCAACUAAAUAGUCAAAA,38,18,22,15,93
313,1,AACY023357773.1/1559-1467,CAUAAGCAUAUAGAGAAGGUUAAGACCUCGGCAACCUGGAAGACUAUCCAAGGUGCCUGAAGAUGUGGCAGAAAUGCAACUAAAUAGUCAAAG,36,17,23,17,93
314,1,AACY023767351.1/867-762,UCCCAGCAUCCAGAGAGGCCAUGGUGGCCUCGCCAACCUGCUCCUCCAGCAAGGUGGCAUCCCGAUCAAGGGAGAUGCGGCCCGACAGGGCAACGAAAGGAGAUCC,26,13,32,35,106
315,1,AACY022849402.1/732-640,AAGAAGCAUAAAGAGAAGGUUAAGACCUCGGCAACCUGGAUGACUAUCCAAGGUGCUUGAAGAUGUGGCAGCAAUGCAACUAAGUAGUCAAAC,35,17,24,17,93
316,1,AACY021297719.1/563-471,GAGAAGCAUAUAGAGAAGGUUAAGACCUCGGCAACCUGGAUGACUAUCCAAGGUGCUUGAAGAUGUGGCAGCAAUGCAACUAAGUAGUCAAAG,33,18,26,16,93
317,1,AACY023396022.1/1219-1097,GAUUAACAUCAGGAGUGGUUUCUAAUUGAAACCCACCAACCGAGCAAAGAUAAAUCAAUGUUACGGUGGUUUGAUCCUUAAACGGUAGAUGUGCCCAGGAAAAUGGGAAACAUGAUUAGCCGC,42,29,29,23,123
318,1,AAXX01000006.1/136094-135999,AUUAAGCAUCAAGAUAAUCCAUUGGGUUAGCCAACCGAUCAACUCACGACACGGUGGCUUAGUAUGCGGAACAGUCGUUCAAAUGUGUUGAGAAAU,31,24,22,19,96
319,1,AACY020038799.1/723-820,AAAUAUCAUCAGGACGGGAGUAAUCCCACCAACCGAGCUUAAGCCACGGUGGUUUGUCAAGUGACAGAUGAGCAGCAAAGCUGAAACUAUCUGAAGCC,33,18,24,23,98
320,1,AACY023097597.1/645-755,GAAUUACAUCAAGAGAGAGCGAAAGCUCCACCAACCAGCCUAAUCGGGCAACGGUGGUUCAACGAUGAGACCGAAAAAGAAAUACUUAAGUAGGUAACAAUACGAUUGAGC,44,18,26,23,111
321,1,AACY022873516.1/143-57,UUAUUGCAUAGAGAGAGGGAUACCUCAGCAACCUAGUUGCCAACUAAGGUGCUUUUUGAUGUGGUUAUACAACAAAAAAUGGCGUUC,27,25,20,15,87
322,1,AACY022730775.1/680-588,UAGAAGCAUAUAGAGAAGGUUAAGACCUCGGCAACCUGGAUGACUAUCCAAGGUGCUUGAAGAUGUGGCAGCAAUGCAACUAAGUAGUCAAAC,33,19,24,17,93
323,1,AACY020031148.1/1716-1625,ACAGUGCAUGAAGAGAGGGAAACCUCAGCAACCUAGAAAGCAAACAAAGGUGCUUCAAAUGCGGUUUUUUAUAGACAAAAAAAUAUGCUAUU,38,20,19,15,92
324,1,AACY023502001.1/877-771,AUCAAGCAUCAAGAGAAGAACUAAUACUCAAUGGUUCUCGCCAACCUGCUAAACCUGGUAAGGUGGUCGAGUAAAAGAUGUGGCUUCGCAGCAAUUAAGAGGUCAAU,37,24,25,21,107
325,1,AACY020472258.1/364-477,GUAGUACAUCACGAGCGACCAACUGGUCCGGCAACCGGGAUUUCCCACGGUGCCAUUUCGCGAAAUGCGAAAGAUGUGGUUACGCCAGCAGGCGUAGCAACGGGCUGGCUCAGU,27,21,35,31,114
326,1,AACY024080065.1/279-371,UAAGAACAUAAAGAGAAGGUUAAGACCUCGGCAACCUGGAAGACUAUCCAAGGUGCUUGAAGAUGUGGCAGAAAUGCAACUAAGUAGUCAAAU,37,18,23,15,93
327,1,AACY020360095.1/3049-2955,AAGAUACAUCAAGAGCAGGAUUAAGUUCCUCUCCAACCUGCCACUCCGGCAAGGUGGAAAAAAGAUGUGGUUAACCAACAAUUAAAGGAGUUAAA,37,19,20,19,95
328,1,AAUW01000010.1/69484-69362,CGCCAUCAUCAAGAGAAGGGCUGGCGCCCUCGCCAACCUGCCGUCCGGGCAAGGUGGUUUCCGCAACAGGGAUGCGGCCGGUCAGACCCUCUACCGAGGUUUUCCGGCAACGAAGCGGUUAAU,25,21,38,39,123
329,1,AACY023449041.1/987-1079,CAUAAGCAUAUAGAGAAGGUUAAGACCUCGGCAACCUGGAAGACUAUCCAAGGUGCCUGAAGAUGUGGCAGAAAUGCAACUAAAUAGUCAAAG,36,17,23,17,93
330,1,AACY020088771.1/512-625,ACUAAUCAUCAGGAGAGGUUUCAUAACUGAAGCCCACCAACCGACCCAAAUGGGCACGGUGGUUCGAUCCUUGAACGGUAGAUGCGCCUUUAAAAAGGAAAUCACAAAGCCGCC,37,21,26,30,114
331,1,AACY020192706.1/264-356,AAGAAGCAUAAAGAGAAGGUUAAGACCUCGGCAACCUGGAUGACUAUCCAAGGUGCUUGAAGAUGUGGCAGAAAUGCAACUAAGUAGUCAAAC,36,17,24,16,93
332,1,AACY021025521.1/348-253,UUACUGCAUCAAGAGUAGAGUUUAGUCUCUCUCCAACCUGCCCACUCCGGUAAGGUGGAAAAAGUGAUGCGGCAUUCUGCAAUACAAGGAGGAAGA,29,22,24,21,96
333,1,AACY020087873.1/1258-1347,GCGCAACAUCAAGAAUACUUAAUUGUAUACCAACCGAACGAUAACGGUGGUUAAACGAUGUGGGCAUCCUAGUCAAAGUCGAUUCUCAUA,31,22,18,19,90
334,1,AACY021493053.1/911-781,GAUGUUCAUCAGGAGAGGUCUGAGCAAUCAGACCCGGCAACCUGGGCGGAAGCCCCAAGGUGCCUCCCAAUCGAGCCUUCGGGUCUGAAAGGGGAUGUGGUCAGCAAUAACUGGCAACGAAACUUCCUGGA,34,23,40,34,131
335,1,AACY022288712.1/729-852,AUAGUACAUCAGGAGUGGUUUCAGUAUUGAAACCCGCCAACCGAACCCAGAUAAAUCAAGGUUACGGUGGUUUGAUCCUUAAACGGUAGAUGUGCCCAGGAAGAUGGGAAACAUGAUUAGCCGC,39,28,32,25,124
336,1,AACY021240446.1/353-242,CAAUUACAUCAAGAGAGAGCGUAAGCUCCACCAACCAGCCUAAUCGGGCAACGGUGGUUCAACGAUGAGACCGAAAGAGGAAUAACUUAAGUAGGUAACAAUACGAUUGGGC,41,19,28,24,112
337,1,AACY020694102.1/167-72,ACCUUGUAUCUUGAGCAGGAUUUAGUUCCUCUCCAACCUGCCUACUCCGGCAAGGUGGAAAAACGAUACGGUUAAUCAACAAUUAAAGGAGAGAAA,32,23,20,21,96
338,1,AE004969.1/118224-118334,GCGCUGCAUUAAGAGUUGGGAAUUCCAUGCCAACCUGCUUUUCAAACGGAAAGGUAAGGUGGACGGUUGAAAAACCGAUGUGGCUCGCCGGAGCAAUCCAAACCCGCUUGA,31,23,31,26,111
339,1,AACY023115370.1/503-620,AGUUAACAUCAGGAGUGGUUUCAUAGUUGAAACCCGCCAACCGAGCCCAGAUAAAUCAUGGUUACGGUGGUUAGAGCCUUAAACGCUAGAUGUGCCUAGGAAAAUAGGAAACAUAAAG,41,26,29,22,118
340,1,AACY020490313.1/1868-1779,AUUUUGCAUAAAGAGAGGGAAGCCUCAGCAACCUAGAUUGCCAACUAAGGUGCUUUUUGAUGUGGUUAUUACAACAAAAAAUGGCUUUUG,29,27,20,14,90
341,1,AACY020308756.1/717-624,AUCUUGCAUCCCGAACCCUUUAGUGGGUGCCAACCGAGCAGAGAAGCCACGGUGGCAAAACGAUGCGGGCAUUAUGCCAAAACAUAUUCCGAGA,28,17,24,25,94
342,1,AACY020553208.1/6570-6666,CUAAUACAUCAAGAGAGAGAUUAAGUUCUCCUCCAACCUGCCAACUCCGGCAAGGUGGAAAAAAUGAUGUGGUUAACCAACAAACAUAGGAGUACAA,38,19,19,21,97
343,1,AACY020064609.1/1218-1313,UAAGAGCAUCAGGAGUGGGACUUGUUCCCCGCCAACCUGCUUACCGAAGCAAGGUGGUUAGAGUAUGUGGCCUAAACGGCAACCAAAUCGGACUCU,26,20,26,24,96
344,1,AACY023894002.1/606-508,AGACAACAUUAAGAGAGGGCUGACGCCCCGCCAACCUGCAGCUGUGCAAGGUGGUACCCCGAAAGGGAAUGUGGCCUAAAGGCAACGACAGCGUCAGCC,29,12,30,28,99
345,1,AL157959.1/650530-650640,GUGCUGCAUUAAGAGUUGGGAAUUCCAUGCCAACCUGCUUUUCAAAUGGAAAGGUAAGGUGGACGGUUGAAAAACCGAUGUGGCUCACCAGAGCAAUCCAAACCCGCUUGA,33,25,29,24,111
346,1,AACY021707435.1/476-571,AAUAUACAUCAAGAGCGAGAUUAAGUUCUCCUCCAACCUGCCAACUCCGGCAAGGUGGAAAAAUGAUGAGGUUUAUCAACAAAUAAAGGAGUUAAA,38,21,19,18,96
347,1,AACY020114069.1/41-129,AGUUUGCAUAAAGAGAGGAAAUCCUCAGCAACCUAGAUUACCAACUAAGGUGCUUUUUGAUGUGGUUUAACGACAAAAAAUGGUAUUUU,31,27,18,13,89
348,1,AACY020501706.1/2164-2069,GAUAUACAUCAAGAGCGAGAUUAAAUUCUCCUCCAACCUGCCAACUCCGGCAAGGUGGAAAAAUGAUGUGGUUAACCAACAAAUAAAGGAGUUAAA,38,20,19,19,96
349,1,AACY023384145.1/1243-1358,GUCAAUCAUCAGGAGAGAUUACAAUAAAGUAAUCCACCAACCGACCCAAAAGGGCACGGUGGUUUGAUCCUUAAACGGUAGAUGUGCCUCAGAAGAGGAAUCUUAAAGCCGCCUGA,40,23,27,26,116
350,1,AACY023360781.1/549-463,UUAAUGCAUAGAGAGAGGAAUUCCUCAGCAACCUAGUUGCCAACUAAGGUGCUUUUUGAUGUGGUUAUACAACAAAAAAUGGCGUUC,28,25,19,15,87
351,1,AACY023280010.1/509-603,ACAUUACAUUUUGAGAGGGUUAAAACCCUGCCAACCUGCAUAACCUUGCGAAGGUGGUAUUAUGAUGUGGCUUAUAAGCAAAAAAAAGGUCCUUU,31,27,20,17,95
352,1,AACY020434678.1/7044-7134,AAGAUGCAUUGAGAAAGGGAUUAUCCCUGCCAACCUGCAUACCGUGCGAAGGUGGUAAUAUAUGCGGCCAAAAGGCAAAAAUUCGGUCUCA,30,19,23,19,91
353,1,AACY021717596.1/367-461,ACCUAGCAUCAAGAGAAGAGUUGUACUCUCUCCAACCUGCCCAAUCCGGCAAGGUGGAAAAAAUGAUGUGGCAUUCAGCAAAUAUAGGAGAUCGC,32,19,22,22,95
354,1,AACY020483405.1/90-1,UUGAAGCAUAAAGAGAAGGUUAAGACCUCGGCAACCUGGAUGGCUAUCCAAGGUGCUAGAAAAUGUGGCAGAAAUGCAACUAAAUAGUCA,34,18,23,15,90
355,1,AACY020582823.1/269-371,AGUCAGCAUUUAGAGAGGGCUGACGCGCCCCGCCAACCUGCAGCUUGAGCAAGGUGGUUACCUCGCAAGAGGGAUGUGGCCUGAUAGGCAACGUCGAGCGUUG,23,19,35,26,103
356,1,AACY020551483.1/2636-2539,UUAUUGCAUCGAGAGUAGGACGAAAGUCCUCGCCAACCUGCUUACCCAAGCAAGGUGGUCCAAUAAUGUGGCCCUUACAGGCAACCAAAUGGGAAUCC,29,20,23,26,98
357,1,AACY024050872.1/154-249,AUCGUACAUCAAGAGUGAGAUUAAGUUCUCCUCCAACCUGCCAACUCCGGCAAGGUGGAAAAGAGAUGUGGUUAAUCAACAACUAAAGGAGAAAAA,37,19,21,19,96
358,1,AACY020788491.1/56-148,AUAAAGCAUAAAGAGAAGGUUAAGACCUCGGCAACCUGGAUGACUAUCCAAGGUGCUUGAAAAUGUGGCAGAAAUGCAACUAAAUAGUCAAAA,39,18,21,15,93
359,1,AACY023060821.1/255-369,GUGUAACAUCAGGAGCGGUUUCUAAGUAGAAACCCACCAACCGAGCCUCAAAGCUACGGUGGUCAGUUCCAUUAAACGGAAGAUGUGCCUUGAAAGAGGAAAAAUGGAACCGCCU,38,22,29,26,115
360,1,AACY020080953.1/3577-3485,CAUAAGCAUAUAGAGAAGGUUAAGACCUCGGCAACCUGGAAGACUAUCCAAGGUGCCUGAAGAUGUGGCAGAAAUGCAACUAAAUAGUCAAAG,36,17,23,17,93
361,1,AACY020166778.1/510-399,GGUAUGCAUCUAGAAGUCACUUGGCGACAAGUGAUGGCAACCGAGCCCACCAGGCCACGGUGCCUCGCUGUAACGGGGAUGCGGCGCGACGAGCGCAAAAGAACUGGUGCUC,27,17,37,31,112
362,1,AACY023409075.1/925-1017,GUAUUGCAUAAUGAACGUUUUUAAACGUACCAACCGACAUCUCAUUGCACGGUGGUUUUGAAUGUGGGUGUCUCUGCCAAAAUUAUGAGAAAU,27,30,20,16,93
363,1,AACY023900834.1/994-1089,UUCUGGCAUCUAGAGCGAGAUUAAAUUCUCCUCCAACCUGCCAACUCCGGCAAGGUGGAAAAAUGAUGCGGUUAACCAACAAAUAAAGGAGUUAAA,34,21,20,21,96
364,1,AACY020411818.1/4986-5078,AACAUACAUAAAGAGAAGGUUAAGACCUCAGCAACCUGGAUGACUAUCCAAGGUGCUUGAAGAUGUGGCAGAAAUGCAACUAAAUAGUCAAAA,39,18,20,16,93
365,1,AANA01000001.1/1651504-1651599,UGGCAGUAUCAGGAACGCAAGAAUUGCGUACCAACCGAGCAAAAAAGCUACGGUGGUUUAGUAUACGGACAGUUCUGUCAAAAUAAAUGAACAUCC,35,20,22,19,96
366,1,AACY020439129.1/2510-2602,AUGAAGCAUAAAGAGAAGGUUAAGACCUCGGCAACCUGGAUGACUAUCCAAGGUGCUUGAAGAUGUGGCAGAAAUGCAACUAAGUAGUCAAAA,36,18,24,15,93
367,1,AACY020225991.1/1900-1814,UUAUUGCAUAGAGAGAGGGAUACCUCAGCAACCUAGUUGCCAACUAAGGUGCUUUUUGAUGUGGUUUUACAACAAAAAAUGGCGUUC,26,26,20,15,87
368,1,ABCR01000016.1/10470-10573,AUCGCACAUCAAGAGUGAGGCCUGUGCCUCUACCAACCUGCCCUUCCCGGCAAGGUGGUGUCCGAACAAGGAGAUGUGGCCAUGACGGCAACCAAGGGGAUCAU,26,18,30,30,104
369,1,AACY023522594.1/207-113,GUUGAAUAUCACGAGAAGGAUUUAUAUCCUCUCCAACCUGCCAACUCCGGCAAGGUGGAAAAAUGAUAUGGCGUUCAGCAAACAUAGGAGGAAAA,34,20,22,19,95
370,1,AACY024112069.1/477-563,UGAGUGCAUAUAGAGAGGAAUACCUCAGCAACCUAGUUGCCAACUAAGGUGCUUUUUGAUGUGGUUAUACAACAAAAAAUGGCGUUC,28,24,20,15,87
371,1,AACY023473445.1/207-306,AUUAAGCAUCAGGAGUGAAUAAGAAAUUAUUCUGCCAACCUGCUUUGAGGAAAGUAAGGUGGAGUAGGAUGUGGUCUUAAUGACAAUUAAGUUCCUCAUC,33,29,24,14,100
372,1,AACY021918035.1/709-603,AUCUUUCAUCAAGAGCUGGGCCGACGCCCACGCCAACCUGCCCCGCCCGGGCAAGGUGGAUCGCGAAAGCGGAUGUGGCUUCUAACGAAGCAACCAAGCGGGUCAAG,26,15,32,34,107
373,1,AACY020029910.1/395-486,ACAGUGCAUGAAGAGAGGGAAACCUCAGCAACCUAGAAAGCAAACAAAGGUGCUUCAAAUGCGGUUUUUUAUAGACAAAAAAAUAUGCUAUU,38,20,19,15,92
374,1,AACY023781615.1/453-361,AAUAUACAUAAAGAGAAGGUUAAGACCUCAGCAACCUGGAUGACUAUCCAAGGUGCUUGAAGAUGUGGCAGAAAUGCAACUAAAUAGUCAGAA,38,19,21,15,93
375,1,AACY021933713.1/55-142,UGAGUGCAUAUAGAGAGGAAUACCUCAGCAACCUAGUUGCCAACUAAGGUGCUUUUUGAUGUGGUUAUACAACAAAAAAAUGGCGUUC,29,24,20,15,88
376,1,AACY022832886.1/280-194,UGAGUGCAUAUAGAGAGGAAUACCUCAGCAACCUAGUUGCCAACUAAGGUGCUUUUUGAUGUGGUUAUACAACAAAAAAUGGCGUUC,28,24,20,15,87
377,1,AACY023367397.1/199-322,AAUCAUCAUCAGGAGUGGUUUCAUGAUUGAAACCCGCCAACCGAGCCUAGAUAAAUCAAGGUCGCGGUGGUUAGAGCCUUAAACGCUAGAUGUGCCCAGGAAAAUGGGAAACAUGAUUAGCCGC,39,26,32,27,124
378,1,AACY023511498.1/688-780,GAGAAGCAUAAAGAGAAGGUUAAGACCUCGGCAACCUGGAUGACUAUCCAAGGUGCUUGAAAAUGUGGCAGCAAUGCAACUAAGUAGUCAAAC,35,17,24,17,93
379,1,AACY021849718.1/721-830,UUUAUACAUCAGGAAGGUCUAUAUGACCUGCCAACCGACUCUGGGUGAGCACGGUGGUUUGAAUCCUUAAACGGUAGAUGUGCCUUGAAAAAGGAAACCUAGAAGCCACC,33,26,27,24,110
380,1,AACY023402647.1/1053-958,AGCAAGCAUCUUGAGUGAGAUUAAAUUCUCCUCCAACCUGCCAACUCCGGCAAGGUGGAAAAGUGAUGCGGUUAACCAACAAUUAAAGGAGUAAAA,35,20,21,20,96
381,1,AACY020086339.1/403-491,AAAAAGCAUGGAGAGAGGUUAAAACCUCAGCAACCUAGAAAGCUAACUAAGGUGCUUAGAUAUGUGGUUUGUAACAAAAAACAGCUUUC,36,20,19,14,89
382,1,AACY020495019.1/1481-1573,GAGAAGCAUAAAGAGAAGGUUAAGACCUCGGCAACCUGGAUGACUAUCCAAGGUGCUUGAAAAUGUGGCAGCAAUGCAACUAAGUAGUCAAAC,35,17,24,17,93
383,1,AACY020375381.1/1502-1407,AUUUUGCAUCUUGAGAGAGAUUAAGUUCUCCUCCAACCUACCAACUCCGGCAAGGUGGAAAAAUGAUGUGGUUAACCAACAAAUAAAGGAGUUAAA,35,24,19,18,96
384,1,AACY022184932.1/558-464,AUAGAGUAUCAAGAGUAGAGUGAAACUCUCGCCAACCUGCCUACCCGGGCAAGGUGGUAAAAAGAUGCGGCUAACCGGCAACCAAACGGGGACCC,31,13,26,25,95
385,1,AACY021652149.1/718-804,UAAAUGCAUAGAGAGAGGAAUUCCUCAGCAACCUAGUCGCCAACUAAGGUGCUUUUUGAUGUGGUUAUACAACAAAAAAUGGCGUUC,29,23,19,16,87
386,1,AACY023677285.1/918-830,AAAAAGCAUGGAGAGAGGUUAAAACCUCAGCAACCUAGAAAGCUAACUAAGGUGCUUGAAUAUGUGGUUUGUAACAAAAAAUAGCUUUC,36,21,19,13,89
387,1,AACY020439832.1/1023-928,AUUGGACAUCAAGAGUGAGAUUAAGUUCUCCUCCAACCUGCCAACUCCGGCAAGGUGGAAAAGUGAUGUGGUUAAUCAACAAAUAAAGGAGUAAAA,36,21,22,17,96
388,1,AACY021520391.1/331-423,AAUAAGCAUAAAGAGAAGGUUAAGACCUCGGCAACCUGGAUGGCUAUCCAAGGUGCUAGAAAAUGUGGCAGAAAUGCAACUAAAUAGUCAAAA,39,17,22,15,93
389,1,AACY023484057.1/321-433,UAAUAACAUCAGGAGCAGUUUCUUUAUUGAAACUCGCCAACCGAGUCAGUAAGACAGCGGUGGUUUGAUCCAUAAAUGGUAGAUGUGCCCAAAAGGGAAACAUAUAAAGCCAC,40,26,25,22,113
390,1,AACY023468294.1/539-447,AAGAAGCAUAAAGAGAAGGUUAAGACCUCGGCAACCUGGAUGACUAUCCAAGGUGCUUGAAGAUGUGGCAGAAAUGCAACUAAGUAGUCAAAC,36,17,24,16,93
391,1,AACY020076934.1/2446-2554,AAGGAACAUUAAGAGAGGUCCAAUAAUGGACCCGGCAACCUAGGACGGACACCCAAGGUGCUUCCCAGAAAUGGGGAUGUGGUACGAAAGUACAAGUAAUUGUCCACAC,38,18,29,24,109
392,1,AACY023296326.1/566-470,AGGAUUCAUCAAGAGUGAGAUUAGAUUCUCCUCCAACCUGCCAACUCCGGCAAGGUGGAAAAAAUGAUGUGGUUAAUCAACAACUAAAGGAGUUAUA,35,23,21,18,97
393,1,AACY020270417.1/535-630,GACAUGCAUCAAGAGUAGAGUUAAGUCUCUCUCCAACCUGCCACUCCGGCAAGGUGGAAAAAAAGAUGUGGUUAACCAACAAAUAAUGGAGUUAAA,36,20,21,19,96
394,1,AACY021322626.1/690-782,GUACUGCAUUAAGAACGUUAUAGACGUACCAACCGACAAACUCAUUGCACGGUGGUUUUGAAUGCGGGUGUCUCUACCAAAAUAAUGAGAAAU,31,24,20,18,93
395,1,AACY023009993.1/839-749,AAGGUGCAUUAAGAAAGGGGUUAUCCCUGCCAACCUGCAUACCGUGCGAAGGUGGUAGUAUAUGCGGCCAAAAGGCAAAAAUUAGGUCUCA,29,19,25,18,91
396,1,AACY022990670.1/572-668,GUCAGGUAUCAAGAGUAGGAUUAAAUUCCUCUCCAACCUGCCAACUCCGGCAAGGUGGAAAAAGUGAUACGGUUGUUCAACAAAAAUAGGAGUAACU,34,22,22,19,97
397,1,AACY023993811.1/239-147,UAAAAGCAUAAAGAGAAGGUUAAGACCUCGGCAACCUGGAUGGCUAUCCAAGGUGCUAGAAAAUGUGGCAGAAAUGCAACUAAAUAGUCAAAA,39,17,22,15,93
398,1,AACY022468102.1/350-442,UUAAAACAUCAUGAGAGAUUAAAUUCUCACCAACCUGCUGACUCCAGCAAGGUGGUAAAAAGAUGUGGUUAACCAACAACUAAAGGAGUUAAA,38,21,17,17,93
399,1,AACY024079110.1/778-875,CCAAUACAUCAAGAGAGAGAUUAAGUUCUCCUCCAACCUGCCAACUCCGGCAAGGUGGAAAAAAAUGAUGUGGUUAACCAACAAACAUUGGAGUACAA,38,19,19,22,98
400,1,AACY021960338.1/597-712,UUAUAACAUCAGGAGCGGUUUCAUAGCAGAAACCCGCCAACCGACCCAUGUGGGCACGGUGGUUUGAUCCUUAAACGGUAGAUGUGCCUCACAAGAGGAAUCUUAAAGCCGCCUGA,33,25,29,29,116
401,1,AACY020136271.1/828-741,GGUUUGCAUAAAGAGAGGGAAUCCUCAGCAACCUAGAUUACCAAUUAAGGUGCUUUUUGAUGUGGUUUAACGACAAAAAAUGGUAUUU,29,27,20,12,88
402,1,AACY022455332.1/194-102,AAGAAGCAUAAAGAGAAGGUUAAGACCUCGGCAACCUGGAUGACUAUCCAAGGUGCUAGAAAAUGUGGCAGAAAUGCAACUAAAUAGUCAAAA,40,16,22,15,93
403,1,AACY023908039.1/555-463,UUGAAACAUAUAGAGAAGGUUAAGACCUCGGCAACCUGGAUGACUAUCCAAGGUGCUCGUAAAUGUGGCAGAAAUGCAACUAAUUAGUCAAAA,35,21,21,16,93
404,1,AAKX01000119.1/136189-136086,AUCAAGCAUCCAGAGUCGGGUUUCCCGACGCCAACCUGCCCUCCCGGGCAAGGUGGACGCCCUCGAGGCGAUGCGGCCGAUUGACGGCAACGAAACGGGAGCAG,23,13,34,34,104
405,1,AACY020492511.1/1806-1718,GGUUUGCAUAUAGAGAGGAAAUCCUCAGCAACCUAGAAUACCAACUAAGGUGCUUUUUGAUGUGGUUUUACAACAAAAAAUGGUAUUUC,30,27,18,14,89
406,1,AACY022492595.1/463-580,AGUUAACAUCAGGAGUGGUUUCAUAGUUGAAACCCGCCAACCGAGCCCAGAUAAAUCAUGGUCACGGUGGUUAGAGCCUUAAACGCUAGAUGUGCCUAGGAAAAUAGGAAACAUAAAG,41,25,29,23,118
407,1,AACY022741470.1/512-415,AUCAUACAUCUAUAGAGAAGGGUAACCUUCACCAACCAGCCAAGACUUGGCAACGGUGGUUCAACGAUGUGGCUUUUGAAGCAACAAUAAAGUCAGAU,34,22,21,21,98
408,1,AACY023705900.1/919-1025,UAACAACAUUAAGAGAGGUCAUUAGUGGCCCGGCAACCUAGGAUGGACACCCAAGGUGCUUCCCAGAAAUGGGGAUGUGGUACGAAAGUACAAGUAAUUGUCCCAAC,35,21,28,23,107
409,1,AACY020423913.1/3046-3139,GUUGAGCAUCAAGAACGCUAAUGCGUACCAACCGACACGCUCGUUGCACGGUGGUUUAGAAUGUGGGUGGCUCUACCAAACUAAUCGAGCUUUC,24,23,24,23,94
410,1,AACY021823955.1/284-382,AUCCUGUAUCAAGAGCAGAGUUAAUUCUCUCUCCAACCUGCUAACUUCUAGCAAGGUGGAACAAAUGAUACGGCUAUUCACGCAACUAAAAGGAGAUCA,34,24,18,23,99
411,1,AACY022718741.1/342-435,ACAUAGCAUCAAGAGUAGGACUUGUUCCUCACCAACCUGCAACUCCAAAGCAAGGUGGUCAAUAGAUGCGGCAAUCGCAAACAAUUGGAGAACA,34,17,20,23,94
412,1,AACY023311957.1/783-659,CCCUCACAUCACGAGUGGCUCGGUUUUCCGGGCUCGGCAACCUGGGGCGAACACCCAAGGUGCCAACCCACCUUUGGUGGGGAUGCGGCUUCCACCUUCCGGUGUCGGCAACAACCAGUUCGAGG,22,24,37,42,125
413,1,AACY022762621.1/313-199,CGACGACAUCAAGAGCGACCCUCACGGGUCCGGCAACCGGGAUCGCCACUCGGUGCCAUCCCGCCUCGCGGCGGGGAUGUGGUCCCGCACUCGCGGGACAAGGAGGUGACAUGGC,21,14,40,40,115
414,1,CP000152.1/3090724-3090621,GUCAAGCAUCCAGAGUCGGAUUCUCCGACGCCAACCUGCCCUCCCGGGCAAGGUGGACGCCUCUGAGGCGAUGCGGCCGAUUUACGGCAACGAAACGGGAGCAG,23,15,33,33,104
415,1,AACY020498997.1/2371-2463,AUUAAGCAUAAAGAGAAGGUUAAGACCUCGGCAACCUGGAAGGCUAUCCAAGGUGCUUGAAGAUGUGGCAGAAAUGCAACUAAUUAGUCAAAA,36,19,23,15,93
416,1,AACY020086339.1/1639-1731,AGUAGACAUAAAGAGAAGGUUAAGACCUCAGCAACCUGGAUGACUAUCCAAGGUGCUUGAAGAUGUGGCAGAAAUGCAACUAAAUAGUCAAAA,38,18,22,15,93
417,1,AACY021123789.1/139-44,UUAAAGUAUCAAGAGAAGGAUUAAAUUCCUCUCCAACCUGCCAACUCCGGUAAGGUGGAAAAAAGAUACGGUUAACCAACAAUUAAAGGAGCAAUA,40,20,18,18,96
418,1,AACY023457680.1/173-265,AAGAAGCAUAAAGAGAAGGUUAAGACCUCGGCAACCUGGAUGGCUAUCCAAGGUGCUUGAAGAUGUGGCAGAAAUGCAACUAAGUAGUCAAAC,35,17,25,16,93
419,1,AACY023861419.1/882-790,AUUAAGCAUAAAGAGAAGGUUAAGACCUCGGCAACCUGGAAGACUAUCCAAGGUGCCUGAAGAUGUGGCAGAGAUGCAACUAAAUAGUCAAAA,37,17,23,16,93
420,1,CP000692.1/3559-3450,CUUCAGCAUCAAGAGUUGGGCCGACGCCCAGCGCCAACCUGCUUCCCGAGCAAGGUGGCUUUCUUCCUUCGGAAGAAGAUGUGGCCGGUCCGGCAACUAAACGGGACAAG,25,20,32,33,110
421,1,AACY020858903.1/521-623,ACGUUGCAUGAAGAGAGGGCAGACGCCCCGCCAACCUGCCUGACACGGCAAGGUGGUUUCCUUGAAAAAGGCAUGAGACCAUAGUGUAAACACAGUGUCCAUG,30,18,29,26,103
422,1,AACY020331588.1/716-808,UUGAAACAUACAGAGAAGGUUAAGACCUCGGCAACCUGGAUGACUAUCCAAGGUGCUAGUAAAUGUGGCAGAAAUGCAACUAAUUAGUCAAAA,36,20,21,16,93
423,1,AACY020514730.1/2517-2605,AUUGUGCAUGAAGAGAGGGUAACCUCAGCAACCUAGAAAGCAAACAAAGGUGCUAAAGAUGCGGUUUUUUAAACAAAAAAUAUGCUAUU,36,21,19,13,89
424,1,AACY022059262.1/134-223,AAAAAGCAUCAAGAACGCGAAUGCGUACCAACCGACAGCUCGUUGCACGGUGGUUUAGAAUGCGGGGGUCCUCCCAAAUUAACGAGAAAU,30,16,23,21,90
425,1,AACY023400827.1/1711-1619,CAAGCACAUCGAGAGCGGACUAAAUUCCCACCAACCCGCAUACUCAAGCAAGGUGGUUCAGCAUGUGGCCAAAUGGCAAUCAACUGGGUAUCU,29,17,21,26,93
426,1,AACY023729720.1/424-336,AAAAAGCAUGGAGAGAGGUAGAAGCCUCAGCAACCUAGAAAGCUAACUAAGGUGCUUAAGUAUGUGGUUUAUAACAAAAAAUAGCUUUU,36,21,20,12,89
427,1,AACY023908770.1/692-806,UUACAUCAUCAGGAGCGAUUUCUUACGAGAAAUCCACCAACCGAGCUUAAAAGCUACGGUGGUUAGUUCCAUUAAACGGAAGAUGUGCCUUGAAAAAGGAAAAAGUGGAACCGCC,40,25,26,24,115
428,1,AACY022640834.1/583-487,AGGAAACAUCAAGAAAGAGUGAUGACACUCUUACCAACCUGCCAACUCCGGCAAGGUGGUUUAAACGAUGUGGCUUUCAGCAACUAAAGGAGGUAAU,34,20,23,20,97
429,1,AACY020546191.1/1354-1440,UGAGUGCAUAUAGAGAGGAAUACCUCAGCAACCUAGUUGCCAACUAAGGUGCUUUUUGAUGUGGUUAUACAGCAAAAAAUGGCGUUC,27,24,21,15,87
430,1,AACY022825914.1/237-332,AGUGUUCAUCAAGAGUGGGAUUUAGUUCUCCUCCAACCUGCCAACUCCGGCAAGGUGGAAAAAUGAUGUGGUUAACCAACAAAUAAAGGAGUUAAA,33,23,22,18,96
431,1,AACY023455354.1/428-520,AAGAAGCAUAAAGAGAAGGUUAAGACCUCGGCAACCUGGAUGACUAUCCAAGGUGCUUGAAGAUGUGGCAGAAAUGCAACUAAGUAGUCAAAC,36,17,24,16,93
432,1,AACY023254477.1/1093-1197,UUCGGACAUCAAGAGUAGGGCUGACGCCCUCGCCAACCUGCCUACCCGGCAAGGUGGUGCUCCGAAAGGAGGAUGUGGCCAUAGACGGCAACUAAAGGGUCUAAG,27,17,33,28,105
433,1,AACY020911503.1/589-700,CAAAAUCAUCAGGAGCGAUUUCCAGAUGGAAAUCCACCAACCGGCCCAAUUGGGAACGGUGGUUAGGUCAAAUAAUGACAGAUGUGCCCUUUAGGGAAACUCUGAACCGCCU,35,23,27,27,112
434,1,CP002046.1/2215703-2215606,CUUAAUUAUCAAGAAUCUCAAAGAGAGAUAGCAACCUGCAAUAACGAGCAAGGUGCUAAAAUAGAUAAGCCAAAUUCAAUUGGAAAAAAUGUUAAUUC,44,23,16,15,98
435,1,CP001712.1/639245-639336,UUCCUGCAUCAGGAACGCUAAGGCGCGUACCAACCGAGCAUAAAAGCCACGGUGGUUCAGAAUGCGGACGGUCGUCAAAAAAAUAAUUCCUU,29,18,22,23,92
436,1,AE002098.2/1888986-1888876,GUGCUGCAUUAAGAGUUGGGAAUUCCAUGCCAACCUGCUUUUCAAAAGGAAAAGUAAGGUGGACGGUUGAAAAGCCGAUGUGGCUCACCAGAGCAAUCCAAACCCGCUUGA,34,24,29,24,111
437,2,AF027868.1/5245-5154,UUUCUAUCCAGAGAGGUGGAGGGACUGGCCCUAUGAAACCUCGGCAACAUUAUUGUGCCAAUUCCAGCAAGCGCUAGCUUGAAAGAUAGGAA,27,21,24,20,92
438,2,AF269983.1/571-671,ACCUUAUUUUGAGAAGCUGAGGGAUUUGGCCCAUAGAAGCUUCAGCAACCGACUUUAAAUAGCACGGUGCUAAUACCAACGAGCAACUCGAAUGAUAAGUA,34,24,22,21,101
439,2,AJ000974.1/281-386,AACUUAUCAAGAGCGGCUGAGGGACUGGACCUAUGAAGCCCGGCAACCUGCAUAGUUUGUAAGGUGCUACUUCCAGCAAAAUGAAUUCCAUUUUGAAAGAUAAGGG,33,25,27,21,106
440,2,AL596164.1/95936-95817,CUCUUAUCGAGAGCGGCAGAGGGACUGGCCCGAUGAAGCCCGGCAACCUAACUUUAUUUAAGCGUAAAGUGAAGGUGCUAAUUCCAGCAAAAUGGUGUAUUCCGUUUUGGUAGAUAAGAG,34,30,33,23,120
441,2,AL591974.1/109385-109266,CUCUUAUCGAGAGCGGCAGAGGGACUGGCCCGAUGAAGCCCGGCAACCUAACUUUAUUUAAGCAUAAAGUGAAGGUGCUAAUUCCAGCAAAAUGGUGUAUUCCGUUUUGGUAGAUAAGAG,35,30,32,23,120
442,2,U52812.1/691-829,CUCUUAUCCCGAGCUGGCGGAGGGACAGGCCCUAUGAAGCCCAGCAACCGGUUUCUCUGUUAUUUAUUAUGUUCAAUUGAGUGAGACAACCAAGGUGCUAACCUGUUGCAAGGUUGUAUGAUUCCUUGAGCGAUAAGAG,34,39,36,30,139
443,2,AL596169.1/221462-221354,CUCUUAUCCAGAGCGGUAGAGGGACUGACCCUUUGAAGCCCAGCAACCUACACAUAUAAGUGAAAGGUGCUAAUCUGUUGCAGGAGUAAUAUCUCCUGAACGAUGAGAG,33,25,27,24,109
444,2,AL591980.1/66651-66543,CUCUUAUCCAGAGCGGUAGAGGGACUGACCCUUUGAAGCCCAGCAACCUACACAUAUAAGUGAAAGGUGCUAAUCUGUUGCAGGAGUAUUAUCUUCUGAACGAUGAGAG,32,27,27,23,109
445,2,AL596172.1/176254-176136,AUCUUAUCCAGAGUGGUGGAGGGAAAUGCCCUGUGAAACCCAGCAACCUAAACAAUAAUUCAUUAUGUGUUUAAGGUGCUAAGUCAUGCAGAACAACGAUUUGUUCUGAAAGAUGAGAA,41,31,27,20,119
446,2,AL591983.1/96176-96058,AUCUUAUCCAGAGUGGUGGAGGGAAAUGCCCUAUGAAGCCCAGCAACCUAAACAAUAAUUCAUUAUGUGUUUAAGGUGCUAAGUCAUGCAGAACAACUAAUUGUUCUGAAAGAUGAGAA,42,31,26,20,119
447,2,AL596170.1/192-86,CUCUUAUUAUGAGUGGUAGAGGGACUGGCCCGUUGAAACCCAGCAACCUUUCAAUUCGUUGAAAAGGUGCUAAAUCCUGCGAAGUGUGAUGCUUCGAGAGAUAAGAG,30,28,29,20,107
448,2,AL591980.1/89597-89491,CUCUUAUAAUGAGUGGUAGAGGGACUGGCCCGUUGAAACCCGGCAACCUUUCAAUACGUUGAAAAGGUGCUAAAUCCUGCGAAGUGUGAUGCUUCGAGAGAUAAGAG,31,26,30,20,107
449,2,AL939119.1/177986-178133,CGCUCAUCCAGAGGGGCAGAGGGAUACGGCCCGAUGAAGCCCCGGCAACCCUCCAGUCGGUUCUUGUCACACGGACGUGGCGAGGCUCCCGGCUAGGGAAGGUGCCAAAUCCGUCUCACGGCGAGAUGCGUCGUGAGGAAGAUGAGGA,32,22,52,42,148
450,2,AB090330.1/380-279,UACUUAUCAAGAGCGGUGGAGGGACUGGCCCUAUGAAGCCCAGCAACCUAUAUGAAAAUAUAUAAGGUGCUAAAUCCUGCAGCAUAAGCUGAGAGAUGAGGA,35,21,27,19,102
451,2,U36379.1/1-106,AUCCUGAGUGGUGGAGGGACAUGGACCCAAUGAAACCCAGCAACCUCUUUUUUAUAAAAGAAAGGUGCCAAACCGUUUGCAGACAAAUAGGUCUGAACGAUAAGAG,37,22,26,21,106
452,2,L42943.1/254-144,CUCUUAUCCUGAGUGGUGGAGGGACAUGGACCCAAUGAAACCCAGCAACCUCUUUUUUAUAAAAGAAAGGUGCCAAACCGUUUGCAGACAAAUAGGUCUGAACGAUAAGAG,37,25,26,23,111
453,2,AF270301.1/145-36,CUCUUAUCCUGAGUGGUGGAGGGACAUGGACCCAAUGAAACCCAGCAACCUCUUUAUUUAAAGAAAGGUGCCAAACCGUUUGCAGACAAAUAUGGUCUGAACGAUAAGAG,36,25,26,23,110
454,2,AJ002571.1/38016-37861,CUCUUAUCGAGAGUUGGGCGAGGGAUUGGCCUUUUGACCCCAACAGCAACCGACCGUAAUACCAUUGUGAAAUGGGGCGCACUGCUUUUCGCGCCGAGACUGAUGUCUCAUAAGGCACGGUGCUAAUUCCAUCAGAUUGUGUCUGAGAGAUGAGAG,37,39,44,36,156
455,2,AL596163.1/172398-172500,UUCUUAUCCAGAGUGGUGGAGGGAAUCGGCCCAGUGAAACCCGGCAGCGGAGCGCAAGUUCUAUGCUAAUUCCGAUCAGAAGUAAUAUUCUGGCAGAUAAGUA,29,24,29,21,103
456,2,AL591973.1/137133-137235,UUCUUAUCAAGAGUGGUGGAGGGAAUCGGCCCAGUGAAACCCAGCAGCGGAGCGCAAGUUCUAUGCUAAUUCCGAUCAGAAGUAAUAUUCUGGCAGAUAAGUA,31,24,28,20,103
457,2,AL596165.1/180914-180814,UUCUUAUCACGAAAGGUGGAGGGACUGGCCCUUUGAAGCCUUAGCAACCGGAAUUUAUUUUCACGGUGCUAAUUCCAGCAGUAUAUUCUGAAAGAUAAGUC,28,30,23,20,101
458,2,AL596166.1/166748-166844,AACUUAUCAAGAAAGGUGGAGGGUUCUGGCCCAGUGAAGCCUUGGCAACCGGACUUUUCACGGUGCCAAAUCCAGCAGUAUCACUGACAGAUAAGGC,28,20,26,23,97
459,2,AL591976.1/242770-242867,AACUUAUCAAGAAAGGUGGAGGGUUCUGGCCCCGUGAAGCCUUGGCAACCGGAUUUUUCACGGUGCCAAAUCCAGCAGGUAACACUGACAGAUAAGGC,28,20,27,23,98
460,2,AE017333.1/969726-969839,UUCUUAUUCAGAGAGGCGGAGGGAAUUGGCCCUGUGAAACCUCGGCAGCGGGUUCUGCAUACAGCAGAAUACUGUGCCACAUCCAACAAGCCGUACGGGCUUGGAAGAUAAGAA,32,23,33,26,114
461,2,BX571856.1/15939-16037,UUCUUAUUGUGAGAAGUUGAGGGACUUGGCCCUGUGAUACUUCAGCAACCGACUUUAUAGCACGGUGCUAAAACCAACGAGUUACUCGAAUGAUAAGUA,29,28,23,19,99
462,2,AE017225.1/3092372-3092274,UUCUUAUCCAGAGAGGUGGAGGGACUGGCCCGAUGAAACCCAGCAACCGCGAUGCAGGUGCUAAUUCCAGCAGAACAAAUUUGUUCUGGGAGAUAAGAC,29,20,28,22,99
463,2,AP006716.1/475254-475360,CUCUUAUCAAGAGUGGUGGAGGGAUGUGCCCUAAGAAGCCCAGCAACCGUCGUUUAACGAAAUGGUGCUAAUUCACAUAAAGUAGACAAUACUUUAAGAGAUAAGAG,37,25,26,19,107
464,2,AP006716.1/507636-507743,GACUUAUCCAGAGAAGUGAAGGGAUUUGGCCCAAUGAAACUUCAGCAACAGACUUAAAAGACAAAAGUACUGUGCUAACUCCAAAGAGGUAUGCCUCAAAGAUAAGUG,42,22,24,20,108
465,2,BA000028.3/2365513-2365403,CUCUUAUUCAGAGUUGGUGGAGGGACAGACCCGAUGAAGCCCAGCAACCAUCACUACUGGUGAAAAGGUGCUAAUCUGAUGCAAGGAUAAUAGUUCCUUGAACAAUAAGAG,36,25,28,22,111
466,2,AE017225.1/177275-177161,CUCUUAUCAAGAGUGGCGGAGGGACUGGCCCGAUGAUGCCCGGCAACCGAGCUUAUGACGUAUAAGCUAAGGUGCUAAUUCCUGCAAAAUGAGUUUUCGUUUUGGAAGAUAAGAG,31,29,33,22,115
467,2,AP008934.1/131883-131770,CUCUUAUUAAGAGUGAGUGGAGGGACUUGGCCCUAUGAAACUCCAGCAACAGCAGUCAUAUGCGAUGUGCUAAAUCCAACAACUCAGUAUGACGAUUGAGUUGAAAGAUGGGAA,37,27,29,21,114
468,2,AE017225.1/1375419-1375524,UUCUUAUAAAGAGAGGCGGAGGGACUGGCCCUACGAUGCCUCGGCAGCGGACUCGAUUUUAGAGUGCUGUGCCAAAUCCAGCAAGCAUGUGCUUGAAAGAUGAGAA,29,23,32,22,106
469,2,CP000046.1/900604-900707,CUCUUAUCGAGAGUGGUGGAGGGAUGUGCCCUACGAAGCCCGGCAACCGUCUUAUAUAGAAAUGGUGCCAAUUCACAUAAAGUUUUAACUUUUGAAGAUGAGAG,30,28,27,19,104
470,2,BA000043.1/974636-974744,UUCUUAUCAAGAGCAGGCGGAGGGACGAGCCCAAUGAAGCCCGGCAACCGGCUUGGCGCGCGCCAAGCACGGUGCUAAUUCUUGCAGCGGAAACGCUGAGAGAUAAGAA,30,16,35,28,109
471,2,CP000001.1/185418-185523,UACUUAUCCAGAGAGGUAGAGGGACUGGCCCUAUGACACCUCAGCAGCGGGUUCUGUAAUAGGAACACCGUGCUAAUUCCAGCAAGCAAGUCUUGAAAGAUAAGUG,32,23,28,23,106
472,2,CP000001.1/3927237-3927096,CUCUUAUCAAGAGCAGGUGGAGGGAUUUGGCCCGAUGAAGCCCAGCAACCGACCGUAAUACCAUUGUGAAAUGGGGCGUUUAUGACGCCAAAAGGCACGGUGCUAAUUCCAGCAGAAAGUAAAACUUUCUGGCAGAUAAGAG,44,29,39,30,142
473,2,CP000046.1/2381002-2380907,CACUUAUCUAGAGAGGUGGAGGGACUGGCCCUAUGAAGCCUCGGCAACAUCUCGAAUGUGCCAAUUCCAGUAACCGUAAUGGUUUGAAGAUAAGCA,28,22,25,21,96
474,2,BA000028.3/3162073-3162182,CUCUUAUCAAGAGUGGUGGAGGGAAUAGGCCCUGCGAAGCCCGGCAACCUGUAGCAAUUGCUAUUGAAAGGUGCUAAAUCCUACAGACUUCAUCGUCUGGAAGAUAAGAG,32,25,30,23,110
475,2,AE017355.1/3872413-3872520,UUCUUAUCAAGAGCAGGUGGAGGGACGAGCCCGACGAAACCCGGCAACCGAUCUACAUAAUUGUAGACACGGUGCUAAUUCUCGCAGCAUUACGCUGACAGAUAAGGA,33,21,28,26,108
476,2,AP006840.1/2688754-2688649,GGUUCAUCGAGAGUGGCGGAGGGACUGGCCCCAUGAUGCCACGGCAACCUCUCCCGCGGGGAGAACGGUGCCAAAUCCAGCGGACACUCGGUCCGAGAGAUGAAGC,24,14,37,31,106
477,2,AE017333.1/1735574-1735680,AACUUAUCAAGAGCGGUGGAGGGACUGGUCCGAUGAAACCCGGCAACCUGCGUGUGAAGCGUAAGGUGCUACUUCCAGCAAAAUGCCCUCAUUUUGAGAGAUAAGGA,31,22,31,23,107
478,2,AE017355.1/4749676-4749569,CUCUUAUCAAGAGAGGUGGAGGGACUGUGCCCUGUGAAGCCCGGCAACCGUCAACUUAUGUUGAAAUGGUGCCAAUUCCUGCAAAGCAAAUGCUUUGAGAGAUGAGAG,30,25,31,22,108
479,2,CP000029.1/480767-480869,CUCUUAUCGAGAGAGGUGGAGGGAUGUGCCCUAAGAAGCCCGGCAACCGUCUAAAAUAGAAAUGGUGCCAAUUCACAUAAAGUAUAACUUUAGAAGAUGAGAG,36,22,27,18,103
480,2,BA000043.1/883132-883242,UUCUUAUCAAGAGAAGCGGAGGGAACUGGCCCAAUGAAGCUUCAGCAACCAGCCGCCCGGCGGCCAGGUGCUAAAUCCAGCGAAUUGAGCAUUCAAUUCGGCAGAUAAGAA,34,19,30,28,111
481,2,AP006627.1/604071-603968,UUCUUAUUAAGAGGAGCAGAGGGACUGGCCCAAUGAUGCUUCAGCAACCCCGCCAUGAGCGGAAGGUGCUAAUUCCAGCAGGACUACGUCCUGGGAGAUAAGAG,29,20,31,24,104
482,2,AE017355.1/1833727-1833836,UUCUUAUUAAGAGAGGUGGAGGGACUGGCCCUUCGAAGCCUCAGCAACCUGAUUUAUGUGAUAUAAAGGUGCUAAAUCCUGUAGGAUAUAAAAGUCCUAAUAGAUAAGAA,37,30,26,17,110
483,2,AP006627.1/3104693-3104588,UUCUUAUCGAGAGAGGUGGAGGGACUGGCCCAAUGAAACCCGGCAACCGCAAGUUCGCUUGAAGGUGCUAAAUCCUGCAAAGCAUAUGGGCUUUGGGAGAUGAGAG,29,22,34,21,106
484,2,AE017334.2/197187-197081,AUUGUAUCAAGAGAGGUGGAGGGACUGGCCCUUUGAAACCUCGGCAGCAGGUUCAUUUUUGAAUACUGUGCCACUUCCUGCAAGCUUUAUAGCUUGAAAGAUAGAAU,29,31,27,20,107
485,2,BA000043.1/972359-972191,CUCUUAUCAAGAGUUGGCUGAGGGAAUUGGCCCAAUGAAGCCCAGCAACCGACCGUAAUACUAUCGUGAGAUAGGGCGCACGCCAAGGGCGGCGCCGGAAGCGUCAUGCUUCCGCAGGGCACGGUGCUAAGUCCAACAGAAAGACCGAUGUCUUUCUGAAAGAUAAGAG,47,30,50,42,169
486,2,BA000043.1/2876470-2876356,CUCUUAUCCCGAGCCGGUGGAGGGACAGGCCCGAUGAAGCCCAGCAACCGUCACAACUGUACAUGUGUGAAAUGGUGCUAACCUGUGGCAAGGCGCAGUCCUUGAACGAUAAGAG,30,21,34,30,115
487,2,BA000028.3/2134366-2134264,AACUUAUCCAGAGUGACGGAGGGAACAGGACCUACGAUGUCACAGCAACCUACCUUUACGGAGUGGUGCUUCUUCCUGCAGAAUUUUUUCUGAAAGAUAAGGU,29,27,25,22,103
488,2,BA000004.3/3590821-3590709,CUCUUAUCAUGAGAGGUGGAGGGACUGGCCCGAUGAAGCCCAGCAACCGCCAAGCAGCAAAUCGCUUGGAAAAGGUGCUAAUUCCUGCAAAGCGAUGCUUUGAGAGAUGAGAG,33,21,34,25,113
489,2,AE017333.1/1487506-1487363,CUCUUAUCGAGAGUUGGGUGAAGGACUGGCCUAAUGAUCCCAACAGCAACCGACCGUAAUACCAUUGUGAAAUGGGGCGCGAAUCUCUGCGCCGCUAGGGCACGGUGCUAAUUCCAUCAGACUUUGAAUUCUGAGAGAUAAGAG,39,33,39,33,144
490,2,AE017180.1/2700118-2700220,UUCUUAUCAAGAGUGGUGGAGGGAAAGGCCCUGUGAAACCACAGCAACCGGUCCGGUAGCGGACGCCAGGUGCUAAAUCCUGCCCGAAAGGGAGCGAUGAGAG,28,16,35,24,103
491,2,AE017334.2/4074410-4074519,UUCUUAUCUAGAGAGGUAGAGGGACUGGCCCUAUGACGCCUCAGCAACCAUUAACAUUUGUUAAUAAGGUGCUAAUUCCAGCAAAUUGCGAAAAAUUUGACAGAUGAGAA,37,29,24,20,110
492,2,AE017225.1/4554904-4554783,CUCUUAUCCCGAGCUGGCGGAGGGACAGGCCCGAUGAAGCCCAGCAACCUCACUUGUAGUGGUAAAUACAGGUGAAUAGGUGCUAAAACCUGUGCGAGGCUACAGGUCUCGAACGAUAAGAG,34,23,36,29,122
493,2,BA000043.1/3025512-3025403,CUCUUAUCAAGAGAGGUGGAGGGAUGUGCCCAAUGAAGCCCGGCAACCGUCAGCGCAUGUGCUGAAAUGGUGCCAAUUCACACAAAGCGGCCUGCUUUGAGAGAUAAGAG,31,21,33,25,110
494,2,BA000028.3/3200638-3200530,AUCUUAUCCUGAGAGGUGGAGGGAAAUGGCCCAAAGAAGCCUCGGCAACAGGUUCUAGCUUGAAUACUGUGCCAAAUCCAUCAAGUAUUCUAUGCUUGGUAGAUAAGAG,33,27,28,21,109
495,2,AP006627.1/3008449-3008342,CUUUUAUCCAGAGAUGGCGGAGGGACAGGCCCGAAGAAGCCCAGCAACCAACACGUAACGUGUAAAGGUGCUAACCUGCAGAAUGCUCGGCGUUCUGGAAGAUAAGAG,33,18,32,25,108
496,2,AE017333.1/4014357-4014466,UCCUUAUCAAGAGUGGUGGAGGGACUGGCCCUGUGAAACCCGGCAACCGCUGUCUAUGACAGAAUGGUGCUAAAUCCUUAAGAGCAUGUUCGUGCUCUUGAAGAUAAGGA,29,27,31,23,110
497,2,AE017225.1/320618-320724,UUCUUAUCCAGAGAGGUGGAGGGACUGGCCCUACGAUACCUCAGCAACGGGUUUUUUUAAUACCGUGCUAACUCCAGCAAGCCAUAUAAAGGCUUGGAAGAUGAGAA,31,26,27,23,107
498,2,AE017333.1/3063716-3063609,AGCUUAUAAAGAGAGAUGGAGGGACUGGCCCGGUGAAAUCUCAGCAACCUGCAGCAGUGCAAGGUGCUAAAUCCAGCAGAAUGUCAGGCGCAUUCUGAAAGAUAAGUU,35,21,31,21,108
499,2,AE017355.1/1384699-1384807,AGCUUAUCAAGAGAAGCGGAGGGAACUGGCCCGGCGAAGCUCGGCAACCUGCUUAUAGAAAGCAAGGUGCUAAAUCCAGCAAAAUGGAAUCCAUUUUGAAAGAUAAGGU,38,20,30,21,109
500,2,AP006840.1/138157-138265,CUCUUAUCAAGAGAAGCGGAGGGACCUGGCCCGAUGAAGCUUCGGCAACCAGCCUGCGUCACCAGGCAAGGUGCCAAGUCCAGCCGGGCAUACUACCGGGAGAUAAGAG,29,15,34,31,109
501,2,AE017333.1/1292148-1292264,UUCUUAUCACGAGAGGUGGAGGGACUGGCCCUUUGAAACCUCAGCAACCGGUCUGCACUGACGACGUCAGUGCACCAAGGUGCUAAAUCCAGCAAGCGGAUGCUUGGAAGAUAAGAA,33,23,33,28,117
502,2,AE017355.1/768972-768867,GUCUUAUCAAGAGCAGGUGGAGGGAUGAGCCCUACGAAGCCCGGCAACCGACCCAUUUAUGGGCACGGUGCUAAUUCUUACAACACAUUGUGUUGAAAGAUAAGAG,31,23,29,23,106
503,2,BA000045.2/2730826-2730714,GACUUAUCCAGAGCAGGCGUAGGGAACAGGCCCGGUGACGCCACGGCAACCGCCCACUAGCAACGGGAAAAGGUGCCAAUUCCUGCGGUUCCUCACGAACCGGAAGAUAAGUC,31,15,33,34,113
504,2,CP000029.1/1935501-1935405,AACUUAUCAAGAGAAGUGGAGGGACUGGCCCAAAGAAGCUUCGGCAACAUUGUAUCAUGUGCCAAUUCCAGUAACCGAGAAGGUUAGAAGAUAAGGU,34,20,26,17,97
505,2,AP006627.1/1705479-1705377,UUCUUAUCCAGAGAGAUGGAGGGAUUUGGCCCUUUGAAGUCUCAGCAACCGGCCUUUGGCAAUGGUGCUAAUUCCAAUAGGUAAUGUACCUAGGAGAUAAGAA,29,28,27,19,103
506,2,AE017334.2/2953356-2953255,UUCUUAUCACGAGAGGUGGAGGGACUGGCCCUAUGAAACCUCGGCAGCGGAUUCGUUAUGAAUACUGUGCCAAUUCCAGCAAGGUAACUUGAAAGAUAAGAA,31,24,27,20,102
507,2,AE017355.1/2515876-2515991,UACUUAUCCAGAGAGGUGGAGGGAACGGCCCUAUGAAACCUCAGCAACCCCUAUGUAAAUGCAUAGGAAGGUGCUAAUUCCGCAGAGAACACGUUGUGUUUUUUGGAAGAUAAGAG,36,27,31,22,116
508,2,AP006627.1/1563582-1563686,CUCUUAUAACGAGAAGCGGAGGGACUGGCCCAAUGAAGCUUCAGCAACCAUUCAUUGCGAUGAAAAGGUGCUAAAUCCAGCAAAGGGAACUUUGGCAGAUAAGGG,35,20,29,21,105
509,2,BA000004.3/910192-910088,UUCUUAUCCAGAGUGGUGGAGGGACUGGCCCUGUGAAGCCCGGCAACCUCUUUUUUUAAAGAAGGUGCCAAUUCCAGCAGAACAUGAUGUUCUGAAAGAUAAGAA,30,27,27,21,105
510,2,AE017225.1/4074580-4074471,CUCUUAUUGAGAGCGGUGGAGGGAAAGGCCCUGUGAAACCCGGCAACCUUCAAACGAAAUGUUUGAAACGGUGCUAAUACCUGCAAAACGAAUGUUUUGCAUAAUAAGAG,36,25,28,21,110
511,2,BA000028.3/1319041-1319141,UACUUAUCAAGAGAGGUGGAGGGACUGGCCCGCUGAAACCUCAGCAACAGAACGCAUCUGUCUGUGCUAAAUCCUGCAAGCAAUAGCUUGAAAGAUAAGUU,32,22,25,22,101
512,2,BA000028.3/727026-727131,GACUUAUCAAGAGAGAUGGAGGGAUUGGCCCGAUGAAGUCUCAGCAACCAGCCUAGAUAAGGUAUGGUGCUAAUUCCAAUAGGCUUACAAGCCUUAAAGAUAAGAA,37,23,27,19,106
513,2,AE009951.2/1317653-1317567,UAACCAUCCAGAGAAACGGAGGGACUGGCCCAAUGAUGUUUCAGCAACCUACUUAAAUGUGUGGUGCUAAUUCCAGAGAGAUGGAGA,28,19,23,17,87
514,2,AP008934.1/276954-277060,CUCUUAUCAAGAGUGGUGGAGGGAUGUGCCCGAUGAAACCCAGCAACCGUCGAUUUUUCGAAAUGGUGCUAAGUCACAAAAAGUUAUUUAACUUUUGGAGAUGAGAG,32,29,28,18,107
515,2,AP006840.1/278272-278389,CUCUUAUCCAGAGUAGGCUGAGGGACUGGCCCGAUGACGCCACGGCAACCGGCACGUCUCCCCAGGCGUGCAGCGGUGCCAAUUCCUGGGGAGGGCUCCGCCCUCCCGAAGAUGAGAG,22,18,39,39,118
516,2,AE017333.1/3302616-3302509,CUCUUAUCCAGAGAGGUGGAGGGAAGUGCCCUAUGAAACCCGGCAACCAUCAACACGUGUUGAAAUGGUGCCAAUUCACGCGAAGCGUUAUGCUUUGAAAGAUGAGAG,32,23,30,23,108
517,2,AP008934.1/15667-15765,AUCUUAUUUCGAGAAGCUGAGGGACUUGGCCCAGUGAUGCUUCAGCAACCGGCUGUGUAGUACGGUGCUAAAACCAACGAUACACUCGAAUGAUAAGUA,29,24,25,21,99
518,2,CP000001.1/5213243-5213138,GUCUUAUCAAGAAAAGGUGGAGGGACAGGCCCGAUGAAACCUUGGCAACAGCCGUAUAACGGAAUUGUGCCAAAUCCUGCAGGUAAUAAAUCCUGAGAGAUAAGAA,38,20,28,20,106
519,2,AE017355.1/388363-388251,UCUUUAUCAAGAGAGGCAGAGGGACCGGCCCUUUGAAGCCCAGCAACCUCAGUUUAUACAAACUGAAUAGGUGCUAAUUCCUGCAAAAUGCAUUGCAUUUUGAAAGAUAAAAC,38,28,23,24,113
520,2,BA000028.3/2437307-2437208,CUCUUAUCUAGAGCGGUGGAGGGACUGGCCCUUUGAAACCGCGGCAACCUUCAUAAUUAAAUGAAAGGUGCCAAUUCCUGCAGAAAAUGAAAGAUGAGAG,32,22,26,20,100
521,2,AP008934.1/1011112-1011223,CUCUUAUCCUGAGUGGCGGAGGGACAUGGACCCAAUGAAGCCCAGCAACCUCUUCUUAAUUGAAGAAAGGUGCCAAACCGUUUGCAGACAAAUAGCGUCUGAACGAUAAGAG,35,23,28,26,112
522,2,BA000004.3/1699957-1700066,UUCUUAUCCAGAGAGGUGGAGGGAACGGCCCGAAGAAACCUCAGCAACCAGCCACGAUCCUGUGGUCAGGUGCUAAUUCCUGCAAGCAUUAUUUGCUUGAGAGAUAAGAG,31,24,30,25,110
523,2,BA000028.3/2708645-2708539,UUCUUAUCAUGAGAGGCGGAGGGAAAUGGCCCAACGAAACCUCGGCAACAGGUUCUUAUUAGAAUACUGUGCCAAUUCCAUCAAGCAAAUUGCUUGAAAGAUAAGAG,36,25,25,21,107
524,2,AP008934.1/318535-318643,AACUUAUCCAGAGAAGUUGAGGGAAUUGGCCCUGUGAAGCUUCAGCAACAGACUUUGUAAAGAAGUACUGUGCUUCGUCCAACAAGUAAUACUACUUGAAAGAUAGGUG,36,28,26,19,109
525,2,BA000004.3/3427467-3427355,CUCUUAUCCAGAGUUGGUGGAGGGACAGGCCCGAAGAAACCCCAGCAACCAACACCUGUUAAACAAAGGUGAAAAGGUGCUAACCUGCAAGGCGUUGCCUUGAAAGAUAAGAG,38,19,30,26,113
526,2,AE006470.1/606189-606295,CUAUCAUCCAGAAAGGCGGAGGGACUGGCCCUGCGAAGCCUUGGCAACCUUCAUUCCACAUGAGCGGUGCCAAAUCCAUCCCGGAGGAAAUCCGGGAAAGAUGAUGU,29,19,30,29,107
527,2,AP006716.1/417999-418100,GUCUUAUUAAGAGUGAGUGGAGGGAAUUGGCCCUAUGAAGCUCCAGCAACUGCGCUUUGCGUGAGGUGCUAAAUCCAACAGGAGUUUCCUGAAAGAUAAGAA,30,25,29,18,102
528,2,BA000028.3/3466520-3466401,CUCUUAUUGAGAGUGGCUGAGGGACUGGCCCUGUGACGCCCGGCAACCGUUCAUCGUAAUUCCAGUGAUGAAUAGGUGCUAAAUCCUGCAAAAUACGGACAGUAUUUUGAGAAAUAAGAG,34,30,32,24,120
529,2,BA000016.3/2500083-2499978,CUCUUAUCCAGAGAGGUGGAGGGAAAAAGGCCCUAUGAAACCCGGCAACCAGUGAGAAAUCACUACGGUGCCAAUUCCGGUAAAGAAAUUCUUUACAAGAUGAGAG,37,20,27,22,106
530,2,AP008934.1/1948647-1948540,CUCUUAUCACGAGAGGUGGAGGGAUGUGCCCUUUGAAGCCCGGCAACCGUCUGUAACAGAAAUGGUGCCAAUUCACAUAAAGUUCAUAGAAACUUUAGAAGAUGAGAG,34,25,28,21,108
531,2,CP000088.1/254824-254964,UGCUCAUCCAGAGGGGUGGAGGGACACGGCCCUGUGAAGCCCCGGCAACCAUCCCGGUGGACGUUGCUCGUCAGGUGCGAGGCGGCCGGGACAGGUGCCAACUCCGUCCCACUGUCAAGGUGGCAGUGGGGAAGAUGAGGG,26,21,55,39,141
532,2,AP006627.1/1701649-1701759,AACUUAUCAAGAGUGGCGGAGGGACCUGACCCAAUGAAGCCCGGCAACCAGUUUAUUUGUAAACCACGGUGCUACAUUCAGCAGAGCAGCUUUUGUUCUGAAAGAUAAGUG,33,26,28,24,111
533,2,AE017333.1/3080753-3080616,CUCUUAUCCCGAGCUGGUGGAGGGACAGGCCCAAUGAAACCCAGCAACCGGUUUCUCUUAUUAAUGGAAAAAAACAGUUUCUGAGACAACUACGGUGCUAACCUGAUGCAAGGUGUUCAAUACCUUGAGCGAUAAGAG,42,32,33,31,138
534,2,AE017333.1/1489705-1489804,UUCUUAUCAAGAGCAGGCAGAGGGACAAGCCCGAUGAAGCCCGGCAACCGACUUUUUAAGCACGGUGCUAAUUCUUGCAGCUGACGCUGAGAGAUAAGGA,29,20,28,23,100
535,2,AE017180.1/1014096-1014202,AACUUAUCAAGAGCGACCGAGGGACAGGCCCGGUGACGUCGCGGCAACCUCCCCAUGGGGGGAAGGUGCCAAUUCCUGCGAGACCGACAGGUUUCGGGAGAUAAGGA,27,15,37,28,107
536,2,AP006840.1/1830606-1830721,CUCUUAUCCAGAGAGGUGGAGGGAACUGGCCCGAUGAAACCCGGCAACCCAGGACGCUGCGGGGCGUCCGAAGGUGCCAACUCCACCGGCGGCCUCACGCCGCCGGAAGAUAAGAG,27,13,39,37,116
537,2,AP006716.1/14213-14314,AACUUAUUAAGAGAAGUGGAGGGACACGGCCCUGAGAAACUUCAGCAACCGGCGAUGCAUACGCACGGUGCUACUACCAACGAGAUACUCGAAUGAUAAGUA,35,18,26,23,102
538,2,AE017333.1/1207733-1207622,UUCUUAUCAAGAGAGGCAGAGGGACUGGCCCGAUGAAGCCUCAGCAACCGGUGAAUGAAUAUUCAUGACCAAGGUGCUAAAUCCAGCAAGCAGCCUGCUUGGAAGAUAAGAA,37,21,30,24,112
539,2,BA000028.3/1098099-1097993,UUCUUAUCCAGAGAGGUGGAGGGACUGGCCCAAGGAAGCCUCGGCAACAGACUUAUUUGAUUAAGUACUGUGCCAAUUCCAGUAGCGUAAUUGCUAGAAGAUGAGAA,32,26,29,20,107
540,2,BA000043.1/745485-745383,UUCUUAUCAAGAGAGGGGGAGGGACUGGCCCGGUGAACCCUCAGCAACCUGGCCCGCGGCCAAGGUGCUAAAUCCAGACAGGCGGAAGCCUGGAAGAUAAGAA,29,14,34,26,103
541,2,AP006627.1/1983212-1983311,UUCUUAUCAAGAGAAGUGGAGGGAAUGGCCCAAUGAAGCUUCAGCAACCAGCCAACCAUGGUCAGGUGCUAAAUCCAGCAGUUUAUCUGCAAGAUAAGAG,33,21,25,21,100
542,2,CP000001.1/334370-334474,UUCUUAUCCAGAGAGGUGGAGGGACUGGCCCUACGAUACCUCAGCAACGGGUUUUUUAAUACCGUGCUAACUCCAGCAAGCCUAUAAGGGCUUGGAAGAUGAGAA,29,25,28,23,105
543,2,AP006627.1/951406-951512,GACUUAUCAAGAGCGACUGAGGGAUUAGGCCCAAUGACGUCCAGCAACCUCCCGUUACGGGGAAGGUGCCAAUUCCUGCAGAAUGGGAUCAUUCUGAAAGAUAAGCC,31,21,29,26,107
544,2,AP006716.1/2100177-2100072,UUCUUAUCAAGAGAGGUGGAGGGAUGUGCCCUAUGAAGCCCGGCAACCGUCUAGUUAUAGAAAUGGUGCCAAUUCACAUAAAGUUGAUUACUUUAGAAGAUGAGAG,33,28,28,17,106
545,2,AP008934.1/616628-616728,AACUUAUCAAGAGAAGUGGAGGGACUGGCCUGUGGAUACUUCGGCAACAUGAUUAUGCGUGUGCCAAUUCCAGUAGCAUCAUUUAUGCUAGAAGAUAAGAA,32,26,26,17,101
546,2,BA000004.3/1348816-1348929,GACUUAUCGAGAGAGGCAGAGGGACUGACCCGAUGAUGCCCGGCAACCCGUUUGUUAGCCAAGCAAACGAAGGUGCUAAUUUCAGCAGAAUGAUUUCAUUCUGGAAGAUAAGCG,34,24,32,24,114
547,2,CP000141.1/2169978-2169874,CUCUUAUCAAGAGUGGCGGAGGGACUGGCCCAAUGAAGCCCGGCAACCGGCCAUAUUUUUGGCAAUGGUGCCAAUUCCUGCGGAUUAAAUUCCGGGAGAUAAGAG,27,23,31,24,105
548,2,AM412317.1/1193313-1193415,UUCUUAUCAAGAGCGGUGGAGGGACUGGCCCUAUGAAACCCGGCAACCAGUAUAUAUUUUAUACAUGGUGCUAAAUCCUGCAGAUUUAACUGAAAGAUGAGAA,33,27,24,19,103
549,2,AM180355.1/1724139-1724245,GUCUUAUCAAGAGUGGUGGAGGGACUGGCCCUUUGAAACCCGGCAACCAGUAUAUUUUAUAUACAUUGGUGCUAAAUCCUGCAACUAAUAUAGUUGAUAGAUGAGUA,32,32,25,18,107
550,2,AAWL01000001.1/327573-327687,CUUUCAUCAAGAGCUGGCUGAGGGACUGGCCCGAUGACGCCGCGGCAACCAUCGCAUCUUUGGGUGCGAAACGGUGCCAAUUCCUGCAGAACGGAUAAGUUCUGACAGAUGAGGG,27,23,36,29,115
551,2,AAJM01000461.1/236-129,UUCUUAUCCAGAGAGGUGGAGGGACUGGCCUUAUGAAACCUCAGCAACAGGUCUGCUUAAGUAGACACUGUGCUAAUUCCAGCGGGUGAUAAUCCUGAUAGAUGAGAG,30,27,30,21,108
552,2,CP000728.1/2062169-2062064,CUCUUAUCAAGAGUGGCGGAGGGAUCAGGCCCUGUGAAGCCCGGCAACAGCUAGUUGAACCUAGAAAUGUGCUAAUUCCUGCAGUGGAUUCACUGAGAGAUGAGGG,28,23,33,22,106
553,2,CP000568.1/2679822-2679717,ACCUUAUCAAGAGAGGCGGAGGGAAUGGGCCCUAUGAAACCCGGCAACCGGCAGAAUUGUAUCGGUGCCAAUUCCUACAGGAUGUAAAAGUCCUGACAGAUGAGGA,33,19,31,23,106
554,2,AP008230.1/4549598-4549497,UUCUCAUCCAGAGUGGUGGAGGGACUGGCCCGAUGAAACCCGGCAACCGGCCUAUAUGGCAGUGGUGCUAAUUCCAGCAGGAUUAUUCCUGGAAGAUGAGCA,25,22,31,24,102
555,2,CP000726.1/3620086-3619976,UUCUUAUCCAGAGCGGCGGAGGGACUGGCCCUAUGAAGCCCGGCAACCACUAAGGUGUUUUAUUACUUUAAACGGUGCUAAUUCCAGCAGGUUAAACCUGGUAGAUAAGAU,30,29,28,24,111
556,2,AAOX01000018.1/27020-26864,CUCUUAUCAAGAGCAGGCAGAGGGACUUGGCCCGAUGAUGCCCAGCAACCGACCGUAAUUCCAUCGUGAGAUGGGGCGCAAUCCUUGCGCCGGAGAAUUCCUCCAUAAGGCACGGUGCUAAUUCCAGCAGAAAGCUUGGCUUUCUGGCAGAUAAGAG,40,32,44,41,157
557,2,AAXV01000005.1/126573-126679,UUCUUAUCAAGAGAGACGGAGGGAUCGGCCCGAUGAAGUCUCAGCAACCAGCUCAAUCAGUAUGGUGCUAAUUCCUUUUGGCAAAAUCUAAGCCUGAAAGAUGAGAA,34,25,26,22,107
558,2,AAOX01000014.1/12064-12163,UUCUUAUCCAGAGAGGUAGAGGGACUGGCCCUAUGACACCUCGGCAGCGGACUGAUGAACCGUGCCAAUUCCAGCAGGCAGAUUGCCUGAAAGAUAAGAA,29,19,28,24,100
559,2,CP000612.1/2418052-2417945,UACUUAUCAAGAGUGGUGGAGGGACUGGCCCUAUGAAGCCCGGCAACCGGCCAUUGGAUGGCGGCGGUGCCAACUCCUGCAGGACUUUUAGUUCUUGAGAGAUAAGGU,24,25,35,24,108
560,2,CP000673.1/1716322-1716209,UUCUUAUCAAGAGAGACGGAGGGACUGGCCCUAUGAUGUCCGGCAACCAGAAGAUUUUUAUUUCAUGGUGCUAAUUCCAGCAGGUAUUAAUAUGAAAAGCCUGAUAGAUAAGAG,36,31,28,19,114
561,2,CP000673.1/2974771-2974666,GCUUUAUCAAGAGCGGUGGAGGGACUGGCCCUAUGAAGCCCAGCAACCAGUAUUGUUUUUUAAUACAUUGGUGCUAAUUCCUACAGCUUAAGCUGAAAGAUAGGGG,29,29,28,20,106
562,2,AM180355.1/174147-174250,ACCUUAUCAAGAGAGGCUGAGGGAUAGGCCCUGUGAAGCCCAGCAACCACCCAAAUGGGAAAAGGUGCUAAUUCCUACAAGACAAAAGUCUUGAAAGAUGAGGU,37,18,27,22,104
563,2,CP000724.1/4004549-4004448,AACUUAUCAAGAGAAACUGAGGGACUGGCCCGAUGAUGUUUCAGCAACCACACAUAUGUGACGGUGCUAAAUCCAGCAGAACAUAGUUCUGGGAGAUGAGAA,35,21,26,20,102
564,2,AAXV01000010.1/2942-2843,UUCUUAUCAAGAGAAGCAGAGGGACUGGCCCAAUGAAGCUUCAGCAACCAACUUUUUGUCAGGUGCUAAAUCCAGAAGACCGUUGAGUCGAAGAUGAGAA,33,22,25,20,100
565,2,CP000724.1/763663-763763,GCCUUAUCAAGAGUGAUGGAGGGGAAGGGCCCGAUGAAAUCCGGCAACCAUAGAGUGUAUGGUGCUAAGUCCCUCAGAAUUUUGGUUCUGAAAGAUGAGGA,29,23,32,17,101
566,2,AAXV01000011.1/30443-30546,UUCUUAUCAAGAGAGAUGGAGGGACUGGCCCGAUGAAAUCUCGGCAGCGGAACUAUUAAGUUACUGUGCCAAAUCCAGCAAGCAAUGUUCUUGAUAGAUAAGAG,33,25,27,19,104
567,2,AAOX01000002.1/320062-320165,UUCUUAUCAAGAGAGACGGAGGGGUAUGGCCCGAAGAAGUCUCGGCAGCAGGUUCAUCCGGACACUGUGCCAAAUCCAUCAGGCAAAGGCCUGGCAGAUAAGAA,31,18,31,24,104
568,2,ABCB02000018.1/9340-9436,CCCUUAUCAAGAGAGGCGGAGGGAACAGACCCUGUGAUGCCCGGCAACCUGCGGUUUGCAAGGUGCCAAUUUCUGCGGGAAAACCGGAAGAUGAGGU,25,17,32,23,97
569,2,CP000685.1/4776282-4776182,UACUUAUCCAGAAAGACUGAGGGAAUAGGCCCAAUGAAGUCUUAGCAACCUGUUGCCGAAUAAGGUGCUAAAUCCUUCCGCUAUAAGCGGGCAGAUAAGAA,34,22,24,21,101
570,2,CP000557.1/1285675-1285779,GUCUUAUCAAGAGUGGGCGAGAGAACGGGCUUGAUGACCCCACAGCAACCUGCCGCUGGCAAGGUGCUAAAACCCGCAAAGCGAGUUCGCUUUGGAUGAUAAGAA,30,19,31,25,105
571,2,AE015927.1/303338-303443,CUCUUAUCGAGAGAGGUGGAGGGAAAGGGCCCUAUGAAACCCGGCAACCAAUAUUUUUAGAAGUAUUAAGGUGCCAAUUCCUGCAGAAAGUUCUGCAAGAUAAGAG,35,24,28,19,106
572,2,AE001437.1/453563-453665,UUCUUAUCAAGAGUGACGGAGGGAUAGGCCCUAUGAAGUCCGGCAACAUCCAAUUAUUUUGGAGAUGUGCUAAUUCCUACAGGUUUAUCCUGAGAGAUGAGAA,30,29,26,18,103
573,2,CP000673.1/503077-503184,UUCUUAUCAAGAGCGGCGGAGGGAUAGGCCCUAUGAAGUCCGACAACCGACAUUUUGUGCAUCGGUGUCAAUUCCUACAGAGUGUGUUAAUACUCUGAAAGAUAAGAA,32,28,27,21,108
574,2,AAOX01000055.1/439-545,UUCUUAUCGAGAGUGGUGGAGGGACUGGCCCUGUGAUACCCGGCAGCCGCUGACUUAGUCAGAAUGGUGCUAAAUCCAGCAAAGCGCAAUGCUUUGGCAGAUAAGAU,27,25,32,23,107
575,2,CP000612.1/107660-107768,CUCUUAUCCUGAGAGGUGGAGGGACUGGCCCUAUGAAACCCAGCAACCAUUCGGUUAAGCCCGGACUGGUGCUAAUUCCUGCAGAAGAUAUUCUUCUGGCAGAUAAGAG,28,26,29,26,109
576,2,AAWL01000002.1/146610-146509,UACUCAUCAAGAGUUGGUGGAGGGACUGGCCCGAUGAAACCGCGGCAACCAUUUGGCAAGUCCAAAACGGUGCCAAUUCCGGCGUACGGCGCGAGAUGGGGA,26,17,34,25,102
577,2,AP008230.1/4551167-4551265,CUCUUAUCAAGAGAGGCGGAGGGACUGGCCCCAUGAAGCCCGGCAACCUACAUAUGUGAGGUGCUAAAUCCAGAGAACCAUCAGGUUCGAAGAUAAGAG,31,17,28,23,99
578,2,CP000673.1/1915422-1915314,UUCUUAUCAAGAGAGGUGGAGGGACUGGCCCUAUGAUGCCCGGCAACCUGAAUGUAUUUACAUUCAAUGGUGCUAAUUCCAGCAGGUAAUAUAACCUGAAAGAUGAGAG,33,28,28,20,109
579,2,AP009389.1/1533734-1533850,CUCUUAUCCGGAGUGGCGGAGGGACUGGCCCUAUGAAGCCCGGCAACCUUUGGGUAUAUAGGCGUACCCAAAAAGGUGCUAAUUCCUGCAGGAGAUUUAUCUUCUGACAGAUAAGGG,29,28,34,26,117
580,2,CP000673.1/3104226-3104112,UUCUUAUCAAGAGAGGCGGAGGGACUGGCCCUAUGAAACCCAACAACCGGCAUUUAUUUCAAUAUGUAUCGGUGUUAAUUCCUGCAGAGUUAAUUUAUACUCUGAAAGAUGAGAA,36,33,25,21,115
581,2,AAOX01000006.1/30687-30791,CUCUUAUCCAGAGAGGCGGAGGGAAUUGGCCCUAUGAAGCCUCGGCAGCAGACUCCUUGCGAGAACUGUGCCAAAUCCAACAAGCGGAAGCUUGGAAGAUGAGAG,30,18,32,25,105
582,2,AE015927.1/1456770-1456662,AGCUUAUUAAGAGCGGUGGAGGGACUGGCCCUAUGAAGCCCGGCAACCUGUAUAUGUGUUUGCAUAUUAUAAGGUGCUAAAUCCUGCGGUGUAAACCGAGAGAUGAGGA,30,27,33,19,109
583,2,AE017194.1/1084280-1084386,UUCUUAUGUUGAGAAGUGGAGGGACGGGCCCUAUGAAACUUCGGCAACCUCGUAUGAGACGAAAGGUGCCAAAUCCUGCAGGUGAAGAAACACCUGAAAGAUAAGAG,35,21,31,20,107
584,2,AE017194.1/3299167-3299061,UUCUUAUUAAGAGAGAUGGAGGGACUGGCCCGAUGAAAUCUCAGCAACAGGCUAUAAAAGUACUGUGCUAAGUCCAGCAAACGUAUGAAGCGUUUGGAAGAUGAGGG,35,24,31,17,107
585,2,AE015927.1/1226200-1226097,AUCUUAUCAAGAGCGGUUGAGGGACUGGCCCUAUGAAACCCAGCAACCUAUACACAAAGUAUAAAGGUGCUAACUCCAGCAGGAAAUUUCCUGAAAGAUAAGAA,39,21,22,22,104
586,2,AAXV01000007.1/42365-42470,CUCUUAUCAAGAGUAGCUGAGGGACUGGCCCUAUGAAGCUCGGCAACCUCCUUUUAUAAAGGAAGGUGCUAAAUCCUGCAAACGAAAUUCGUUUGAUAGAUAAGAG,33,27,25,21,106
587,2,AAOX01000002.1/340881-340984,CACUUAUCUAGAGUGGCUGAGGGACUGGCCCAUCGAAGCCCGGCAACCUGCUAAAAGCAAGGUGCCAAUUCCAGCAAAAUGUCCAGCAUUUUGGGAGAUAAGGU,30,21,28,25,104
588,2,AAXG02000006.1/101826-101729,GCCUUAUCAAGAGCGGUGGAGGGAACGGCCCGAUGAAACCCGGCAACCUGCGCAUUGCGCAAGGUGCCAAAUCCGGCGAGAGAAUCGAAAGAUGAGGA,29,12,33,24,98
589,2,CP000673.1/818867-818971,AACUUAUUAAGAGAGGCGGAGGGAAAGGCCCUAUGAAGUCCGGCAACCAGCAUUAUGUAAUGUAUUGGUGCUAAAUCCUGCAGCAUUGUAGCUGAAAGAUGAGGU,33,25,30,17,105
590,2,AE001437.1/1976371-1976471,UUCUUAUCAAGAAGGUGGAGGGACUGGCCCUAUGAAGCCUGACAACCGGCAAAUGUACGGUGUUAAUUCCUGCAAAACUUAUUUGUUUUGAAAGAUAAGAA,32,28,24,17,101
591,2,AE001437.1/2914841-2914733,GUCUUAUCAAGAGAGGUGGAGGGACUGGCCCUAUGAAACCCAACAACCAGCAUUUUUUAAUUAGAUGUAUGGUGUUAAUUCCUGCAAAGUUAAUUUUGAGAGAUAAGAG,35,32,26,16,109
592,2,CP000232.1/2070462-2070570,CUCUUAUCGAGAGCUGGCGGAGGGACUGGCCCGAUGAAGCCCGGCAACCGGCCUCUUAGAACCCAGGUACGGUGCCAAUUCCUGCAGGAUUUCUCCUGGCAGAUGAGAG,23,21,34,31,109
593,2,AAEW02000009.1/42224-42117,GUGUUAUCACGAGUGGUGGAGGGAAUGGCCCUUUGAAACCACAGCAACCGGUCCUGACGUUCAGGAUGACAGGUGCUAAUUCCACCCCCGCAAGGGGACAGAUGAGAC,28,20,33,27,108
594,2,AAWL01000026.1/22109-22215,CUCUUAUCAAGAGCGGUGGAGGGACUGGCCCUGUGAAGCCGCGGCAACCGGCAGCAAUGCGUCUGGUGCCAAAUCCAGCAGAAUCUUCGGAUUCUGGAAGAUGAGAG,26,20,35,26,107
595,2,CP000724.1/968949-968838,CUCUUAUCAAGAGAGGUGGAGGGACUGGCCCGAUGAAACCCGGCAACCACGAAUUGUUUUUGCAAUUCGAAGGUGCUAAUUCCAACAACACUUAUGUGUUGAAAGAUGAGAG,34,27,29,22,112
596,2,ABCF01000005.1/97205-97306,UUCUUAUCGAGAGAGGCAGAGGGACUGGCCCUGUGAAGCCUCGGCAGCGGACUAUUUAUAGUACCGUGCCAAAUCCAGCAAGCAUGUCUUGGGAGAUAAGAA,28,22,30,22,102
597,2,AAXV01000019.1/61222-61331,AUCUUAUCAAGAGAAGCAGAGGGAUUUGGCCCGAUGACGCUUCAGCAACCUCUAACAAAUGUUAGAAAGGUGCUAAUUCCAGCAAAGGUUUUUCCUUUGAGAGAUAAGAG,36,28,26,20,110
598,2,AAOX01000038.1/20734-20635,UUCUUAUCAAGAGAGGUGGAGGGACUGGCCCGAUGAAACCCGGCAACCGGCAAUAGAACGGUGCUAAUUCCAGCAGAGCAUGAUCUCUGGCAGAUAAGUU,29,20,29,22,100
599,2,CP000612.1/3367128-3367031,UGCUCAUCAAGAGAGGUGGAGGGACUGGCCCGAUGAAACCCGGCAACCUCACGUAAGGUGCCAAGUCCUGCGGGAAGAAUAUUCCUGACAGAUGAGGU,27,17,31,23,98
600,2,BA000028.3/3200764-3200871,UUCUUAUCGAGAGAAGCUAAGGGACCUGGCCUGUUGACGCUUCAGCAACCUCUAUCUCCAUUAGAAAGGUGCUACCUCCAGCAAGAUGUAUGUCUUGAAAGAUAAGAG,31,28,25,24,108
601,2,AAOX01000006.1/96737-96624,UUCUUAUCAAGAGAGGCAGAGGGUAUGGCCCUGUGAAGCCUCAGCAACCUUCAAUGGAUAAUAUUGAAAAGGUGCUAAUUCCUGCAGGUCCUUUAUGGGCUUGAAAGAUAAGAA,35,30,29,20,114
602,2,BA000028.3/2856865-2856757,UCCUUAUCAAGAGUCGGGGGAGGAAUCUGGUCCAUUGAUCCCGCAGCAACCAGUUACAAUGAAGUAACAUGGUGCUCAUUCCAGCAAGCGUAGGCUUGAUAGAUGAGAA,32,25,29,23,109
603,2,CP000673.1/3384182-3384086,UUCUUAUUUUGAGAGACGGAGGGACUGGCCCUAUGAUGUCCGGCAACCUGAAUAUUUAAGGUGCUAAUUCCAGCAGGUAUUACCUGAGAGAUAAGAA,28,27,25,17,97
604,2,CP000382.1/316300-316411,AUCUUAUCAAGAGUGGUUGAGGGACUGGCCCUAUGAAACCCGGCAACAACUAAUUUUCAUUUAAAUUAGUAAUGUGCUAAUUCCAGCAGGAAAUUUUCCUGAAAGAUAAGAG,38,32,23,19,112
605,2,AE001437.1/1073888-1073785,UCCUUAUCAAGAGAAACGGAGGGACUGGCCCAAUGAUGUUUCAGCAACCAAGGUUUUAUACUUAUGGUGCUAAUUCCAGCAGGAUAUUUUCUGAAAGAUGAGGA,32,29,25,18,104
606,2,ABDQ01000003.1/211832-211918,UGCUUAUCUAGAGUGGCGGAGGGACUGGCCCUUUGAAGCCCAGCAACCUAUAUUUAUUAUGUGGUGCUAAUUCCAGACAGAUGAGGA,22,24,24,17,87
607,2,CP000232.1/1354284-1354167,CUCUUAUCGAGAGUGGUGGAGGGACUGGCCCGAUGAAGCCCGGCAACCCGCUCUCCUGGUUUCUCCGGGGGCGACAGGUGCCAAUUCCUGCAGGGCAGAAGGCCCUGAGAGAUAAGGG,23,21,42,32,118
608,2,AAXV01000007.1/124740-124627,CUCUUAUCAAGAGCGGCGGAGGGAUAGGCCCUAUGAUGCCCGGCAACCAGUAGGUGAUGAACUUACUAAGGUGCUAAUUCCUACAGAUUCUUACUUGGAUCUGGCAGAUAAGGG,30,28,32,24,114
609,2,ABCF01000016.1/2236-2349,CUCUUAUCGAGAGCGGCGGAGGGAUUAGGCCCGAUGAAGCCCGGCAACCUACAGGCAGUUUCUGCUUGGAAAGGUGCUACAUCCUACAGGCUCAAUGAGUCUGGAAGAUAAGAG,30,23,35,26,114
610,2,CP000612.1/2872894-2873007,UUCUUAUCCAGAGAGGCUGAGGGACUGGCCCUGAGACGCCCGGCAACCUUCUUAGGCAUUUAUCUAAGAAAGGUGCUAAUUCCUGCAGAAGAAUAAUCUUCUGAAAGAUAAGGA,34,28,28,24,114
611,2,AP009389.1/251789-251896,UUCUUAUCGAGAGAAGGGGAGGGACGGACCCAAUGAACCUUCGGCAACCUUCAGGCUUGAAGGCCUGAAAAGGUGCCAAUUUCCGCCGGGUAACCGGAGAGAUAAGAA,32,19,33,24,108
612,2,CP000142.2/516461-516352,UCUUUAUCGAGAGUGGUGGAGGGAUAGGCCCUGUGAAACCACAGCAACCGAUUCGCCGGCGCGAAUGUCAGGUGCUAAUUCCUACCCCUUCAACAGGGGAGAGAUGAGGA,28,22,34,26,110
613,2,AE015927.1/2676955-2676853,UUCUUAUCAAGAGAGGCGGAGGGACUGGCCCUAUGAAACCCGGCAACCAAAAAUAAUAAUUUUAAGGUGCCAAUUCCAGCAGGUGAAACCUGACAGAUAAGAC,37,20,24,22,103
614,2,CP000232.1/1204935-1204832,GGCUUAUCGCGAGAGGUGGAGGGAGGGCCCCGAUGAAACCCGGCAACCCCGCUAUUUAGCCGGAAGGUGCCAAGUGCCGCAGGAAACCUCCUGGAAGAUAAGUU,26,16,35,27,104
615,2,CP000673.1/1916685-1916789,UUCUUAUCAAGAGAGGUAGAGGGACUGGCCCUGUGAUACCCGGCAACCUUAUUGUUUUCAAUGGUGCUAAUUCCAGCAGGCAUGUAUUUGCUUGACAGAUGAGAA,27,31,27,20,105
616,2,AAOX01000005.1/171326-171162,CUCUUAUCGAGAGCAGGCGGAGGGAUUUGGCCCGAUGAAGCCCAGCAACCGACCGUAAUUCCGUUGUGAAACGGGGCGCAGCAAGAUUUGCGCCGGUAUGUAAAUACCUUUAAGGCACGGUGCUAAUUCCAACAGAGGAGAUUUUUCUUUUCUGGGAGAUAAGAG,43,39,48,35,165
617,2,AAXV01000033.1/3690-3784,CUCUUAUCAAGAUAGGUGGAGGGACUUGGCCCAAUGAAGCCUCGGCAACCGAAACAUAGGUGCCACUUCCAACCGAUGUAUCUGAGAGAUAGGAG,28,19,26,22,95
618,2,AAOX01000002.1/320243-320340,CACUUAUCCAGAGAGGCGGAGGGACUGGCCCGAUGAAGCCUCGGCAGCAGGUCUGUUGACACUGUGCCAAUUCCACCGGUAUACCGGAAAGAUAAGCA,26,17,29,26,98
619,2,CP000482.1/3869976-3869870,UGCUUAUCAAGAGUGGUGGAGGGAAAGGCCCUGUGAAACCACAGCAACCGGCCGUCAUGGCGCCAGGUGCUAAUUCCUGCCGUCAGGCAAAGAUGAGAGGGUGUGCU,26,20,36,25,107
620,2,CP000698.1/4591678-4591570,GCUUUAUCGAGAGUGGUGGAGGGAAAGGCCCUGUGAAACCACAGCAACCGGUUCGCGAAAGCGAAUGCCAGGUGCUAAAUCCUGCCGACUGACCAGGCGAAGAUGAGGU,30,18,36,25,109
621,2,AL009126.3/3997775-3997881,ACCUUAUCAAGAGAGGUGGAGGGACUGGCCCUAUGAUACCCGGCAACCGCUGUUUCAAACAGAAUGGUGCUAAAUCCUUAAGAACAUUGCGUUCUUGCAGAUGAGGC,30,25,28,24,107
622,2,CP001097.1/2001878-2001771,CUAUCAUCGAGAAAGGUGGAGGGACUGGCCCUGAGAAGCCUUGGCAACCGUCACGCACAGUGAUUGGUGCCAAUUCCAUCCCGGACUGCGAGCCGGGAGAGAUGAUGG,26,19,36,27,108
623,2,CP001336.1/1583758-1583658,CUCUUAUCCAGAGUAGGUGGAGGGACUGGCCCGAUGAAACCCGGCAACCGACAUGAAAAUGCACGGUGCUAAAUCCUGCAGGAAAUACUGGGAGAUGAGAG,31,17,31,22,101
624,2,CP001022.1/2707752-2707649,CACUUAUCCAGAGAGGUGGAGGGACUGGCCCUACGAAACCUCGGCAACAGACUCAUUAUGAGCACUGUGCCAAUUCCAUCAGACAAUUGUCUGAGAGAUGAGUC,30,22,26,26,104
625,2,AL009126.3/1258304-1258424,UUCUUAUCGUGAGAGGUGGAGGGACUGGCCCUUAGAAACCUCAGCAACCGGCUUGUUUUGCAUUUGCAAAGCGCCAAGGUGCUAAAUCCAGCAAGCGUUUUUUAUGCUUGGAAGAUAAGAA,32,33,32,24,121
626,2,AE008691.1/500243-500352,CUCUUAUCAAGAGAGGUGGAGGGAAAGAGCCCGAUGAAACCCGGCAACCUGUCCUUUUAAGGAUAAGGUGCCAAUUCUCUCAGAAGAUUUUUUCUUCUGAAAGAUGAGGG,32,28,29,21,110
627,2,CP001390.1/1543852-1543744,UGCUUAUCAAGAGUGGUGGAGGGAAAAGGCCCUGUGAAACCACAGCAACCGGUUGAUCCGAAAGGACGGCGUCAGGUGCUAAAUCCUGCCCAUUGGGUAAAGAUGAGAG,32,20,35,22,109
628,2,ABDU01000083.2/79240-79352,UUCUUAUCAAGAGAGGUGGAGGGACUGGCCCUGUGAAACCCAGCAACCUAUGGUAUAAGUAUUUUUUAUGUCAUAACGGUGCUAAAUCCUGCAGGUUUACUGAUAGAUAAGUA,33,34,27,19,113
629,2,AL009126.3/1424683-1424527,CUCUUAUCGAGAGUUGGGCGAGGGAUUUGGCCUUUUGACCCCAAAAGCAACCGACCGUAAUUCCAUUGUGAAAUGGGGCGCAUUUUUUUCGCGCCGAGACGCUGGUCUCUUAAGGCACGGUGCUAAUUCCAUUCAGAUCUGAUCUGAGAGAUAAGAG,37,43,42,35,157
630,2,ABDT01000114.2/68234-68332,CUCUUAUCAAGAGAGGUGGAGGGAUAGGGCCCAGUGAAACCCGGCAACCUGUAUAUACAAGGUGCCAAUUCCUGUAGAUGUAAUUCUACAAGAUAAGAA,33,22,25,19,99
631,2,CP001089.1/3288078-3288187,UUCUUAUCAAGAGCGACCGAGGGACUGGCCCGGUGACGUCGCGGCAACCCGCCUGAAAAGGUACGGUGCCAAUUCCAGCAAAGCCGCACAGCGGUUUUGACAGAUAAGGA,29,18,33,30,110
632,2,CP000879.1/1211576-1211465,UCCUUAUCGAGAGAGGCGGAGGGACUGGCCCGAAGAAGCCCGGCAACCUGCAUAAUUUAACAAAAUUAUGCAAUGGUGCUAAAUCCUGCAGAGAAAUUCUGGGAGAUAAGGA,37,22,31,22,112
633,2,ACOM01000005.1/822103-822219,AACUUAUCAAGAGUGGUGGAGGGACUGGCCCUAUGAAACCCGGCAACCGACAUUUAGUUCAUUUACUAUAUGUGACGGUGCUAAUUCCUGCAGUUUAUUUAAACUGGUAGAUGAGAG,33,34,29,21,117
634,2,AE008691.1/2076682-2076573,CUCUUAUCAAGAGUGGUGGAGGGACUGGCCCGAUGAAACCCGGCAACCGGCACGUAAGUGCUUGGUGCCAAUUCCUGCAGGUUGGGGUUACCCAGCCUGAGAGAUGAGAG,25,22,37,26,110
635,2,CP001098.1/2431377-2431263,CAAUCAUCAAGAGUGGUGGAGGGACUGGCCCGAAGAAGCCCGGCAACCUACCUGAGUUUAGCAAGGUAAGGUGCCAAAUCCUGCAUUCUGGGGAAUCCGGAGUGAGAGAUGAGGG,32,20,39,24,115
636,2,CP000909.1/4069333-4069227,UGCUCAUCGAGAUGGGCUGAGGGACUGGCCCGAUGACGCCCGGCAACCCCCGCCAGGGAAGGUGCCAAAUCCAGCGGCAAUGGAUAUCAUUGGCCGAAAGAUGAGAG,27,15,36,29,107
637,2,AL009126.3/3364503-3364397,CUCUUAUCAAGAGAGGUGGAGGGAAGUGCCCUAUGAAGCCCGGCAACCAUCAACACUGUUGAAAUGGUGCCAAUUCACACGAAGCGUUCAGCUUUGAAAGAUGAGAG,33,22,29,23,107
638,2,CP001022.1/2804795-2804898,UUUUUAUCGCGAGAGACGGAGGGACUGGCCCGAUGAUGUUUCGGCAGCGGACGAUUAAAUCGUACUGUGCCAAAUCCAGCAAGCUGCGGCUUGAGAGAUAAGAA,28,23,32,21,104
639,2,CP001089.1/3739157-3739264,UGCUUAUCAAGAGUGGUGGAGGGAUAAGGCCCGAUGAAACCACAGCAACCGGCCCUGCGACAAACAGGGCGCCAGGUGCUAAAUCCUGCCGCAAGGCGAAGAUGAGCG,31,14,35,28,108
640,2,CP001022.1/2309368-2309263,CUCUUAUCGAGAGUGGUGGAGGGACUGGCCCGAUGAAACCCGGCAACCGCGGAAUUUAUUCCGAAGUGGUGCUAAUUCCAGCAGACGAUUGUCUGCAAGAUGAGAG,27,23,33,23,106
641,2,AP008230.1/5317569-5317463,UUCUUAUCAAGAGUGGUGGAGGGACUGGCCCGAUGAAACCCAGCAACCGGUAUUCGGAUGAAUACAACGGUGCUAAUUCCUGCGAUGGAAGCAUUGAUAGAUGAGAG,31,24,32,20,107
642,2,Y09476.1/38002-37885,UUCUUAUCAAGAGAAGCAGAGGGACUGGCCCGACGAAGCUUCAGCAACCGGUGUAAUGGCGAUCAGCCAUGACCAAGGUGCUAAAUCCAGCAAGCUCGAACAGCUUGGAAGAUAAGAA,39,20,32,27,118
643,2,AACY020322622.1/575-479,UACUUAUCAAGAAAGGUGGAGGGAAAAGGCCCUUUGAAACCUUAGCAACCCCAAAUUAGGAAGGUGCUAAAUCCAGAUGUAAAAAUCAAGAUAAGAG,40,19,22,16,97
644,2,CP001124.1/432444-432343,UGCUUAUCUAGAGUGGUGGAGGGAAAGGCCCUGCGAAGCCACAGCAACCGGCCCAGAAAUGGGCGACAGGUGCUAAAUCCUGCCGAAAGGCGAAGAUGAGAA,31,14,34,23,102
645,2,CP001110.1/965443-965552,CUAUCAUCCAGAAAGGUGGAGGGACUGGCCCUGAGAAGCCUUGGCAACCGUCAUUGCUCUAAUGAGCGGUGCCAAUUCCAUCCCGGCAUAAAGACCGGGAAUGAUGAUGG,29,22,32,27,110
646,2,CP001022.1/2977132-2977031,UUCUUAUCCAGAGAGGUGGAGGGACUGGCCCUUUGAAGCCUCAGCAACAGGUCGAAAGACACUGUGCUAAUUCCUGCGGGUGUUGUACCCGAUCGAUAAGCU,24,25,29,24,102
647,2,ABDT01000037.2/9251-9359,UACUUAUCAAGAGUGGUGGAGGGACUGGCCCUGUGAAACCCGGCAACCAAUAUUUAUUAGAUGAUAUGAGGUGCCAAAUCCUGCAGUUUUUAUGACUGGUAGAUAAGGU,31,31,29,18,109
648,2,CP001022.1/449125-449227,CUCUUAUCGUGAGUUGGCAGAGGGAAUUGGCCCGAAGACGCCGCAGCAACCGACCAUCCGGCACGGUGCUACAUCCAACAGACAUUCGUCUGAGAGAUAAGAG,28,18,29,28,103
649,2,CP001022.1/2949654-2949549,UUCUUAUCAAGAGAAGUCGAGGGAACGGCCCGAAGACACUUCAGCAACCCCGCGCGUAGCGGAAGGUGCUACUUCCUAAAAGGAAUUUUUCCUUUGAAGAUAAGAG,32,23,27,24,106
650,2,CP000853.1/102837-102950,CUUUUAUCGAGAGAGGUGGAGGGAAAGGCCCUAUGAAACCUCGGCAACCUGCAAACGUAUUUGUUUGAAAAGGUGCCAAUUCCUACUCUAAGUGAACUUAGAGAGAGAUAAGAG,37,27,30,20,114
651,2,AL009126.3/1426876-1426976,UUCUUAUCAAGAGCAGGCAGAGGGACGAGCCCGAUGAAGCCCGGCAACCGACUUAUAAAGCACGGUGCUAAUUCUUGCAGCUAGCGGCUGAGAGAUAAGAU,30,19,29,23,101
652,2,CP000875.1/2997482-2997580,CUCUCAUCGAGAUGGGCAGAGGGACUGGCCCGACGAAGCCCGGCAACCCCAUUAUUUGGAAGGUGCCAAAUCCUGCAGGUUCGGCCUGAUAGAUGAGUU,23,20,30,26,99
653,2,CP001022.1/2505940-2506043,UACUUAUCGAGAGCGACCGAGGGAUUAGGCCCAACGACGUCCGGCAACCACCUUUAAGGAACGGUGCCACAUCCUACAGAAUGUUUCAUUCUGAGAGAUAAGUU,30,23,25,26,104
654,2,AL009126.3/3999166-3999272,UCCUUAUCAAGAGAGGUGGAGGGACUGGCCCUGCGAUACCCGGCAACCGCUGUUUAACAGAAUGGUGCUAAAUCCUUUAGAGCAAUGAUUGCUCUUGAAGAUAAGGU,29,27,29,22,107
655,2,CP000875.1/1061086-1061193,AACUCAUCCAGAGGGGUGGAGGGAUCGGCCCUAUGAAACCCCGGCAACCGCAGGCAGCAAUGCUUGGACUGGUGCUAAGUCCGACAGAAUCAUUCUGGAAGAUGAGGG,29,18,35,26,108
656,2,AE008691.1/1750369-1750270,CUCUUAUCAAGAGAGGUGGAGGGACUGGCCCGAUGAAACCCGGCAACCAGCCUUAGGGCAUGGUGCCAAUUCCUGCAGCGGUUUCGCUGAAAGAUGAGAG,25,19,32,24,100
657,2,ABDT01000031.2/132-23,UUUUUAUCAAGAAAGACAGAGGGACUGGCCCUAUGAAGUCUAGCAACCUGAAUUAUUAAUUAAUUUAAGGUGCUAAUUCCAGCAGAUAUUUUAUAUCUGAAAGAUAAGAA,41,34,20,15,110
658,2,AL009126.3/3129333-3129195,CUCUUAUCCCGAGCUGGCGGAGGGACAGGCCCUAUGAAGCCCAGCAACCGGUUUCUCUGUUAUUUAUUAUGUUCAACUGAGUGAGACAACCAAGGUGCUAACCUGUUGCAAGGUUGUAUGAUUCCUUGAGCGAUAAGAG,34,38,36,31,139
659,2,AP008955.1/3935954-3935848,UUCUUAUCCAGAGAGGUGGAGGGUCUGGCCCGAUGAAGCCCGGCAACCGUUGCAUAUUGCAACAAGGUGCCAAUUCCUGCGAGACGUUUCGUCUCGAAAGAUAAGAA,28,24,30,25,107
660,2,ACML01000054.1/24739-24633,CUCUUAUCAAGAGAGGUGGAGGGAUCGGCCCUAUGAAACCUCGGCAACCCCUAUUUUAUUUAGGAAGGUGCCAAUUCCUUUAGAAUUUAAAUUCUAAAAGAUAAGAA,35,30,22,20,107
661,2,AP009049.1/1342262-1342152,UUCUUAUCCAGAGUGGCGAAGGGACUGGCCCUAUGAUGCCCAGCAACCUGAAUGAUUUUUCAUCAUUCAACGGUGCUAAUUCCAGCAGGUAUAAAACCUGAAAGAUGAGAA,34,28,25,24,111
662,2,ACDK01000006.1/20557-20663,GUCUUAUCAAGAGUGGUGGAGGGACUGGCCCUAUGAAGCCCAGCAACCAAGAAUUUUAAUCGAUUCUUAAGGUGCUAAAUCCUGCAGGAAAUCCUGGUAGAUAAGAG,33,26,28,20,107
663,2,CP000924.1/750630-750734,CUCUUAUCGAGAGUGGUGGAGGGACUGGCCCGAUGAAACCCGGCAACCGGCAUUUUAUAUGCGUCUUGGUGCCAAUUCCAGCAGCGUUUCGCUGAAAGAUGAGAG,24,25,32,24,105
664,2,ACMX01000011.1/17693-17806,CUCUUAUCCAGAGAGGCGGAGGGACUGGCCCUAUGAUGCCCGGCAACCGAGCUUAUGAAUUAUAAGCUAAGGUGCUAAUUCCUGCAAAACGAUUUUCGUUUUGGAAGAUAAGAG,32,29,30,23,114
665,2,CP000448.1/1653165-1653067,CUCUUAUCCAGAGUGGUGGAGGGACUGGCCCGAUGAAACCCGGCAACCGCCUGAAAGGUAUGGUGCCAAAUCCUGCAGGAGGAUCCUGGCAGAUGAGAG,25,17,33,24,99
666,2,ABEZ02000013.1/193212-193110,ACCUUAUCAAGAGAGGCUGAGGGACAGGCCCUAUGAAGCCCAGCAACCACUUGGAAAAGGAAGGUGCUAAAUCCUGCUAGAGAGAAUUCUAGAAAGAUGAGGU,36,18,29,20,103
667,2,CP000764.1/3033666-3033778,UUCUUAUCUAGAGAGGUAGAGGGACUGGCCCUAUGACACCUCAGCAACCAUUAACAAACUUGUUAAUAAGGUGCUAAUUCCAGCAAAUUAUCAAAUAAUUUGAGAGAUAAGAA,42,30,21,20,113
668,2,CP001078.1/2736261-2736158,UUCUUAUCGAGAGUGGUGGAGGGACUGGCCCUAUGAAACCCGGCAACCAAUAUAUUAUAUAUAUAAGGUGCUAAAUCCUGCAGUAAGUAACUGAUAGAUAAGGG,34,27,26,17,104
669,2,CP000923.1/995529-995640,CUCUUAUCAAGAGUGGUGGAGGGACUGGCCCGAUGAAACCCGGCAACCGGCAUUUAUAUGCGUCUGGUGCCAAAUCCUGCAGGUUAGAUUAUUCUAACCUGAGAGAUGAGAG,29,27,32,24,112
670,2,ACMW01000090.1/86610-86722,UUCUUAUCUAGAGAGGUAGAGGGACUGGCCCUAUGACACCUCAGCAACCAUUAACACGUUCGUUAAUAAGGUGCUAAUUCCAGCAAAUUGUGAAAAGAUUUGACAGAUAAGAA,39,29,24,21,113
671,2,ABWP01000002.1/3034-3135,ACCUUAUCAAGAGAGGCUGAGGGACAGGCCCGAUGAAGCCCGGCAACCACCCAUAAGGGAAAAGGUGCUAAUUCCUACAGGAUUUAUCCUGAAAGAUGAGGU,33,18,28,23,102
672,2,ACMV01000059.1/168768-168876,AGCUUAUCAAGAGAAGCGGAGGGAACUGGCCCUACGAAGCUCAGCAACCUGCUUAUAAGAAGCAAGGUGCUAAGUCCAGCAAAAUGGCAUCCAUUUUGAAAGAUAAGGU,38,21,28,22,109
673,2,CP000813.1/1116941-1116823,UUCUUAUCAAGAGAGGCAGAGGGACUGGCCCUGUGAAGCCUCAGCAACCGGUGUAGUAGAAAUCUAUUUUCUAUGACCAAGGUGCUAAAUCCAGCAAGCAACUGCUUGGAAGAUAAGAA,38,27,30,24,119
674,2,CP000727.1/1728869-1728972,UACUUAUCAAGAGAGGCGGAGGGACUGGCCCUGUGAAGCCCAGCAACCUAUAUGAAAGUGAAUAUAAGGUGCUAAAUCCUGCAGCAUAAGCUGAGAGAUGAGGA,35,20,30,19,104
675,2,ACMP01000006.1/18282-18169,CUCUUAUCAAGAGUGGCGGAGGGACUGGCCCGAUGAUGCCCGGCAACCGAGCUUAGAACUUAUAAGCUAAGGUGCUAAUUCCUGCAGAACGAUUUUCGUUUUGGAAGAUAAGAG,31,28,32,23,114
676,2,CP001615.1/763985-763879,CUCUUAUCAAGAGAGGCUGAGGGACUGGCCCUAUGACGCCCAGCAACCGCGGAGCAAUCCGAAAUGGUGCUAAUUCCAGCAAGGUGAGAAACCUUGACAGAUGAGAG,32,18,31,26,107
677,2,ABRX01000004.1/223227-223118,CUCUUAUCAAGAGAGGCAGAGGGACUGGCCCUAUGACGCCCGGCAACCGUUUCUACUAUAGAAAUUGGUGCUAAUUCCUGCAAAGCUGUUACAGCUUUGACAGAUAAGAG,31,27,27,25,110
678,2,CP001034.1/2889251-2889136,UCCUUAUCAAGAGUGGUGGAGGGACUGGCCCUAUGAAGCCCGGCAACCGGCAGCAGCUAAUCCUGCUGUAAAGGUGCCAAAUCCUGCAGAAGUGUAUUACUUCUGACAGAUAAGGA,32,25,32,27,116
679,2,CP001056.1/749334-749442,AUCUUAUCAAGAGUGGUGGAGGGACUGGCCCUAUGAAACCCGGCAACCAAAUGAUUACUUAUCAUUUAUGGUGCUAAAUCCUGCAACUUAUGGAGUUGAUAGAUGAGAG,33,30,27,19,109
680,2,ACJM01000005.1/12852-12955,CUCUUAUCAAGAGAAGGUGGAGGGACUGGCCCGAUGAAACCCGGCAACCGGACACGCGUCGCGGUGCUAAUUCCAGCAGGGAGUGAAACCCUGAUAGAUAAGAG,30,16,33,25,104
681,2,ABDP01000004.1/161395-161294,CUCUUAUCAAGAGAGGUGGAGGGAAAAGGGCCCUAUGAAACCCGGCAACCAGUGAUAUUCACUAAGGUGCCAAUUCCUGCAGUAUUAUCUGCAAGAUAAGAG,33,22,26,21,102
682,2,CP000922.1/2445298-2445193,CUCUUAUCAAGAGAGGUGGAGGGAUGUGCCCGAUGAAACCCGGCAACCGUCAGCGCUGCUGAAAUGGUGCCAAUUCACACAAAGCGUUUGCUUUGAGAGAUAAGAG,30,22,31,23,106
683,2,CP001393.1/1215384-1215507,UUCUUAUCAAGAGUGGCGGAGGGACUGGCCCAAUGAAGCCCGGCAACCGGAAAAAGGUAGGGGUGCCCUUUUUCUUGGUGCCAAUUCCAGCAGGUAUUUUUUUAAAAUACCUGGCAGAUAAGAA,34,31,34,25,124
684,2,CP000930.2/1734610-1734715,CUCUUAUCAAGAGUUGGUGGAGGGACUGGCCCGAUGAAGCCCGGCAACCAGCAGGUUUUUCCUGCAUGGUGCCAAUUCCUGCAGGGGAAACCCUGAAAGAUAAGAC,27,22,31,26,106
685,2,CP000679.1/1731346-1731467,UUCUUAUCAAGAGUGGUGGAGGGACUGGCCCAAUGAAGCCCGGCAACCGGAAAAAGGUAUGGGUGCCCUUUUUCUUGGUGCCAAUUCCAGCAGGUAUUUUUAAAAUACCUGGCAGAUAAGAA,34,31,33,24,122
686,2,ABDA02000002.1/27359-27468,CUCUUAUCUAGAGAGGUGGAGGGACUGUGCCCUGUGAAACCCAGCAACCAUCAAUUUUUACAUUGAAAUGGUGCUAAUUCCUGCAAAGCAAAUGCUUUGAGAGAUGAGAG,33,29,27,21,110
687,2,ACLX01000083.1/11419-11532,UUCUUAUCUAGAGAGGUAGAGGGACUGGCCCUUUGACGCCUCAGCAACCAUUAACAUUCAUUCGUUAAUAAGGUGCUAAUUCCAGCAAAUUGUGAAAGAUUUGACAGAUGAGAA,36,32,25,21,114
688,2,BAAZ01010499.1/873-972,CUCUUAUCAAGAGAGGUGGAGGGAUAGGGCCCGAUGAAACCCGGCAACCUGUAUUUUCAAGGUGCCAAUUCCUGUAGAUAGAUUAUCUACAAGAUAAGAG,31,24,26,19,100
689,2,ABKW02000003.1/317079-316978,CUCUUAUCAAGAGAGGUGGAGGGAAAAGGGCCCUAUGAAACCCGGCAACCAGUGAUAUUCACUAAGGUGCCAAUUCCUGCAGUGCUAUCUGCAAGAUAAGAG,32,21,27,22,102
690,2,CP001348.1/101863-101963,UCCUUAUCAAGAGAGGUGGAGGGAAUGGGCCCGAUGAAACCCGGCAACCAGCAUUUUUUGCAUGGUGCCAAUUCCUGCAGGCUAUGCCUGGAAGAUGAGGG,25,22,32,22,101
691,2,ABVH01000010.1/37660-37766,CGCUUAUCAAGAGCGAGGGAGGGACUGGCCCGAUGAACUCCGGCAACCUGCUUCAUUUAGCAAGGUGCCAAUUCCAGCAAAAUGGAUUCCAUUUUGGAAGAUAAGAC,31,23,28,25,107
692,2,CP000560.1/1082099-1081978,UUCUUAUCAAGAGAAGCCGAGGGACUGGCCCGACGACGCUUCAGCAACCGGUGUAGUGGUUUACCCAAACCAUGACCAAGGUGCUAAAUCCAGCAAGCUAAAAACAGCUUGGAAGAUAAGAA,41,22,30,29,122
693,2,CP000721.1/1647224-1647332,AACUUAUCAAGAGUGGUGGAGGGACUGGCCCGAAGAAACCCAGCAACCGGUAAAUUUUAUAGAAUUACUUGGUGCUAAAUCCUGCAGCGUAAGAGCUGGUAGAUAAGGU,35,25,30,19,109
694,2,ACMR01000082.1/17402-17507,UUCUUAUAAAGAGAGGUGGAGGGACUGGCCCUUUGAAACCUCAGCAACCUAAUAUUACAUAAAGGUGCUAAAUCCUGUAGGAUCUAAAAGUCCUAAAAGAUAAGAA,40,26,22,18,106
695,2,ACLP01000020.1/71764-71658,CUCUUAUCAAGAGUGGUGGAGGGAUGUGCCCUACGAAACCCAGCAACCGUCAUUGUAUGACAUGGUGCUAAUUCACAUAAAGUUAAUCAUACUUUAGAAGAUGAGAG,34,28,25,20,107
696,2,ACLW01000047.1/255928-256033,UUCUUAUUAAGAGAGGUGGAGGGACUGGCCCUUCGAAGCCUCAGCAACCUUAUGUGAUAUAAAGGUGCUAAAUCCUGUAGGAUCUAAAAGUCCUAAUAGAUAAGAA,35,28,25,18,106
697,2,ACNG01000055.1/75164-75269,UUCUUAUUAAGAGAGGUGGAGGGACUGGCCCUUCGAAGCCUCAGCAACCUAAUGUGAUAUAAAGGUGCUAAAUCCUGUAGGAUAUAAAAGUCCUAAUAGAUAAGAA,37,27,25,17,106
698,2,AP009484.1/63878-63783,UGCUUAUCCAGAGUGGUGGAGGGACUGGCCCUAUGAAACCCGGCAACCUAUUAAUUUAGGUGCUAAUUCCAGCAGGUAUAUCCUGAAAGAUAAGGU,27,25,25,19,96
699,2,ABFU01000060.1/128844-128955,CUCUUAUCGAGAGCGGCGGAGGGAAUAGGCCCUGUGAAGCCCGGCAACCAUCAAGCGAAUUUUGCUUGAAAAGGUGCUAAUUCCUACAGGUAAUCUACCUGGAAGAUAAGAG,33,24,31,24,112
700,2,AAML04000010.1/122381-122487,AUCUUAUCAAGAGUGGCAGAGGGACUGGCCCUGUGAAGCCCGGCAACCAGUAUAUUUAAUUAUACAUUGGUGCUAAAUCCUGCAGCAUUUAUGCUGAAAGAUGAGUA,32,29,26,20,107
701,2,ABFD02000009.1/97533-97428,UUCUUAUCCAGAGUGGUGAAGGGACUGGCCCUAUGAAACCCAGCAACCAGUAUAUUUUUAUAUACAUUGGUGCUAAAUCCUGCAGUAUUAUACUGAAAGAUGAGUC,32,32,22,20,106
702,2,AARM02000086.1/6918-7038,CUCUUAUCGAGAGCGGCAGAGGGACUGGCCCGAUGAAGCCCGGCAACCUAACUUUAUUUAAGCGUAAAGUGAAGGUGCUAAUUCCAGCAAAAAUGGUGUAUUCCGUUUUGAUAGAUAAGAG,36,30,32,23,121
703,2,ABSQ01002824.1/631-738,GCCUUAUCAAGAGCGGUGGAGGGAUAGGCCCUAUGAAACCCGGCAACCAUAGUGUGAAUACACGUUUGGUGCUAAAUCCUACAGAAUAUUUAUUCUGAAAGAUGAGGA,34,26,28,20,108
704,2,ACFR01000002.1/115417-115315,CUCUUAUCGAGAGAGGUGGAGGGAUGUGCCCUAUGAAGCCCGGCAACCGUCUGAUAUAGAAAUGGUGCCAAUUCACAUAAAGUUCAACUUUAGAAGAUGAGAG,32,24,28,19,103
705,2,AM295250.1/465274-465380,CUCUUAUCAAGAGAGGUGGAGGGAUGUGCCCUGCGAAACCCGGCAACCGUCUUUAUAUAGAAAUGGUGCCAAUUCACAAAAAGUUGAACUGCUUUUGAAGAUGAGAG,33,26,28,20,107
706,2,AARL02000014.1/678-559,CUCUUAUCGAGAGCGGCAGAGGGACUGGCCCGAUGAAGCCCGGCAACCUAACUUUAUGUAAGCGUAAAGUGAAGGUGCUAAUUCCAGCAAAAUGGUGUAUUCCGUUUUGGUAGAUAAGAG,34,29,34,23,120
707,2,ABKL02000024.1/81090-81192,AUCUUAUCCAGAGAGGUGGAGGGACUGGCCCUAUGAAACCCGGCAACCAGUAUAUUUAUAUACAAUGGUGCUAAAUCCUGCGGCGAAAGCUGAGAGAUGAGUA,32,23,28,20,103
708,2,ACND01000092.1/77021-76920,UUCUUAUCACGAGAGGUGGAGGGACUGGCCCUAUGAUACCUCGGCAGCGGAUUCGUUAGGAAUACUGUGCCAAUUCCAGCAAGGUAACUUGAAAGAUAAGAA,30,24,28,20,102
709,2,ACMS01000020.1/866-971,CUCUUAUCCAGAGAGGUGGAGGGACUGGCCCUACGAUACCUCAGCAACGGGUUUUUUAAUACCGUGCUAAUUCCAGCAAGCUUAAAGUAAGCUUGGAAGAUGAGAA,31,26,27,22,106
710,2,ACMM01000043.1/11026-11131,UACUUAUCCAGAGAGGUAGAGGGACUGGCCCUAUGACACCUCAGCAGCGGGUUCUGUAGUAGGAACACCGUGCUAAUUCCAGCAAGCAAGUCUUGAAAGAUAAGUG,31,23,29,23,106
711,2,ACLY01000071.1/41239-41095,CUCUUAUCAAGAGCAGGUGGAGGGAUUUGGCCCGAUGAAGCCCAGCAACCGACCGUAAUACCAUUGUGAAAUGGGGCGUAUAUUUACGACGCCAAAAGGCACGGUGCUAAUUCCAGCAGAAAGUAUACUUUCUGGUAGAUAAGAG,44,32,39,30,145
712,2,CP000817.1/560536-560639,CUCUUAUGAAGAGCGGCGGAGGGAAGUGCCCUAUGAAGCCCGGCAACCAUCACAUAGUGAAAAGGUGCCAAAUCACCCAAAGAUUUUUCUUUGAAAGAUGAGAG,34,21,27,22,104
713,2,ACMT01000176.1/7164-7023,CUCUUAUCAAGAGCAGGUGGAGGGAUUUGGCCCGAUGAAGCCCAGCAACCGACCGUAAUACCAUUGUGAAAUGGGGCGUUUAUUUACGCCAAAAGGCACGGUGCUAAUUCCAGCAGAAAGUUUACUUUCUGGCAGAUAAGAG,41,33,38,30,142
714,2,ACNK01000182.1/46147-46039,UUCUUAUCAAGAGAGAUGGAGGGACUGGCCCGAUGAAAUCUCAGCAACAGGCUAUAUCAAAGUACUGUGCUAACUCCAGCGAACGCAAUAGGCGUUUGAAAGAUGAGGA,36,23,29,21,109
715,2,CP000148.1/765280-765385,UUCUUAUCACGAGCGACCGAGGGACUGGCCCUAUGACGUCGCGGCAACCCCCCGCAAGGGGACGGUGCCAAAUCCUGCGGAACGGCAACGUUCCGGGAGAUAAGGA,25,15,34,32,106
716,2,ACME01000005.1/38827-38723,AUUGUAUCAAGAGAGGUGGAGGGACUGGCCCUUUGAAACCUCGGCAACAGGUUCAUUUUGAAUACUGUGCCACUUCCUGCAAGCUUUAUGCUUGAAAGAUAGAAU,29,30,26,20,105
717,2,ABMW01084009.1/100-6,CAUUUAUCAAGAGUGGCAGAGGGUCAGGCCCUGUGAAGCCCAGCAACCUACAUUUGUAAGGUGCUAAAUCCUGCGGUAUAACCGAAAGAUAAGUU,29,22,24,20,95
718,2,ABGD02000008.1/40601-40696,ACCUUAUAAAGAGCGGCGGAGGGACUGGCCCUGUGAAGCCCGGCAACCUGCAUAUUGCAAGGUGCCAAAUCCAGCGGUAUGACCGAGAGAUGAGGA,27,15,31,23,96
719,2,CP001099.1/664814-664922,CUAUCAUCCAGAAAGGCGGAGGGACUGGCCCUGCGAAGCCUUGGCAACCUUCAUAUCACCUAUGAGAGGUGCCAAAUCCAUCCCGGAGGAAUUCCGGGAAAGAUGAUGU,30,21,30,28,109
720,2,ACMJ01000013.1/79549-79437,CCUUUAUCAAGAGAGGCAGAGGGACCGGCCCUUUGAAGCCCAGCAACCUCAGUUUAUAAGAACCGAAUAGGUGCUAAUUCCUGCAAAAUGCAUUGCAUUUUGGAAGAUAAAAC,37,26,25,25,113
721,2,CP001337.1/4323854-4323960,UGCUCAUCGAGAUGGGCUGAGGGACUGGCCCGAUGACGCCCGGCAACCCCCAACAGGGAAGGUGCCAAAUCCAGCGGCAAUGAAGAACAUUGGCCGAAAGAUGAGAG,31,13,35,28,107
722,2,ACGB01000028.1/29135-29031,UGCUCAUCAAGAGUGGCGGAGGGAAUGGCCCUAUGAACCCACAGCAACCAUGGCCUCAUGGCCAACGGUGCUAAAUCCUGCAAUGUAAUGAUUGUAAGAUGAGAG,31,21,29,24,105
723,2,ACMZ01000099.1/4914-5019,UUCUUAUCAAGAGCAGGUGGAGGGACGAGCCCGACGAAACCCGGCAACCGAUCUACAAUCGUAGACACGGUGCUAAUUCUCGCAGCAUUAUGCUGACAGAUAAGGA,32,20,28,26,106
724,2,AASE01000018.1/36798-36683,CUAUCAUCGAGAAAGGUGGAGGGACUGGCCCUGAGAAACCUUGGCAACCGUCAAUUCAUAAUGAAGUAUGAACGGUGCCAAUUCCAUCCCGGUAUAAAGGUCGGGAAAGAUGAUGG,36,24,33,23,116
725,2,ACOK01000109.1/19481-19381,ACCUUAUCAAGAGCGGCGGAGGAAACAGGUCCUGUGAAGCCCGGCAACCUGACUAUUUCGGUCAAGGUGCUAAUUCCUGCGGUUUAUCCGGAAGAUGAGGA,26,22,30,23,101
726,2,ACJB01000070.1/16733-16623,CUCUUAUCCUGAGUGGUGGAGGGACAUGGACCCAACGAAACCCAGCAACCUCUUUUUAGUAAAGAAAGGUGCCAAACCGUUUGCAGACAUAUAUCGUCUGAACGAUAAGAG,35,25,26,25,111
727,2,AP008971.1/1262692-1262597,AUCUUAUUAAGAGUAGUGGAGGGAAUGGGCCCUAUGAAACUCAGCAACCUAUUAAAUUAGGUGCUAAAUCCCACAGGAAAUCCUGAAAGAUAAGUU,35,24,21,16,96
728,2,ACNI01000057.1/7157-7272,UACUUAUCCAGAGAGGUGGAGGGAACGGCCCUAAGAAACCUCAGCAACCCCUAUGCAAUUUUAUAGGAAGGUGCUAAUUCCGCAGAGAACACGAUGUGUUUUUUGAAAGAUAAGAG,38,27,29,22,116
729,2,CP000975.1/1171211-1171325,CUCUUAUCGAGAGCGGUGGAGGGACUGGCCCUGUGAAACCGCGGCAACCGGAAAAGAGAGUCUUUUCGUCAAGGUGCCAAUCCCAGCCCUUUGAAGCGUAAGGGAAGGAUGAGAG,30,21,38,26,115
730,2,ACLA01000020.1/206857-206751,ACCUCAUCCAGAGCAGCGGAGGGAAUGGCCCGAUGAAGCUGCGGCAACCAUGGCAAUGUGUGCCAACGGUGCCAAUUCCUAUAGGCGGAGCGCCUAUGAGAUGAGAG,28,17,35,27,107
731,2,ACLT01000057.1/24072-24187,UACUUAUCCAGAGAGGUGGAGGGAACGGCCCUAAGAAACCUCAGCAACCCCUAUGCAAUUUUAUAGGAAGGUGCUAAUUCCGCAGAGGACACGAUGUGUUUUUUGAAAGAUAAGAG,37,27,30,22,116
732,2,CP000860.1/973047-972931,CUCUUAUCGAGAGUGGCGGAGGGACUGGCCCGAUGAAGCCCGGCAACCAGUCGGUGGCGGUGGUCACCGGCCAGGUGCUAAUUCCUGCGGGAGAUCGAUUCUUCUGGGAGAUAAGAG,23,23,43,28,117
733,2,ACMD01000102.1/19238-19132,UUCUUAUCAAGAGAGAUGGAGGGACUGGCCCGGUGAAAUCUCAGCAACAGGCUAAAAAAGCACUGUGCUAAUUCCAGCAAACGUAAAAGGCGUUUGGAAGAUGAAGG,37,21,30,19,107
734,2,ACMU01000050.1/34307-34422,UACUUAUCCAGAGAGGUAGAGGGAACGGCCCUUUGAAACCUCAGCAACCCCUAUGUAAUUACAUAGGAAGGUGCUAAUUCCGCAGAGGACACUAUGUGUCUUUUGAAAGAUAAGGG,36,28,29,23,116
735,2,ACEC01000115.1/2240-2146,GUCUUAUCAAGAGUGGUGGAGGUAACAGGACCUGUGAAGCCCGGCAACCUUUUGAGUAAGGUGCCAAAUCCUGCGGCUAUGCCGAAAGAUGAGAA,27,20,29,19,95
736,2,CP001364.1/4661646-4661757,CACUCAUCCAGAGCGGUGGAGGGACCGGCCCGUUGAAACCGCAGCAACCCUCGUAUGCGUCGCCGCAUACGAACGGUGCUAAGUCCGGCAGAGGUGUUCUGGAAGAUGAGCG,25,18,37,32,112
737,2,CP001145.1/871363-871477,UUCUUAUCCAGAGCGGUGGAGGGAAAGGCCCGAAGAAGCCCGGCAACCAGCGAGGGAGAAAACCGAGCAUGGUGCCAACUCCUUCUGCACCAAGUCUGGUGCAGGAAGAUAAGAA,35,16,36,28,115
738,2,CP000492.1/2010009-2009901,CUGUCAUCGAGAAAGGUGGAGGGACUGGCCCUGAGAAACCUUGGCAACCGUCAUUGCAAUAUGAUUGGUGCCAAUUCCAUCCCGGAUUACUGGCCGGGAGAGAUGAUGG,27,24,34,24,109
739,2,AAFX01122557.1/25-152,UGCUCAUCCAGAGAGGUGGAGGGACCGGCCCUGAGAAACCUCGGCAACCGCGAAGCGCAGUCGCUGGUGCCAAAUCCGGCAGAAGUUCUCCGGCAGGGUGGCCGGGAGACAUUUCUGGAAGAUGAGGA,30,19,46,33,128
740,2,CT573074.1/54619-54740,AUCUUAUCCGGAGUGGCAGAGGGACUGGCCCUGUGAAGCCACAGCAACCGGCCUGUUCAGAUUACGUCUGAACAUGGUGCAGGUGCUAAUUCCUGUCUCAAGUUUUUGGGAAAAGAUAAGAU,31,31,34,26,122
741,2,ABCM01000001.1/92975-92873,UACUUAUCCAGAAAGACUGAGGGAAAGGCCCUGUGAUGUCUUAGCAACCUGUUGAUUAAUAAGGUGCUAAUUCCUGUCCGCAACGUAGCGGAGAAGAUAAGUG,31,26,27,19,103
742,2,AM263198.1/870267-870363,AUCUUAUCAAGAAAGGUGGAGGGUUCUGGCCCGAUGAAGCCUUGGCAACCGGAUUUUCACGGUGCCAAAUCCAGCAGUUAACACUGACAGAUAAGGC,28,21,26,22,97
743,2,ACKT01000016.1/194512-194407,ACCUCAUCCAGAGCAGUGGAGGGAAUGGCCCGAUGAAGCUGCGGCAACCAUGACGACUGGGUCAACGGUGCCAAUUCCUUUAGGCGGACUGCCUAUGAGAUGAGAG,27,19,34,26,106
744,2,CP001100.1/1493806-1493922,CUGUCAUCAAGAAAGGUGGAGGGAAAGGCCCUGCGAAACCUUGGCAACCGCUCAAAUAAAAAUGUGAGUUGGUGCUAAUUCCUACCCGGUGUAAACUACCAGCGGGAUAGAUGACGG,36,23,33,25,117
745,2,CP000239.1/1201745-1201635,UCUUUAUCCAGAGCAGACUGAGGGAUCAGGCCCAACGAAGCUGCGGCAACCGGCGGAAGCCUCCGCUACGGUGCCAACUCCUGCGGUUAGUCAGUAACCGAAAGAUAAAGG,30,18,32,31,111
746,2,ACIH01000230.1/3738-3609,AUCUUAUCAAGAGCAGGUGGAGGGACUAGCCCGAUGAUACCCGGCAACCGGCGAUGAAACCCAUCGCAGCGGUGCUAAUUCUUGCAGGACCGUCCGUUUCGAACGCUGGACGGCUUCUGAGAGAUGAGAG,32,25,40,33,130
747,2,ACIK02000010.1/282585-282485,AACUCAUCAAGAGUAGUGGAGGGAUAGGCCCUGUGAAGCUACAGCAACCAUUCCAAGAGGAAAAGGUGCUAAUUCCUAUGACAAAUGUCGUUAGAUGGGAG,34,21,28,18,101
748,2,CP000607.1/1332223-1332114,CUAUCAUCGAGAAAGGUGGAGGGACUGGCCCUGAGAAGCCUUGGCAACCGUCAUUCCUGUAAUGAUUGGUGCCAAUUCCAUCCUGGCAGGGACGCCGGGAAAGAUGACGG,27,22,35,26,110
749,2,CP001101.1/884104-884209,CUAUCAUCCAGAAAGGUGGAGGGAGUGGCCCUGAGAAGCCUUGGCAACCGUCAGUAGUGAUUGGUGCCAAUUCCAACCCGGACAAGCAGUGCGGGGAAGAUGAUUG,28,20,35,23,106
750,2,CP000108.1/1604667-1604787,CUAUCAUCCAGAAAGGUGGAGGGACUGGCCCAAAGAAGCCUUGGCAACCGUUAUUGUACUGCAAUAAUAGGUGCCAAUUCCAUCCUUAACAUGGUAACUACCUGUUAAGGAACGAUGAUGG,37,29,29,26,121
751,2,ABIB01000001.1/287097-286995,UCGUUAUCAAGAAAGGCUGAGGGAAUAGACCCGAUGAAGCCUUAGCAACCCUUUACACAUAAAGAAGGUGCUACAUUCUACUGCGCAAGCGGAUAGAUAACAA,37,21,23,22,103
752,2,AAOG01000001.1/142958-142849,AUGUUAUCAAGAAAGGCGGAGGGAUUAGACCCAUUGAAGCCUUAGCAACCCUUUAGUAAUAAAGAAGGUGCUAAAUUCUACUCAAUUAUUCGUAAUUGGAUAGAUAACAA,41,30,22,17,110
753,2,AANC01000003.1/237429-237533,AUGUUAUCAAGAAAGGCGGAGGGAAUAGACCCUAUGAAGCCUUAGCAACCCUUUCUCCCGAAAGAAGGUGCUACAUUCUAUCUGUUUUUGCAGAAUAGAUAACGC,33,27,23,22,105
754,2,ACBZ01000203.1/8528-8629,CUCUUAUUCAGAGUGGUGGAGAUAUUAAGGAUCAGUGAAACCACGGCAACCCCUGACAAAAGGAAGGUGCCAACCUGAGCGAAGAAAUUCGAACAAUAAGAG,38,18,26,20,102
755,2,CP001108.1/778657-778762,CUGUCAUCCAGAAAGGUGGAGGGACUGGCCCUGAGAAGCCUUGGCAACCGUCAUUCGUGAUUGGUGCCAAUUCCAACCCGGAGAGCUGUCCGGGAAAAGAUGAUGG,26,21,34,25,106
756,2,CU207366.1/381646-381752,UCGUUAUCAAGAAAGGUUGAGGGAUUAGACCCUGUGAAACCUUGGCAACCCUCCUGUAAUGGGAGAAGGUGCUACGUUCUACCACGCCAGUCGUGGAUAGAUAACUC,29,26,28,24,107
757,2,ACIN02000013.1/199862-199965,CUCUUAUUCAGAGUGGCGGAGAGUGAAGGCUCUGUGAAGCUACGGCAACCCCUGAAAGAUGGAAGGUGCCAACCUGAGCGAAGUUUUACUUCGAGCAAUAAGAG,30,22,31,21,104
758,2,AARI02000249.1/265-361,AACUUAUCAAGAAAGGUGGAGGGUUCUGGCCCCGUGAACCUUGGCAACCGGAAGUUUCACGGUGCCAAAUCCAGCAGGUAACACUGACAGAUAAGGC,29,18,27,23,97
759,2,ACHB01000100.1/57340-57454,GAUUUAUAAAGAAGUGGCGAGAGACUGGCUCAAUGACCCACUGGCAACCUUCAAAAAACGUUUGAAAAGGUGCCAAUUCCUGUCCAAAGCAAUGUUGCUUUGGAGCAUAUAAAUG,39,28,26,22,115
760,2,ABIL02000006.1/144101-144004,ACCUUAUUUAGAGCGGUGGAGUGAAUAGGCACUAUGAAACCCGGCAACCGGCAAAGGUACGGUGCUAAUACCUACGGGAUUUUUCCGAAUGAUGAGUA,29,23,27,19,98
761,2,CP000096.1/692601-692748,CUAUCAUCGAGAAAGGUGGAGGGACUGGCCCUGAGAAGCCUUGGCAACCGUCAUUGACCGUCAGUGAUUCAAUGGAUUGCAUUGAUUCAUGUAUUGAGGUAAUGAUUGGUGCCAAUUCCAUCCCGGUUGAAGGCCGGGAAAGAUGAAG,39,37,44,28,148
762,2,AAPR01000022.1/22928-22828,GAUUUAUAAAGAAGAGGCGAGAGACAGGCUCCGCGACCCUCGGCAACCUCAACAAAGUGUUGAAAGGUGCUAAUUCCUGCCCGACAAGGGACAUAUAAAUU,34,19,25,23,101
763,2,ABRU01000018.1/11937-11821,CACUCAUCAAGACCGGCUGAGGGAUUAGGCCCUUUGACGCCGGGGCAACCAUCGGGUUUCACCACCCGAAACGGUGCCAACUCCUGCGGGGUCCUUCGGGGUCGCGAGAGAUGAGUG,23,21,38,35,117
764,2,ABVW01000002.1/44661-44766,UAGUUAUCAAGAAAGGUGGAGGGAUUAGACCCUGUGAAGCCUUAGCAACCCUUUGUAUUGUUCAAAGAAGGUGCUACAUUCUAUCUCAUUUGAGAAUAGAUAACCG,33,31,24,18,106
765,2,ACDH01000015.1/29225-29312,AUACCAUCAAGAGAGAUUGAGGGACUGGCCCGUUGAAAUCUCAGCAACCUGCUUUUUAAGUGUGGUGCUAACUCCUGAGAGAUGGAAU,25,23,23,17,88
766,2,AAWS01000061.1/3106-3001,GAUUUAUAAAGAAGCGCUGAGAGAGUAGGCUCGAUGAAGCGCUGGCAACCUGCUACACAGUAAGGUGCUAAGUCCUACCUAAUUUAUUCAUUAGGAAAGAUAAAUC,36,26,25,19,106
767,2,ABED02000029.1/620487-620585,GACUUAUCAAGAGCGGCUGAGGGGACAGGCCCUGUGAAGCCCGACAACCUGCGCGAGAGCGUAAGGUGCCAAAUCCUGCGGGAAACCGGAAGAUAAGAG,29,12,34,24,99
768,2,ABOU02000055.1/96522-96420,CUCUUAUUCAGAGCAGUGGAGAUACAAAGGAUCUAAGAAGCUGCGGCAACCCCACAUUAUAAAGGAAGGUGCCAACCUGAGCGAGUUACUCGAACAAUAAGAG,37,19,25,22,103
769,2,ACEX01000437.1/2744-2885,CGCUCAUCCAGAGGGGCAGAGGGAACGGCCCGUUGAAGCCCCGGCAACCCUCCAGCUGGUCUCGCGUCCUGUAGCGAGGCUCCCAGCUCGGGAAGGUGCCAAUUCCGUCUCGUGGCGAAAUGCGUCCCGAGGAAGAUGAGGA,28,22,48,44,142
770,2,AAXX01000001.1/747308-747200,UUGUUAUCACGAAAGCUGGAGGGAAUAGACCCUAUGAAAGCUUAGCAACCUCUCGCCCUUGCGGAAAGGUGCUACAUUCUAUUCCGAUACUAUCGGAAGCAGAUAACGU,32,27,25,25,109
771,2,ABOX02000046.1/18955-19074,AUCUCAUGAAGAGUGGUUGAGGGACUGGCCCUACGAAACCACGGCAACCGGCUGGGACGCGAUUUCCAGUGCAGGUGCCAAGUCCAGCUCGAGCACCAUUAGCUCGGGGAAAAAUGAGAA,33,20,37,30,120
772,2,CP001275.1/371734-371625,CGCUCAUCUCGAGCGGUGGAGGGAACGGCCCGACGAAACCCGGCAACCAGCGCAGGCCACUGCGCCAGGUGCCAAUGCCGGCGGAGCGGGAAAGCUCCGCACGAUGAGCG,24,9,40,37,110
773,2,ABWO01000038.1/8212-8308,CUCUUAUUCAGAGUGGUGGAGGUAAAAGGAUCUAUGAAGCCACGGCAACCCCGGGAACGGAAGGUGCCAACCUGAGCGAGUAAUCGAACAAUAAGAG,32,16,29,20,97
774,2,ACDD01000058.1/73-160,AUACCAUCCAGAGAAGCGGAGGGACUGGCCCGAUGAUGCUUCAGCAACCUACUGUUAGAGUGUGGUGCUAAUUCCAGACAGAUGGAGA,25,18,26,19,88
775,2,AAVO02000010.1/47842-47944,CUUUUAUUCAGAGUGGUGGAGAUACAAAGGAUCUGAGAAGCCACGGCAACCCCUUUAUGUAUGAGGAAGGUGCCAACCUGAGCGAGACAUCGAACAAUAAGAG,34,21,28,20,103
776,2,AAVL02000036.1/100921-100817,CUCUUAUUAAGAGUUGGCGGAGAUACAAGGAUCUGUGAUGCCACGGCAACCCCCGAUUAUGAUGGAAGGUGCCCACCGGAGCAAUGCAAUAUUGAUCAAUAAGAG,32,23,28,22,105
777,2,ABYX01000149.1/176896-177023,AGCUCAUCCAGAGGGACUGAGGGAACGGCCCGUUGAAGUCCCGGCAACCCUCCUGCCGACCGCGAGGUCACGGUGGGGAAGGUGCCAAUUCCGUCUUGCGGCGAAAUGCGUCGCGAGGAAGAUGAGGA,28,19,46,35,128
778,2,CP001472.1/3934139-3934250,AUUUCAUGAAGAGUGGCUGAGGGACGGGCCCUGUGACGCCACGACAACCGGCUCGAGCAAUUCGGGACAUCGGUGUCAACUCUCUCCUGCGUAACGGCGGGGAACAUGAGAU,26,21,36,29,112
779,2,CT573213.2/7305357-7305472,GGCUCAUCCAGAGGGGCAGAGGGAACGGCCCAGUGAAGCCCCGGCAACCACCCGCAUCCGAUGCGUGGCAGGUGCUAAUUCCGACCCGUGGCAGGUUGCCCCGGGAAAGAUGAGGA,26,14,41,35,116
780,2,ABVR01000040.1/301449-301548,CUCUUAUUCAGAGUGGUGGAGGUACAAAGGACCUGCGAAGCCACGGCAACCCCGGUAAGCCGGAAGGUGCCAACCUGAGCGAGCAAUCGAACAAUAAGAG,31,14,30,25,100
781,2,CP000386.1/1121068-1121189,CCCGCAUCAAGAGCGGUGGAGGGAACUGGCCCAGCGAAGCCGCGGCAACCGGCGGGGGGCCCUUACCCCCGUGAGGUGCCAAUUCCAGCAGGUCUCCCCGAGGGGGGCCUGAAAGAUGUGGG,23,14,47,38,122
782,2,BA000030.3/4858626-4858480,CGCUCAUCCAGAGGGGCAGAGGGAUACGGCCCGAUGAAGCCCCGGCAACCCUCCAGCCGGUCUUGUCACGUUGAUGUGGCGAGGCUCCCGGCUCGGGAAGGUGCCAAAUCCGUCUCACGGCGAAGUGCGUCGUGAGGAAGAUGAGGA,30,23,52,42,147
783,2,CP000885.1/4762158-4762063,CUCUUAUUCAGAGUGACGGAGAGUAAAGACUCAGUGAAGUCACGGCAACCCCCUAUGGGAAGGUGCUAAGUUGAGCGAGCAAUCGAACAAUGAGAG,31,18,28,19,96
784,2,ACEZ01000126.1/65345-65190,AGCUCAUCCAGAGGGGCAGAGGGAAACGGCCCGAUGAAGCCCCGGCAACCCUCCAGUCGGUACUCGUAGGUCACUGGCGACCACUUCGCGAGGCUCCCGACUAGGGAAGGUGCCAAAUCCGUCUCACGGCGAGAUGCGUCGUGAGGAAGAUGAGGA,37,22,52,45,156
785,2,CP000159.1/648790-648906,CAUUCAUCCAGAAGGGUGAAGGGAGCAGGCCCGAUGAAGCCCUGGCAACCGCCGUCGGCACCCCCCGACGGAAAGGUGCCCCAUCCUGCCUCGACUGCUGUCGAGGAAAGAUGAGUG,27,16,37,37,117
786,2,AM420293.1/1589093-1588966,AGCUCAUCCAGAGGGGCAGAGGGAACGGCCCGUUGAAGCCCCGGCAACCAUCUCGGCGUAUCGCGCAUUCCGCGAGGCCGCCGGCGAAAAAGGUGCCAAUUCCGACCCGUCCGCGGGACAGAUGAGGA,29,15,43,41,128
787,2,ACIP02000004.1/237213-237114,CUCUUAUUCAGAGUGGUGGAGAUACAUAGGAUCCGUGAAGCCACGGCAACCCCCAAAGCGGUAGGUGCCAACCUGAGCGAGUAUGUUCGAACAAUAAGAG,30,19,28,23,100
788,2,AAXA02000011.1/106110-106208,CUCUUAUUCAGAGCAGUGGAGGUACAAAGGACCUGUGAAGCUGCGGCAACCCCCGGUUCGGGAAGGUGCCGACCUGAGCGAGUAAUCGAACAAUAAGAG,28,17,31,23,99
789,2,CP000383.1/165474-165365,GAUUUAUAAAGAAGAGGGGAGAGAACGGGCUCUUUGAACCUCUAGCAACCUCCGGGAGCAAAUCCAGAAAGGUGCUAAUUCCUGACCUGAAUAAACAGGGCAUAUAAAUU,39,23,27,21,110
790,2,AARG01000011.1/103271-103357,UAACCAUCGAGAGAAACUGAGGGACUGGCCCUAUGAAGUUUCAGCAACCUGUCAUCAGAUGUGGUGCUAAUUCCAGAUAGAUGGAAG,27,20,23,17,87
791,2,ACET01000016.1/116829-116743,AUACCAUCAAGAGAGAUUGAGGGACAGGCCCGAAGAUAUCUCAGCAACCUACUGAAAUGUGUGGUGCUAACUCCUGUUAGAUGGAAG,28,19,23,17,87
792,2,ACII01000156.1/15700-15599,CUUUUAUUCAGAGUGGUGGAGAUACAAAGGAUCUGCGAAGCCACGGCAACCCCUGUUUGUGUAGGAAGGUGCCAACCUGAGCGAGUGAUCGAACAAUAAGAG,30,22,30,20,102
793,2,ACEW01000347.1/17844-17982,CGCUCAUCCAGAGGGGCAGAGGGACACGGCCCGUUGAAGCCCCGGCAACCCUCCAGUCGGUUCUCGCCAGCGCGAGGCCCCGGCUAGGGAAGGUGCCAAUUCCGUCUCAUGGCGAAGUGCGCCAUGGGGAAGAUGAGGA,28,19,49,43,139
794,2,AAVP02000024.1/12932-13029,CUCUUAUUCAGAGCAGUGGAGAUACAAAGGAUCUGAGAAGCUGCGGCAACCCCUGAACAGGAAGGUGCCAACCUGAGCGAGUCAUCGAACAAUAAGAG,33,16,27,22,98
795,2,ABJH01000081.1/1215-1362,CGCUCAUCCAGAGGGGCAGAGGGAAACGGCCCGUUGAAGCCCCGGCAACCCUCCAGCCGGUCUCGUCGCGCACAGCGCAGCGGGGCUCCCGGCUCGGGAAGGUGCCAAUUCCGUCUCAUGGCGAAACGCGUCAUGAGGAAGAUGAGGA,31,19,51,47,148
796,2,ACEV01000067.1/336881-337014,CGCUCAUCCAGAGGGGCAGAGGGAACGGCCCGACGAAGCCCCGGCAACCGGCGUGCAGCCUGUCAUCCCGCGAUCGCGGGGUAGCUGACGACCACGGUGCCAAUUCCGGCCCGCUUCGGCGGGGCAGAUGAGGA,25,15,49,45,134
797,2,ABWN01000022.1/104834-104735,UGCUUAUUCAGAGUGAUGGAGAUACAUAGGAUCUGUGAAGUCACGGCAACCCCCUUGGCGGAAGGUGCCAACCUGAGCGAAAGUAUUCGAGCAAUAAGUG,29,22,29,20,100
798,2,AANA01000001.1/1389418-1389294,ACGUUAUCACGAAAGGCAGAGGGAUUAGACCCAGUGAAGCUUUGGCAACCUCUCAGAAAUGAGAAAGGUGCUACAUUCUACAAUCUAUUUCGAUAUUUUAUCAAAUAGCUAUUGACAGAUAACAG,44,33,25,23,125
799,2,AAPD01000001.1/936074-936181,AAAUUAUCAAGAAAGGACGAGGGAACAGACCCAUCGACUCCUUAGCAACCCUUAACGCUCGUUAAGAAGGUGCUACAUUCUGCCCAUUUAAUUGGGAUGAGAUGAUAC,36,25,23,24,108
800,2,ABVK02000003.1/176687-176823,CUCUUAUCCAGAGCGGUGGAGGGUACGGCCCUGUGAAACCGCGGCAACCUCCCGCUCCUUCCGUUCCAUGGCCGGAAGCGGGCGGGGCUGGUGCCAACGCCGGCCCGGGCGGGGGAAACGCCCGGGAACGAUAAGAG,24,18,51,44,137
801,2,CP000249.1/5255171-5255287,GGCUCAUCCAGAGGGGCAGAGGGAACGGCCCAGCGAAGCCCCGGCAACCACCCGCAUCCCGUGCGCGGCAGGUGCUAAUUCCGGCCUGGUGGCAGACUGCCCCGGGAAAGAUGAGGA,25,12,42,38,117
802,2,AAYG02000021.1/57727-57823,CUCUUAUUCAGAGCAGUGGAGGUACAAAGGACCUGUGAAGCUGCGGCAACCCCGUCAAGGAAGGUGCCGACCUGAGCGAGCAAUCGAACAAUAAGAG,30,15,29,23,97
803,2,ABJF01000395.1/4781-4624,CGCUCAUCCAGAGGGGCAGAGGGACACGGCCCGUUGAAGCCCCGGCAACCCUCCAGUCGGUUCUCGCGAUCGCCCGCACGGCGACACCAGCGAGGUCCCCGGCUAGGGAAGGUGCCAAUUCCGUCUCAUGGCGAAGUGCGCCAUGGGGAAGAUGAGGA,32,21,54,51,158
804,2,CP000820.1/215210-215091,GGCUCAUCCAGAGGGGCAGAGGGAACGGCCCAGCGAAGCCCCGGCAACCACCGUCGCAUCCAUGCGCGGCAGGUGCUAAUUCCGACCCGGGACGCAGCCGGCUCCCGGGAAAGAUGAGGA,27,11,42,40,120
805,2,ABLU01106369.1/97-6,CAGUUAUUAAGAAAGGCAGAGGGAUUAGACCCGUUGAAGCCUUAGCAACCCUUUAUUCAUAAAGAAGGUGCUACAUUCUACCAAAAUAUUUU,32,26,17,17,92
806,2,ACEU01000265.1/7365-7210,CGCUCAUCCAGAGGGGCAGAGGGAUACGGCCCGUUGAAGCCCCGGCAACCCUCCAGCCAGUCUCCGCGCGGUUCACCGAUACCGCCACCGAAGGCCCUGGCUCGGGAAGGUGCCAAUUCCGUCUCGCGGCGAGAUGCGCCGCGGGGAAGAUGAGGA,30,20,53,53,156
807,2,CP000112.1/2490976-2491083,AACUCAUGAAGAGGACGAGAGGGGUCUGGCCCGAUGACCGUCCGGCAACCUGCCCGCAAGGCAAGGUGCCAAAGCCAGCCACGGUGAGAUGCCGCGGUGCCAUGAGGU,26,13,38,31,108
808,2,ABYC01000290.1/27042-27199,CGCUCAUCCAGAGGGGCAGAGGGACACGGCCCGUUGAAGCCCCGGCAACCCUCCGGUCGGUACUCCCGGCGCGUGUUCCACCCGCGUCCGCGAGGCUCCCGGCUCGGGAAGGUGCCAAUUCCGUCUCGCGGCGAGAUGCGUCGCGAGGAAGAUGAGGA,26,22,56,54,158
809,2,ACES01000173.1/1604-1473,ACCUCAUCCAGAGGGGCAGAGGGAUACGGCCCGACGAAGCCCCGGCAACCACCCGCACGUUCGAUGACGAGCGGCGCGGACAGGUGCCAAUUCCGUCCCCGCCGCAGGGUGCGAUGCGGGGAAAGAUGAGAG,30,13,47,42,132
810,2,AP008226.1/728125-727989,CUCUUAUCCAGAGCGGUGGAGGGUACGGCCCUGUGAAGCCGCGGCAACCUCCCGCCCCUUCCGUUCCAUGGCCGGAUGCGGGCGGGGCUGGUGCCAACGCCGGCCCGGGCGGGGGAAACGCCCGGGGACGAUAAGAG,21,18,53,45,137
811,2,AP008957.1/5227167-5227072,CCACCAUCCAGAGUGGCUGAGAGACCUGGCUCGAUGAUGCCGCAGCAACCCGCUUCGUUUGCGCAGUGUGGGUGCUACCGCCAGGACCGAUGGAGG,18,17,32,29,96
812,2,ABXP01000190.1/1560-1672,GUUUUGUACAGUUUGGGUAACCAGGGAAAGAGCCCGAUGAAACCCGGCAACCUGUCCUUUUAAGGAUAAGGUGCCAAUUCUCUCAGAAGAUUUUUUCUUCUGAAAGAUGAGGG,31,32,29,21,113
813,2,ABYA01000312.1/4381-4534,AGCUCAUCCAGAGGGGCAGAGGGACACGGCCCGAUGAAGCCCCGGCAACCCUCCAGCCGGUUCUCGUGUCGAUCGUUGUGCGCGCACAGCCGAUCGCACCCGCGAGGCUCCCGGCUAGGGAAGGUGCCAAAUCCGUCUCACGGCGAGAUGCGUC,29,22,50,53,154
814,2,CP001638.1/2955292-2955189,UUCUUAUCAAGAGAGGUGGAGGGACUGGCCCAAUGAAGCCCGGCAACCGGUUGUUUCAACAUGAUGCUAAUUCCAGCAGAGCGAAUUGCUCUGAGAGAUAAGAA,31,23,29,21,104
815,2,CP002040.1/5022556-5022415,UGCUCAUCCAGAGGGGUGGAGGGACCGGCCCUGCGAAGCCCCGGCAACCAUUCCAGCAUGUGACACCCGCGAACCCGCGGGACGGCUGGGACAGGUGCCAACUCCGGCCUGGGGACAAGGUGUCCGCCAGGAAAGAUGAGGG,30,16,52,44,142
816,2,CP001700.1/9422701-9422569,CGCUCAUCCAGAGGAGCUGAGGGACCGGCCCUACGACGCUCCGGCAACCAUCCGUUCUGCCACCUCAUCGUGGCACGGCGCGGUGCCAACUCCGGCCCACCCGGCAGCCGCCGAGCCGUGGGAAAGAUGAGGA,25,16,42,50,133
817,2,ADJS01002320.1/1580-1477,UACUCAUCGAGAGCAGCGGAGGGAUUUGGCCCCAUGAUGCUGCAGCAACCAUUCUAUAUAGGGAAAAGGUGCUAAUUCCAUCAGCAUUUGCUGGCAGAUGAGAG,29,24,29,22,104
818,2,CP001825.1/900813-900915,GCCUUAUCAAGAGAGGUGGAGGGAGACGGCCCUGUGAAGCCCGGCAACCAGCGCCCAGGAGCGCCAGGUGCCAAUUCCGGCGAGGUCACUCGCAAGAUAAGGG,25,12,37,29,103
819,2,ACIE02000025.1/96603-96517,AAUCCAUAGAGAGAGAUGGAGGGACAGGCCCUUUGAUAUCUCAGCAACCUGCUUUUAAGUGUGGUGCUAAUUCCUGAUAGAUGGUUU,23,26,23,15,87
820,2,CP003056.1/960835-960734,GCCUUAUCAAGAGAGGCGGAGGGACUUGGCCCGAUGAAACCUCAGCAACCAGCCCAUACGGCACGGUGCUAAAUCCAACAGGUAUACCUGAAAAGAUAAGGA,34,15,27,26,102
821,2,CP002637.1/1789046-1788942,CACUCAUCAAGAGCAGUGGAGGGACUGGCCCUAUGAAACUGCGGCAACCGUUGGCGUAGGCCAAAAAGGUGCCAAUUCCUAUAGGUAUUGCCUAUGAGAUGGGAG,29,21,32,23,105
822,2,ABJG02000470.1/2764-2919,CGCUCAUCCAGAGGGGCAGAGGGAAACGGCCCGUUGAAGCCCCGGCAACCCUCCAGCCAGUCUCCGCGCGGUUCACCGAUACCGCCACCGAAGGCCCUGGCUCGGGAAGGUGCCAAUUCCGUCUCGCGGUGAGAUGCGCCGCGAGGAAGAUGAGGA,32,20,52,52,156
823,2,CP003029.1/2215558-2215432,AGCUCAUCCAGAAGGGUGGAGGGACCAGGCCCUGUGAAGCCCUGGCAACCGCCCCGUUGAUCGUCGGGAGACGACGUGGGGAAAGGUGCCAAUUCCUGCCUCGCACGACCGCGAGGGGAGAUGAGCU,27,18,46,36,127
824,2,CP001814.1/9846218-9846077,UGCUCAUCCAGAGGGGUGGAGGGACCGGCCCUGCGAAGCCCCGGCAACCCUCCCGGUUCAAGACUCGUUUUUCUGACGAGGUCGGCCGGGACAGGUGCCAAUUCCGGUCUGUGACCAGGGUGGUCGCAGACGAAGAUGAGGG,26,25,51,40,142
825,2,CP002157.1/228642-228537,CCGUUAUCAAGAAAGGCGGAGGGACUAGACCCAAUGAAACCUUGGCAACCCUUUACUUUAAAGUAGGUGCUACAUUCUAUUACGCCUAUGGCGUGAAAGAUAACAG,34,25,24,23,106
826,2,ACCR02000003.1/83189-83082,CUCUUAUCUAGAGCGGCAGAGGGACUGGCCCUAUGAAGCCCGGCAACCUAACUUUUUUUAGUGAAGGUGCUAAUUCCAGCAACAUUUCUAAAUGUUGACAGAUAAGAG,31,29,25,23,108
827,2,ACDB02000007.1/188296-188209,UAACCAUCAAGAGAAACUGAGGGACUGGCCCUAGGACGUUUCAGCAACCUGCUUAAAAAGUGUGGUGCUAAUUCCAGAAAGAUGGAUA,30,19,22,17,88
828,2,CP001681.1/4562963-4563072,UGCUUAUAGAGAAAGAUGGAGGGAUUAGACCCUGCGAAGUCUUGGCAACCUGUGCUUACAAGGUGCUACAUUCUACAGGAAAUGCAGCUGUACUUCCUGACAGAUAAGUG,32,28,29,21,110
829,2,CP001699.1/4958750-4958860,UUCUUAUCAAGAAAGGCAGAGGGAAAUGGCCCUGUGAAGCCUUAGCAACCAUCCGGAACCACCAAACCGGAAAGGUGCUACAUCCAGCCCGCAUAGCGGGAAAGAUAAGUC,37,17,28,29,111
830,2,CP001968.1/2913390-2913281,AACUUAUCGAGAGUAGUGGAGGGACAAGGCCCUGUGAAGCUACAGCAGCCGGUUAGCAUUAAAAGCUGAUGUCUGGUGCUAAUUCCGACCCUAUGGAGGAGAGAUAAGUC,32,24,33,21,110
831,2,ABTR02000001.1/1201751-1201854,CUCUUAUCGAGAGAGGCGGAGGGACUGGCCCGAUGAAGCCCGGCAACCUGCCCGUAAGGGCAUGAGGUGCCAACACCAGCGACCGACAGGUCGAGUGAUAAGAG,27,13,36,28,104
832,2,ABJJ02000300.1/30118-29960,CGCUCAUCCAGAGGGGCAGAGGGAUACGGCCCGAUGAAGCCCCGGCAACCCUCCAGUCGGUUCUCGUAGCGAUCGCUGACGAUCGUCUCCGCGAGGCUCCCGACUCGGGAAGGUGCCAAAUCCGUCUCACGGCGAGAUGCGUCGUGAGGAAGAUGAGGA,33,25,53,48,159
833,2,ABWK02000020.1/271385-271488,CUCACAUCCAGAGCGGCGGAGGGACUGGCCCGAUGAAACCGCGGCAACCAUUGACUUCGUCAAAACGGUGCCAAUUCCUUUAGGUCCGGCCUAUAAGAUGAGAG,27,19,29,29,104
834,2,CP001649.1/963759-963659,UACUCAUGUAGAGGAUGCGAGGGAAAUCGGCCCGUCGACCAUCCGGCAACCUGCUUCAGCAGCAAGGUGCCAAUGCCUUCCCGUUACGGGACCCAUGAGAG,24,18,29,30,101
835,2,CP001720.1/3787367-3787476,CUCUUAUCCGGAGUGGUGGAGGGACUGGCCCGAUGAAACCCGGCAACCUUCUGAGAACUAAUCAGAAAGGUGCUAAUUCCUGCAGAGGAUUUUCUUCUGACAGAUAAGAG,30,26,30,24,110
836,2,CP001685.1/832315-832217,AACUUAUCAAGAGUGAUACUAGGGACCGGCCCGUUUUGAGUAUCCAGCAACCUGUAUUAACAAGGUGCUAAUUCCGGCAUGUGAAUGCGAAGAUAAGAA,32,24,24,19,99
837,2,CP001818.1/1579334-1579230,CUCUUAUCAAGAGUGGCGGAGGGACUGGCCCGAUGAAGCCCGGCAACCUGCAGAGCACGUCUCUGCGUGGUGCCAACACCUGCGGCGAAAGCCGAGUGAUAAGAG,25,16,35,29,105
838,2,CP003056.1/3328132-3328032,UUCUUAUCCAGAGAGGUGGAGGGAAAGGCCCUUUGAAGCCUCGGCAACAGGUUGAAAAACACUGUGCCAAUUCCUGCAGACAAUCGUCUGAAAGAUAAGAG,32,21,27,21,101
839,2,CP001778.1/452900-453004,ACUUCAUCAAGAGCGGUCGAGGGAACGGCCCUGCGACACCGCGGCAACCACCCAUCCGGGCAGGUGCCAAAUCCGUCCGGCGUGACCGCGCCGGGAAGAUGAGGC,23,11,35,36,105
840,2,CP001743.1/842385-842265,GCCUUAUCCAGAGCAGCGGACAGGGCAACUGCCCGACGGGAACGGCCCGAUGAAGCUGCGGCAACCUGCCAAAGGCAAGGUGCCAAUUCCGGCCCGGCCUCUGCGCCGGGAAAGAUAAGGG,29,13,41,38,121
841,2,CP001794.1/1767716-1767554,UUAUCAAGAGUUGGCUGAGGGAAUUGGCCCAAUGAAGCCCAGCAACCGACCGUAAUGCUAUCGUGAGAUAGGGCGCACGCCAAGGGCGGCGCCGGAAGCGUCAUGCUUCCGCAGGGCACGGUGCUAAGUCCAACAGAAAGACCGAUGUCUUUCUGAAAGAUAA,45,29,49,40,163
842,2,CP001793.1/5775580-5775452,AUCUUAUCAAGAGCAGGUGGAGGGACUAGCCCUAUGAAACCCGGCAACCGGCGGCAACAUCGCACGGUGCUAAUUCUUGCAGGAGAUACGACGAUUGUAUAAGCCGUUGUAUAGCCUGACAGAUGAGAG,37,26,37,29,129
843,2,CP001736.1/1289540-1289681,UGCUCAUCCAGAGGGACUGAGGGAUACGGCCCGUUGAAGUCCCGGCAACCCUCCCCGUGGAGGCCCCGUCCUGGGGCCGCUCGCGGCGGAACGGUGCCAAAUCCGUCCCACGCCGAGAUCCGGCGCCCGGGGAAGAUGAGGA,25,18,50,49,142
844,2,ACDG02000015.1/15379-15466,AUACCAUCAAGAGAGAUUGAGGGACAGGCCCUAAGAUAUCUCAGCAACCUACUGGAAAAGUGUGGUGCUAACUCCUGUCAGAUGGAAG,29,18,23,18,88
845,2,AAXU02000001.1/3185191-3185093,AGCUUAUCGAGAAAGACUGAGGGAAGGGCCCGACGACGUCUUAGCAACCUGUAACCAAGGUGCUAAUUCCCAUCCCGAAUAUUCGGGAAUAGAUGAGCG,30,19,27,23,99
846,2,CP001631.1/1935400-1935293,GAAUCAUCGAGAGCGGUGUAGGGACGGGCCCUGUGAUACCGCGGCAACCAGUUCGAUACGUCGAACCAGGUGCCAAUGCCCGAGCGAUGGCGGCGGGAGGGACGAUGU,24,16,41,27,108
847,2,CP001738.1/890419-890560,CGCUCAUCCAGAGGGGUGGAGGGACCGGCCCUGUGAAGCCCCGGCAACCCUCCCGGUGCUGACGCUCUCGCGACCUGCGAGGCCGGCCGGGACAGGGUGCCAAUUCCGGCCCGCGACCAAGGUGGCGCGGGACAGAUGAGGA,24,16,54,48,142
848,2,ABJI02000433.1/3689-3816,CGCUCAUCCAGAGGGGCAGAGGGAACGGCCCGUUGAAGCCCCGGCAACCCUCCCGCCGACCGCGAGGUCACGGUGGGGAAGGUGCCAAUUCCGUCUCGUGGCGAAGUGCGUCACGAGGAAGAUGAGGA,27,16,47,38,128
849,2,ABYU02000037.1/4945-4847,CUCUUAUUCAGAGUGAUGGAGAUACAUAGGAUCUGUGAAGUCACGGCAACCCCGCAUGGCGGAAGGUGCCAACCUGAGCGAAUAAUCGAACAAUAAGAG,32,19,27,21,99
850,2,ACDZ02000006.1/93274-93376,UACUUAUCAAGAGUGAGUGAGGGAUAAGGCCCGGUGAACUCCAGCAACCUAAUCAAUUGAUUAAGGUGCUUUCCUUAGCAAAGUUUACUUUGAGCGAUGAGGU,30,29,26,18,103
851,2,CP003056.1/1844232-1844126,AACUUAUCAAGAGAGGGGGAGGGACUGGCCCGAGGAAACCUCAGCAACAGAUUCUUUUUGGGAAUACUGUGCUAAUUCCAGCAAGCGUCAAGCUUGGAAGAUAAGUU,33,24,30,20,107
852,2,ACBY02000020.1/258141-258043,AACUUAUCAAGAGUGGCAGAGGGGACAGGCCCUGUGAAGCCCGACAACCUACACAAAUGUGCAAGGUGCCAAUUCCUGCGGGGAACCGAAAGAUAAGCG,32,14,29,24,99
853,2,CP001656.1/5519557-5519455,UUCUUAUCAAGAGCAGGCGGAGGGACUAGCCCGAUGAAGCCCGGCAACCGGCGUAAGCACGGUGCUAAUUCUUGCGGAAACAUUAGUUUCUGAGAGAUGAGGG,27,21,33,22,103
854,2,CP001791.1/1324400-1324509,UUCUUAUCCAGAGCGGCGGAGGGACUGGCCCUAUGAAGCCCGGCAACCAUCACGAAAGUGGAAGGUGCCAAUUCCAACAGAGCGUAUUCGUACGCUUUGACAGAUAAGAG,31,21,31,27,110
855,2,ACJX02000007.1/318260-318153,CUCUUAUCCAGAGCGGCGGAGGGACUGGCCCUGCGAAGCCCGGCAACCUGCUUACCCUUUGGGGAGCGUGGUGCCAAAACCUGCAACCGAAAGGUUGAAUGAUGAGAG,25,19,35,29,108
856,2,CP001739.1/1846920-1847007,AUAUCAUCAAGAGGAACUGAGAGACAGGCUCUGUGACGUUCCAGCAACCUACGUAAAUCGUGUGGUGCUAAUUCCUGAAAGAUGAAAA,30,20,21,17,88
857,2,CP001619.1/3294664-3294557,GAUUUAUAAAGAAGAGGCGAGAGAAUGGGCUCAACGAACCUCUGGCAACCUGCUACCACAUCGGAGAAAGGUGCUAAUUCCCACCUAAGUUAUUAGGAGAUAUAAACU,38,23,25,22,108
858,2,CP001867.1/829496-829625,CACUCAUCCAGAGGGGCAGAGGGACACGGCCCGACGAAGCCCCGGCAACCGCCGCACCGCGCGUCAGCGCAGCGGAAGGUGCCAAUUCCGUCCCGCGCGGCUCGACGGCCCGAUGCGGGGAAGAUGAGGA,27,10,47,46,130
859,2,ACLF03000006.1/44662-44769,CACUCAUCACGAGGGGUGGAGGGAACGGCCCGCUGAUACCCCAGCAACCAGUCGGUCUUCGACCAGGUGCUACGUCCGUCCCGGAGUCCGCUCCGGGGAAGAUGACCU,21,17,34,36,108
860,2,CP003056.1/732327-732208,UUCUUAUCAAGAGAGGUUGAGGGAAUGGCCCGAUGAAGCCUCAGCAACCUUCAAUGCUUUUACGCAUUGAAAAGGUGCUAAGUCCUGCAAGUUAUGGGAUCAUAACUUGAAAGAUAAGAA,39,31,29,21,120
861,2,CP001823.1/1231295-1231405,CUCUUAUCCAGAGUGGUGGAGGGAACGGCCCGACGAAGCCCGGCAACCGACGGAUCGCACGGUCCGCGCGGUGCCAAUUCCGGCAGCGGCGUUGCCGCUGAGAGAUGAGAG,22,15,41,33,111
862,2,CP001769.1/5132553-5132446,UACUUAUCCAGAAAGACGGAGGGACCGGACCCGAUGAUGUCUUGGCAACCAACCAGCCCAGGGGAAUGGUGCCAAUUUCCUCCCGCCAGCCAGCGGGGUAGAUAAGGU,28,18,32,30,108
863,2,ACCL02000003.1/136176-136276,CUCUUAUUCAGAGUGGUGGAGAUACAGAGGGUCUGUGAAGCCACGGCAACCCCGCAUAGACGGAAGGUGCCAGCCUGAGCGAUUAAUUCGAACAAUAAGAG,30,19,30,22,101
864,2,ACKQ02000002.1/742513-742620,AUGUUAUCAAGAAAGGUUGAGGGAUUAGACCCUGUGAAACCUUAGCAACCCUUUGCGCAAGUAAAGAAGGUGCUACGUUCUACCAAAAUAAUUUUGGACAGAUAACUU,37,29,23,19,108
865,2,ACIQ02000024.1/9596-9700,AUCUUAUUCAGAGACGGUGGAGCUACAUAGGAGCGAAGAAGCCGCAGCAACCCCGGAAACGGAAGGUGCUAACCUGAGCGAACAAUUUGUUUCGAACAAUAAGAC,36,18,28,23,105
866,2,ACHA02000006.1/124772-124667,CGCUUAUAGAGAAAGGCAGAGGGACUAGACCCAAUGAAGCCUUGGCAACCUGUCUUGGAGACAAGGUGCUACAUUCUACCCCACCUAAAAAAGGGAAAGAUAAGCG,37,18,27,24,106
867,2,CP001630.1/1349393-1349277,CGCUCAUCCAGAGGGGCAGAGGGAUCGGCCCGAAGAAGCCCCGGCAACCUGUCACCAGUCAUCAGACUGGGUGAUCACGGUGCCAAUUCCGACCCGCGAAAGCGGGAAAGAUGAGGA,31,14,38,34,117
868,2,CP001661.1/2331226-2331122,AACUUAUCACGAGCGACCGAGGGACUGGCCCCAUGACGUCGCGGCAACCUCCCGUAAGGGAAGGUGCCAAAUCCAGCGAAGCGGCGACGCUUCGGAAGAUAAGGA,29,13,33,30,105
869,2,CP002043.1/113014-112896,GUCUUAUCCAGAGCAGCGGAGGGAACGGCCCUGUGAAGCUGCGGCAACCUGCGGAGGCCUUCUAAAGCGCCUACUAAGGUGCCAAUUCCGACCCGGUGGCCAUCCGGGAAAGAUAAGGA,29,19,38,33,119
870,3,AF010496.1/39869-39652,GGCACCUUCGCGGCAGAUGGUUCCCGGCCAAGCCACGCGCGGCCGGGUGAAAAGGGAAUACGGUGUGGUGUAGGCAUCAGCCGCCAAAUCCGUAACUGCCCCCGCAACUGUAAGCGGCGAGCACCCCCCGGCAACCACUGGCCCCGACCGCGGGGCCGGGAAGGUGGGGAAGCCACGACCCGCAAGUCAGGAGACCUGCCAUCAGCGUCAUCAACCGC,47,24,71,76,218
871,3,AF010496.1/105318-105541,CCACUCAGGGCGGGCGCUGGUUUCUGUCCUAUGACAGGCGAAGAGGGAAUGUGAAGGGAAUUGCGACGGCUUUGCCGCGAAACCCGACCGCAGCCGCCCCCGCGACCGUGACCGGAGAGGGCGCCCCGAGGCCACUGGCACCAGCCGGGAAGGCGGGGCGACCGUGAGGGGACCCCCCCUCGCAUCCGCAAGCCGGGAGACCUGCCAGCGCAUGGAUUUCGGGC,41,26,82,75,224
872,3,AF010496.1/116971-117194,GCUACUCCAACAGGCGAUGGUUCCCAACUGGACGGGAUUAAUAGGGAACACGGUGAGGAUUACCCAUCAGGGGCCUAAUCCGUGGCUGCCCCCGCAACUGUGAGCGGCGAGACGACGGUCGAAGACCACUGGCCCCCCCGAUCCACCGGGGAGAACGGCCGGGAAGGUGACCCGAGUUGAUCGAACCGCAAGUCAGGAGACCUGCCAUCGCUCUGGCGUCGCAA,52,32,71,69,224
873,3,AF193754.1/4343-4142,GCAAUGAGGAAGGAUUAAGGUUCUUUGUCAUUGGCAAAGCUAAGAGGGAAACUGGUGCGAAAGAAUUUUCAAAGCCAGUGCUGCCCCCGCAACUGUAAACGGCGAGCAAAGAUCAAAAUGCCACUGAUAUUAUUAUCGGGAAGGCUGAUCGGACGCGGUGACCCGUCAAGUCAGGAGACCUGCCUUAAACCAAGUCAUCCAC,63,41,53,45,202
874,3,AF193754.1/24966-24788,GGAAAUUUUUUUGCAUAGGGUUUCCUUCGAGUGAAGGAAAAUUGGGAACAAGGUGCAAAACCUUGGCUGCCCCUGCAACUGUAAACAGUUGAAACGCCAAAAAGCCACUGAAUCUAUUCGGGAAGGCGGUUGUUUCGAUGCUGUGAGCCAGGAGACCGACCCUAUGUAAUCGUUCCACG,50,44,47,38,179
875,3,AF263012.1/9229-9015,AGGCUGACCGGUGCAGCUGGUUCGCCCUGUCCGCCAGGCAGGGUGUCGCAAGAGGGAACCCGGUGGAAAUCCGGGACUGCCCCGCAGCGGUGAGUGGGAACGACCGCCGUCAUACGCACUGGGCCCGGACGGGUCUGGGAAGCGACGGCCACUAGGUGUCUGCCCGGCAGACGUGCCCGCGAGUCCGAAGACCUGCCCGCUGCCCGCACGCGACC,36,27,79,73,215
876,3,AF306632.1/382-181,GAUAAUCCAAGUCGUCGAGGUUCUCCGGUUCCCAUUGAUCCGGAGCUAAGAGGGAAGCCGGUGCAAAUGCCGGCGCUGCCCCGCAACUGUAAGUGGCGAGCCGCUGUCCAACGAUGUCACUGAAGCCUGCACGGCUUCGGGAAGGCCGGACAGCAGCGAUGACCAGCAAGCCAGGAGACCGGCCCCGACAAUAUAUUGGUCC,47,33,62,60,202
877,3,AJ000758.1/1191-1370,UCAAACAGCAACAGUAAAGGUGCCAAGAAGGCUUAAUAGGGAAACUGGUGAAAGACCAGUACUGCCCCCGCAACUGUAAGUGUGGACGAACGAGUAUAACCACUGUGAAAAAAUCACGGGAAGGUUCUCAAGUAGAAUGAUACACAAGUCAGGAGACCUGUCUUUAUUGUGAAGUUUCUA,64,38,44,34,180
878,3,AJ000758.1/1489-1668,CAUAUCGUGCAAAAAAAAGGUGCGUAAUAUUUACAUUGCGUUAAAUGGGAAGUCUGGUGUGAAGCCAGCGCGUACCCGCCACUGUGAAGAGGAGCUGAUUGCAUUUGCCACUGUAUUCGGGAAGGCGCAAUCAAGUGAUGAAUCGAAGUCAGGAAACCAGCCUUUUUCUAAUGCUAAGCU,53,45,47,35,180
879,3,AJ278144.1/22351-22163,CAGUAAUAUCCAGUUGUCGGUCCUGCGAGUUAAUAGGGAAUCCAGUGCAAAUCCGAAACUGACACGCAGCGGUAAGGAAAGGUGCGAUGAUUGCGUAAUGUGGACACGGUCAUCCGGUGGGUGGUCAUCUCUUUGUAUCUUCAGAUGCCCUUCUAGGUCUGAAGACCUGUCGGUUAACGUCGCAUCUGG,44,50,54,41,189
880,3,AL583923.1/215513-215333,GUACUAUAUGCGACACUGUGUAUCUGUAAAGGCGAUGACGAUGCAGGAAGUCGGUGCAAAGCCGGCGCGGUCCCGCCACUGUAAUCGGGGAGCGACCCUCGUAGGCCACGGCCAUUGGCUGGAAGGCGAGGCAAGCGGUGAUCCGAGAGCCAGGAAACUCGCGUCAUCGCGUCCUGCUAAC,41,31,60,49,181
881,3,AL591978.1/19809-19999,UUAAAUAGGUCUUAUGUUGGUGGAAUGUAUGUACAUUUCUGAAAGAGGAAUUCGGUGCGAUGCCGAAACUGCCCCCGCAACUGUAAGGUGGACAAGAAUCGAGAUAACCACUGUACGUUUUUAGCGUAUGGGAAGGUUCGAUUGUUGGAUGAAGCCAAGUCAGGAUACUCGCCAAAUAAGACGGAAGCAAC,58,48,52,33,191
882,3,AL591978.1/56481-56658,GUACUAAACAACUAAAUAGGUGAAUAUAUUAAUCCGGGAAAGAGGUGAAAAUCCUCUACAGGCCCUAGCUACUGUAAUACGGACGAAAACCAAACAUAUGUCACUGGAAGCAAUUCCGGGAAGACUGGUGAGUAGGAUGAUGUUAAGUCAGGAGACCGCUUUUAUAUUCGAUAUCCAA,64,42,40,32,178
883,3,AL596167.1/167425-167616,UUAAAUAGGUCUUAUGUUGGUGGAAUGUGUUUGCAUUUCUGAAAGAGGAAUUCGGUAUGAAGCCGGAACUGCCCCCGCAACUGUAAGGUGGACAAGAAUUGAAAAUAACCACUGUGCGUUUUUGACGUAUGGGAAGGUUCAAUUGUUGAAUGAAGCCAAGUCAGGAUACUCGCCAAAUAAGACGGAAGCAAC,60,50,51,31,192
884,3,AL596167.1/202425-202602,GUACUAAACAACUAAAUAGGUGAAUAUAUUAAUCCGGGAAAGAGGUGGAAAUCCUCUACAGGCCCUAGCUACUGUAAUUCGGACGAAAGCCAAACAUAUGUCACUGGAAGAAAUUCCGGGAAGACUGGUGAGUAGGUUGAUGAUAAGUCAGGAGACCGCUAGUAUAUUCGAUAUCCAA,63,41,43,31,178
885,3,AL627279.1/139350-139157,CGGUAGCAUCCGUGGGCCGGUCCUGUGAGUUAAUAGGGAAUCCAGUGAAAAUCUGGAGCUGACGCGCAGCGGUAAGGAAAGGUGAGAUGAGAGCGUAAGCAGACACUGCCUCCGGCGGGAAGUCAUCAUUUCUGCUAUCCAGUCAACGGAUAACCCUCCAAGCCCGAAGACCUGCCGGCUAACGUCGCAUCUGG,49,36,59,50,194
886,3,AL672113.1/43141-43341,UGAUUGUGCGCAUGUCGUGGUUCUCCGCGCGGCACUGCCGUAGCGGAGCUAAGAGGGAAGCCGGUGCGAUGCCGGCGCUGCCCCCGCAACUGUUAGCGGCGAGCCAAGCCCAUUGGUGUCACUGAGGCGAACGGCCUCGGGAAGACGGGCAGAGGCUUUGACCCGCGAGCCAGGAGACCUGCCACGACGAACAACGUCCAC,39,30,70,62,201
887,3,AL939107.1/133849-134073,AGGCUGGCCCGUGCAGCUGGUUCGCCCCGUCCGCCAGGCGGGAUGCGUCGCAAGAGGGAACCCGGUGGGAAUCCGGGACUGCCCCGCAGCGGUGAGCGGGAACGACCGCCGUCAUACGCACUGGGCCCGACGUACCGGGCCCGGGAAGCGACGGCCAGUAGGUGUCCUCCGGACAGGAGGGUGGGCCCGCGAGUCCGAAGACCUGCCACCUGCCCGCGCGCGGAC,36,24,87,78,225
888,3,AL939107.1/140625-140436,GGACGCUGAUGGGAUGAUGGCCGGCGACAGGGCGACGACGGUCCGAGGAAGCCGGUGCGAAUCCGGCGCGGUCCCGCCACUGUGAUCGGUGAGCGGAUCCCGAAGUUGCCACUGCCCCGGUAGGGGCGGGAAGGCCGGGACGAGCUGUGACCCGGGAGCCAGGAAACUCACGUCGUCGCCUCCUCGACGG,33,24,76,57,190
889,3,AL939107.1/141879-142126,ACGCUGAUGCCCGCAGUUGGUUCGCGCCUCCUGUCCGAUCAGGUCUCGGCGGCGCGACGCAAGAGGGAACCCGGUGGGAAUCCGGGACUGUCCCGCAGCGGUGAGUGGGAACGAAAGCCGUCAACAGCACUGGGCCCCAGAUGAGUUGGAGCCCGGGAAGCGACGGCCGGUAGGUGCCCGCCGGUGAUCCGUGUCCCCGGUGAGCGCGCCCACGAGUCCGAAGACCUGCCACUGCGCCCGUACGCGAU,43,35,89,81,248
890,3,AL939107.1/147400-147583,CAGACCGUAGUAUCAGCGGGUCAUCGCCGCGACGGGAGACAGGAAGCCGGUGUGAAUCCGGCACGGUCCCGCCACUGUGACCGGGGAGUGCACCCUUCGACACGCCACUGCGCGCCGCGCGGGAAGGCCAGGGAGGAGCGUCGAUCCGGGAGUCAGGACACUGGCCUGUCGCGGGCCCGUUCCG,32,23,69,60,184
891,3,AL939125.1/243385-243171,CCUGCUUGUGCCCACCCCGGUGGGAGCACUACUGUCGCCACGCCUUGGUGAACGGGAAAUCCGGUGUGAUGCCGGUGCGGCCCUCGCCACUGUGAAUCGGGAAGUCCGGCUCCGGCCCUGACGGGCAGCCACUGGAUCGCUUGCGGUCCGGGAAGGCGGAGCACGGGCGGUGGUACCCGUAAGCCAGGAGACCGGCCAAGGCGCGUCGUCCAUCC,33,34,77,71,215
892,3,AY033236.1/563-353,GUGUAGGCUAGUAGUGCUGGUUCGGCUGCCCCACGGCAGUCGUCGCAAGAGGGAAUCCGGUGUAAUUCCGGAACUGUCCCGCAGCGGUCAAUGGGAACGACACAACGUAAGGCACUGGGCGGCAACGCCUGGGAAGUAGUAGUGGAGGAAGUCGGGAGUGAUCUCGCAAUGCCCAUGAGUCCGAAGACCUGCCAGCAGCGACAACAUCUGU,50,37,71,53,211
893,3,AY043208.1/560-782,UAUCUUUGCUCCCUGAUCGGUUCCGAAUAGUCAUUCCUCUAUCCGGAUUAAAAGGGAAUCGGGUGUAAAUCCCGGACAGUCCCGCUGCUGUGAAGCUCCGUCUGAAUUUCCGAUAACAACUGUUGCCACUGGGAUACCUUUUUGUAAAUAGAUAAGGAGUCACCGGGAAGGCGUCGGAAACAAGGAGUCAGUCAGAAGACCUGCCGCUUAUCAAAGGCUGUUU,57,59,55,52,223
894,3,BX248334.1/308192-308010,CCACGCUCUGCAUGCCAAUAUUCUUCCCGUCAGGCGAUGACGAUGCAGGAAGCCGGUGAGAAUCCGGCGCGGUCCCGCCACUGUCACCGGGGAGCGACCCUCAUAAGCCACGGCCACAGGCUGGAAGGCGAGGCAAGCAACGAUCCGGGAGCCAGGAGACUCGCGUCAUCGCGUCCUGCCACC,39,25,56,63,183
895,3,BX248337.1/276050-275850,GGCAUCGAGCGGGGCAACGAUGCUUCGCGAGAGGGAACCUGGUGAGAAUCCGGGACUGUCCCGCAGCGGUAUGCAGGAACGACCGCCGUCUUGGAAGUAGACAAGCACUGGUCUCAACGACUGGGAAGCGACGGCCAGUAGGAGCACCCACCGGGUGCGAGCCUGCGAGUCCGAAGACCUGCCAGCCGUGCCGGACGCGCC,44,25,72,60,201
896,3,BX248356.1/172244-172444,CUGUACAAAUCGCACCAAGGUGUUAGUGUUGGGUGUGUUGAAGUGAUCGGGAAUGCCAGUGCAAUUCUGGCAGCGGACCCCGCCACUGUAACCGCAAAUUAUGCCCAUUUCUAGCCACUGCAGUCCUGCGGGAAGGGUAGAAAGACACACUUUUUACUGGGCGCGGUAGCCAGGAGACCGGCUUCAACAUUUUAUACGUAG,49,48,56,48,201
897,3,BX248357.1/28572-28772,UGUGUUACACAUUGAUUAGGUGCAGCAUAGAACUGCUGCAUGGGAAUCUGGUGAAAAUCCAGAGCUGACGCGCAGCGGUGAAGGUGCAAGUGAGUGCUUCAAUGUAGCCACUGAGAGUAUAAAAACUCUUGGGAAGGUGAGGCAAUUACUCUCGCGUAGAGCACCCCAGUCCGAAGACCGGCCUAAUCAGAAACAUGUGCU,58,44,57,42,201
898,3,BX294140.1/211185-211419,UCCGAGGUGACUGAUUUGGUUUCUGCCGAGUCAGUGAACAGGGAACUCCGGUGAAAUUCCGGGACGGUCCGGCCGCUGUGUGCCGCCAGAGAUCUUCCAAGUGAAGUCUCAUUGUUUGCUUUUCUAUUCAGCCAUUGCUCGUGUUUUCGCGUUUCAACGUGAACGUGAGUGAGAAGGCCAUGAGCAAACAAAGUGGUGGUGAGUCAGAAGACCUACCUCGUACAAGACGUUUUGG,51,64,68,52,235
899,3,BX294144.1/76053-76292,GCAACGUUACGUGGUGCCGGUGUUCCAAAUCUUGGAUCACUGGGAACAGGGAACUUCGGUGAGAUUCCGAGACGGCCCGGCCGCUGUAUCCGAUGCGAAGUUGCUGACUUGGCAACUUCCAAGCAAACAUUCCUCUUGUGCCAUUGUCGUUGAUCGGAAUUAUCCGUGACGGACGAGAAGGCGAGCGUUUGCGAGUUUGCAUCGGGAGUCAGAAGACCUACCACGAAACGGACACUAUGU,56,56,70,58,240
900,3,BX569694.1/273573-273792,CCCCUAGGGUUUGGGUCUGGUUUCAGCGGGGAUCAGCCGCUGAUGGAAACGGGGAAAGAACGGUGCAAAUCCGUCGCUGUCCCGCAGCUGUAAAGCGUCCGGCCCCGCCGGCGUCAGUCAGAACGCCCGCCAGGAGCACUACCGACGAGGAUCGACUUUGACCAAUCUUCUGGCUUCUCCCCGGCCUCUGCGCCAGGCCGCCGUUGCCGCAUUGGCCUUG,37,42,68,73,220
901,3,BX571869.1/30799-30632,UUAAUACCACACCUUAAUGGUGUGGUUGGGAAGGAGGUGAAAGUCCUCCGCAGCCCCCGCUGCUGUGAUGCUGACAACUCCGCUGAUGCCACUGGUCGGAAAGACUGGGAAGGUUGCGGGGAAGGGUGACGCUAAGCCAGAAGACCGACCUGACAGGCACGAGACAUU,42,31,54,41,168
902,3,BX572594.1/100625-100429,AAUACCGUGACCAGCGACGGUUCCCGAAAGGGAUCAAUAGGGAACGCGGUGCGGGCUUUAGGGCUCUAUUCCGCGGCUGCCCCCGCAACUGUAAGCGGCGAGCCAUUCGCCACACGCCACUGGGCUUUCGUCCUGGGAAGGCGGUGAACGGCAACGACCCGCGAGCCAGGAGACCUGCCGUCAGUCGUGGUCACACG,40,31,64,62,197
903,3,BX572595.1/86162-86360,GCUAGCGUGCCAAGCGAUGGUCCUUCCGUCAGGAAGGUGAAAAGGGAAGCCGGUGGGAGGCGCGGUGCGUCUCGAUCCCGGAGCUGCCCCCGCAACUGUAAGCGACGAGCCAUUGCCGAGGCCACUGGGAAUUCCUGGGAAGGCGGCGAAUGGCGGCGACUCGCGAGCCAGGAGACCUGCCAUCGCGUAUUGUGCUUUG,38,33,73,55,199
904,3,BX572595.1/100553-100338,UUUGAUCGCGCCCGUUCAGGUGUGCCGGGAAUCGUCCGGCACAGGGAAGCCGGUGCGGGCCCAAGCUUAUGGCCGCAAACCCAAAUCCGGCGCUGCGCCCGCAACUGUGAGCGGUGAGCGAUCCUUCAAUCGGCCACUGGGCAGCACUUGCCCGGGAAGGCGAAGGAUUGCGACGACCCGUGAGCCAGGAGACCGGCCUGAGUACGUCAUCUUCCA,42,35,71,68,216
905,3,BX572596.1/50556-50756,UCUGGUUUUGACGUCUUCGGUGCCUCGCGUGCGAGGUGAAACUGGGAAUACGGUGCGGUGUUUUUCACCUAAUCCGUAGCUGCCCCCGCAACUGUAGGCGGAUCUGUCCGGAUCAUGUAGCCACUGACGUCCUCGGCGUCGGGAAGGCGGUCCAGGCGAUAUCCGUGAGCCAGGAGACCGGCCGAAGACGGGAAGCAUCUA,37,44,66,54,201
906,3,BX572599.1/247113-247314,UUAACCCGAGGUUGUACCGGUGCCUCUCGCCGAGAGAGGUGAAACGGGAAUGCGGUGCGGGGCGAUGCCCCAAUGCCGCAGCUGCCCUCGCAACUGUGGGCGGAUCGGAGCGUCCUCGCAUGCCACUGACCAGAUCGGUCGGGAAGGCGGACGCGCCGGAUAUCCGCGAGCCAGGAGACCGGCCGGUACAAGGUGUGCAACU,39,30,73,60,202
907,3,BX572599.1/256535-256331,CAAACAUCGCGCGCCGACGGUGUCCUGUCUUCGGACAGGACGAAGAGGGAAUAUCGGAAGAUCGCUGCCUGCAGCGGUCGCGCCGAAGCUGCCCCCGCAACUGUAAACGGUGAGCCGACGCAAUACGCCACUGGAUCAUAUCCGGGAAGGCCGCGUCGGCGACGACCCGUGAGCCAGGAGACCUGCCGUCGCCUGCUAUGUUGAC,44,31,65,65,205
908,3,BX572599.1/259196-259407,UGUGGUGCCGCUCGCUUCGGUGCCCUUCGUUCGAAGGGUGAAACGGGAAUGCGGUGCGGCGAGCAAUCGCCAAGUCCGCGGCUGCCCCCGCAACUGUAAGCGGAUCGUCUCCGGUCACUCCGCCACUGAGUUCGGCAUCCUAGAGCCGCUCGGGAAGGCGACCGGGACAAUGUCCGCGAGCCAGGAGACCGGCCGAAGUCCGCAACCAAGCC,39,33,70,70,212
909,3,BX572600.1/273933-274129,CAUAGUGAUCGCCGUCGAGGUUCUUCGGGCACGAUCGUCCCGAAGCUAAGAGGGAAGCCGGUGCAAGGCCGGCGCUGCCCCCGCAACUGUUAGCGGUGAGCCGACGUUCAGCAAAGCCACUGGGAGCGAUCCCGGGAAGGUCGAACAAAGGCGAUGACCCGCGAGCCAGGAGACCUGCCUCGUCGAACGAAACGUCC,45,27,65,60,197
910,3,BX572608.1/190529-190732,ACUUCUAAUGGCGGUGACGGUUCCCGAGAGGGAUGAAAAGGGAAUACGGUGCGGACGCAGACACUUUCGCGUUCUAGGCCGUAGCUGUUCCCGCAACUGUAAGCGGAUCGUCUUUCGUCGGAUGCCACUGGGAACCUCGGUCCUGGGAAGGCGACGGAAGAUCAACCGCGAGCCAGGAGACCUGCCGUCAUUCGUGGUCACACG,44,40,66,54,204
911,3,BX842572.1/309867-309685,CCACGCUCUGCAUGCCAAUAUUCUUCCCGUCAGGCGAUGACGAUGCAGGAAGCCGGUGAGAAUCCGGCGCGGUCCCGCCACUGUCACCGGGGAGCGACCCUCGUAAGCCACGGCCACAGGCUGGAAGGCGAGGCAAGCAACGAUCCGGGAGCCAGGAGACUCGCGUCAUCGCGUCCUGCCACC,38,25,57,63,183
912,3,L12006.1/1016-1191,CCAUAACGUAAACCAACAGGUUUGCCACAUUUGUGGUAGGGAAGGGGGUGAAAAUCCCCCGCAGCCCCCGCUGCUGUGAUGCUGACGACCCCGUAAAGACCACUGAUCGCAAGAUUGGGAAGGACGGGCGAGGAGGACGCUAAGCCAGAAGACCUGCCUGUCGGUGAUAACCAACA,49,28,52,47,176
913,3,M10112.1/56-247,CUGUAGCAUCCACUUGCCGGUCCUGUGAGUUAAUAGGGAAUCCAGUGCGAAUCUGGAGCUGACGCGCAGCGGUAAGGAAAGGUGCGAUGAUUGCGUUAUGCGGACACUCGCCAUUCGGUGGGAAGUCAUCAUCUCUUAGUAUCUUAGAUACCCCUCCAAGCCCGAAGACCUGCCGGCCAACGUCGCAUCUGG,43,44,54,51,192
914,3,M34485.1/360-150,UUUACACAAUUCGUAACAAGUUAAAAGCAUUCGCUUUAGGGAAACUGGUGCAAAUCCAGUGCUGCCCCCGCAACGGUAAAAAUGUAAACCAUAUUAAAAAAGUCAUUUAGACUUACGCCACUGCAUGCAUAGAUGUGGGAAGGUGAAUAUGCUUGUCUCUUUUUGAGAUGCCAUUUGAGUCCGGAGACCUGCUUGUUACAUCUAUCCACUC,63,61,42,45,211
915,3,M57569.1/218-26,CGGUAGCAUCCGUGGGCCGGUCCUGUGAGUUAAUAGGGAAUCCAGUGAAAAUCUGGAGCUGACGCGCAGCGGUAAGGAAAGGUGAGAUGAGAGCGUAAGCAGACACCUGUCCGGCGGGAAGUCAUCAUUUCUGCUAUCCAGCCAACGGAUAACCCUCCAAGCCCGAAGACCUGCCGGCUAACGUCGCAUCUGG,49,35,59,50,193
916,3,M89481.1/311-504,CGGUAGCAUCCGUGGGCCGGUCCUGUGAGUUAAUAGGGAAUCCAGUGAAAAUCUGGAGCUGACGCGCAGCGGUAAGGAAAGGUGAGAUGAGAGCGUAAGCAGAAACUGCCUCCGGCGGGAAGUCAUCAUUUCUGCUAUCCAGCCAACGGAUAACCCUCCAAGCCCGAAGACCUGCCGGCUAACGUCGCAUCUGG,50,35,59,50,194
917,3,U45329.1/408-194,CUAAAGUGGCAGCGUAUCGGUUCUGCAAGUGUCAAAACGCNCGCGGAUGAAAAGGGAAUACGGUGAGGACGACCCAAGUAAGGGCCGAAACCGUGGCUGCCCCCGCAACUGUGAACGGCGAGCGAUGUCCAUCAUGCCAUUGGCCCCACGGCCGAUAAGGCGGACAAAGCCCAGACCCGUGAGCCAGGAGACCUGCCGAUAAGCAUGCGCGAAAG,59,28,67,60,215
918,3,Z94723.1/23034-23246,CACACGGCGCCAGUAUCGAGUGAUGCUAGCUCAGCAUCGCGAGAGGGAACCCGGUGAGAAUCCGGGACUGUCCCGCAGCGGUAUGCAGGAACGACCGCCGUCUGGAAGCACUGGUCUUAGAAAAAUCCGAGACUGGGAAGCGAUGGCCAUUAGAAGCACCUAUCCAGUGCGCGCCUGCGAGUCCGAAGACCUGCCGGCUGUGUCGGGCGCGCC,48,33,70,62,213
919,3,AM236080.1/2836182-2835994,GAAAUAGAUGCGCCGUCAGGUGCCCGCCGGUAAGGCGGGAGAAUCGGGAAUCCGGUGCAAGACCGGAACGUGCCCAACGCUGUAAGGCCGACGUUUGCCGCUUCAUCACGCCACUGGCUUUUCGCCGGGAAGGCUGCGGCAGACGGAUGACGCCCAGUCAGAAGACCGGCCUGGCAAGAUAGACCGAUC,43,28,63,55,189
920,3,CP000283.1/2591234-2591019,CAAACAUCACGCGCCGAUGGUGUCCCGUCUUUGGACGGGACGAAAAGGGAAUGCCGGAAGUCGCUGCCCGCAUUGAUGCGAGCAAGACCGAGCCGGAGCUGCCCCCGCAACUGUAAACGGCGAGCCGACGCAACACGCCACUGGAUGUUUCUCCGGGAAGGCUGCGCCUGCGACGACCCGUGAGCCAGGAGACCUGCCAUCGCCUGCUGUGUUGAC,46,33,68,69,216
921,3,AE013598.1/1368227-1368452,UACCAUGCGCGCCCCUGAGGUGACUGUCGGCUUGCCGGCGGUUUAAACGGGAAUCCGGUGCGCAGAUCGCCUUGGCGUGGUGCAAUUCCGGAGCUGCCCCCGCAACGGUGGGCGAGACAAGGGUCUGCAUGUAACACCACUGUGCGGUGCACGGGAAGGCGCAGAUCCGGGAAGCGAUUGCUUCCGCUCGCAAGCCCGGAGGCCGGCCUGAAGGGAUUGACCCGGC,40,38,81,67,226
922,3,AAAP01002228.1/195-394,CCUAGCGUGGCCGUCGACGGUUCCCGAAAGGGAUCAAAAGGGAACGCGGUGAAGGGCCUUUGCCCGAUCCCGCGGCUGCCCCCGCAACUGUGAGCGGAGAGCCCUCCAUCACCACGUCACUGGGCGAGCCUUCGCCUGGGAAGACGAUGGAGGACAACGACCCGCGAGCCAGGAGACCUGCCGUCAGCCGUGGUCACACG,41,26,66,67,200
923,3,AAYH02000045.1/230200-229995,UAUCUUUGCCCGCGAAUUGGUUCCGGAUGCAUGUUUCCAUCAUCUGGAUUAAAAGGGAAUCGGGUGUAAAUCCCGGACAGUCCCGCUGCUGUGAAGCUCCGUUUAUAUCAUGAAAAACACCCUUGCCACUGAUAUGCAUUGAAAUAUCGGGAAGGCUUCAGGAUUAGGAGUCAGUCAGAAGACCUGCCAUUCAUUAAAGGCUGCCU,54,56,49,47,206
924,3,CP000283.1/2593935-2594143,CUGUUGUCGCGCAUCUUCGGUGCCCUUCGUCGGAAGGGUGAAACGGGAAUGCGGUGAGGCGAGUGAUCGCCCAAUCCGCGGCUGCCCCCGCAACUGUAAGCGGAUUGUCUUCGGUCACAUGCGCCACUGAGUUCGGCACCAGCCGCUCGGGAAGGCGAUCAGGACAACAUCCGCAAGCCAGGAGACCGGCCGAAGACCGUAGCAACGCC,43,34,67,65,209
925,3,CP000463.1/3532969-3532758,UCAUAAGUUAGCCAUCGUGGUUCUGCGGGCAAGUCGUGCCCGGAGCUAAGAGGGAAGCCGGUGCGGCGCAAGCCAAGGCCGGAGCUGCCCCCGCAACUGUAAGCGGCGAGCCGCUGUCCAACAAUGUCACUGGGACCGAUGAGGUUUCGGGAAGGCCGGACAGCAGCGUUGACCCGCGAGCCAGGAGACCUGCCACGAUGAAAUUCAACGUC,48,32,71,61,212
926,3,AAAP01003520.1/1076-875,GGCCAAGAUCAUCCCGACGGUUCCCGCAAGGGAUCAAAAGGGAACGCGGUGAGGACCGUUCGGUCCGAUGCCGCGGCUGCCCCCGCAACUGUGAGCGGCGAGCCUUUUCGCCACCGACGUCACUGGGCCACCUCGCCCGGGAAGACGGUGAGAAGGCGACGACCCGCGAGCCAGGAGACCUGCCGUCAGCCGUGGUCACACG,40,25,68,69,202
927,3,CP000115.1/3123579-3123785,CAUAGGAUGGGGGGUCGAGGUUCUCCGGGACGAUUCACGCCCGGAGCUAAGAGGGAAGCCGGUGUGUCUUCGGAUAAAGCCGGCGCUGCCCCCGCAACUGUAAGCGGUGAGCCGUGGUCCAUCAUGCCACUGGGUGUUGUCCCGGGAAGGCCGGACCAAAGCUGAGACCCGCGAGCCAGGAGACCUGCCCCGGCAACAUAGUCGUCC,41,33,72,61,207
928,3,CP000463.1/3487850-3487645,UUUCGUUCGGUCAUCUUCGGUGCCCUUGUUCGGAAGGGUGAAACGGGAAUGCAGUGCGGCGAGCAAUCGCCAAAGCUGCGGCUGCCCCCGCAACUGUAAGCGGAUUGUCCGCGAUCACUAAGUCACUGAGGCGAGUUUCGGCCUUGGGAAGACGAUCGGGACCGUAUCCGUGAGCCAGGAGACCGGCCGAGGAUUUGUCGCAAUGC,41,43,68,54,206
929,3,CP000250.1/5294881-5295084,CUUUUAGUUGUAGGCGACGGUUCCUCUCCGGAGGAUCAAAAGGGAAUGCGGUGCGGGUGCCUUCGGAAACCCAACUCCGCAGCUGUUCCCGCAACUGUAAGCGGUUCGACUUUCGUCGGAAUGCCACUGGGAAACUCGGUCCUGGGAAGGCGACGGAAGGUAACCCCGCGAGCCAGGAGACCUGCCGUCAUCCGUGGUCACACG,42,40,64,58,204
930,3,CP000738.1/1657203-1656988,GCCAUAUGACAGCCGUCAGGUGCCCGCUUUUAUGUGGGAGAAUCGGGAAGCCGGUGCAGUUCCGGCACGUGCCCAACGCUGUGAAGGGGACGUUCUCGCCAAAAACAGGCUCUGAAUCUUUUCAGAGCUUUGCCACUGAAUUUUAAAGUGAUUUGGGAAGGCGGCGGGAGCGGAUGAUCCGAAGUCAGAAGACCGGCCUGGCGAGAUAGACCGGCC,50,44,70,52,216
931,3,AM263198.1/1122851-1123040,UUAAAUAGGUCUUAAGUUGGUGAAAUGUAUUUGCAUUUCUGAAAGAGGAAUUCGGUGCAAUGCCGAAACUGCCCCCGCAACUGUAAGGUGGACAAGAAUUGAGAAAACCACUGUGCGUUUAAUCGUAUGGGAAGGUUCAAUUCUUGGAUGAAGCCAAGUCAGGAUACUCGCCAAAUAAGACGGAAGCAAC,62,47,48,33,190
932,3,CP000139.1/3919800-3919587,UAUCUUUGUUCCCGAAUCGGUUCCGAAUAGAUGUCCUCUAUCCGGAUUAAAAGGGAAUCGGGUGUAAAUCCCGGACAGUCCCGCUGCUGUGAAACUCCGAUAAAAUUUCCGAUACGUACCUAUUGCCACUGCCUGACUCCACAUAACGAGAACGCGGGAAGGCAUCGGAAAUGAGGAGCCAGUCAGAAGACCUGCCAUUCAUCAAAGGCCGUUU,59,50,50,55,214
933,3,CP000481.1/1942077-1942287,AUGGUGUCGCCUGCGACUGGUUCGACCCCUCGGGGUCGUGCCAACAGGGAACCCGGUGUGAAUCCGGGACUGCCCCGCAGCGGUGAGCGGGAACGACCGCUGUCAUCAAGCACUGGGCCGGACGGCCUGGGAAGCGACAGCCAGUAGGUGACCGGCGAUUCGCCGGUCGGGCCCGCAAGUCCGAAGACCUGCCAGUCGCCCCGCGGACACC,37,28,75,71,211
934,3,CP000479.1/1283346-1283177,CAAGAAUGUCACCCGUAAGGUGAUGACGAUGCAGGAAGCCGGUGCGAAUCCGGCGCGGUCCCGCCACUGUCAUCGGGGAGCGACCCUCAACGGCCACGGCUGACAAGCUGGAAGGCGAGGCGAGCGGCGAUCCGAGAGCCAGGACACUCGCGUCAUCGCGUCCUGCGACC,37,21,58,54,170
935,3,CP000647.1/3513278-3513100,CGGCGAAACAAACCGACAGGUUCGACACCAGUUUGGUGUCAGGGAAGGGGGUGUAAAUCCCCCGCAGCCCCCGCUGCUGUGAUGCUGACGACCCCGCAAAAACCACUGAUCGAAAGAUUGGGAAGGGCGGGCGAGAACGAGGCUAAGCCAGAAGACCUGCCUGCCGGUAACUGACCAAC,49,24,55,51,179
936,3,CP000133.1/3940621-3940395,ACUAUAUCUAGUGUUCAAGGUUCCUUCGAUUCGUCAGGAUCGCGGGCGAAGAUGGGAAUACGGUGCGUUUCGCCAUGACGGCGCAACAAGGCCGGAGCUGCCCCCGCAACUGUAAGCGGCGAGCAACUGUCCGAUUUCAGGUCACUGAGGCAUGAUGCCUCGGGAAGGCUGGGGCAGGGUGCUUCGACCCGCGAGCCAGGAGACCUGCCUUGAACUAGAUGUCCACG,48,45,73,61,227
937,3,CP000463.1/3491563-3491365,UUAAAGCGCUGCGUCACCGGUGCCUCUCGCAAGAGGGGUGAAACGGGAAUGCGGUGCGGGACGAUGUCCCCAAGCCGCAGCUGCCCUCGCAACUGUAAGCGGAUCACGACGUCCUUGAUGCCACUGGCCGAUCGGCCGGGAAGGCGGACGAGCGAUACAUCCGCGAGCCAGGAGACCGGCCGGUGACGUUGAGCCAACU,42,29,68,60,199
938,3,CP000491.1/325972-326168,ACUACACGGUCGGGUGACGGUUUCCGAUUUCGGAAUGAAAAGGGAACGCAGUGCGGACCAGCCGGUCCCAUGCUGCGGCUGCCCCCGCAACUGUAGGCGGAUAGCCUUUGCCAACGGCCACUGGGUGCGACCCCGGGAAGGCGGCGACAGGCGACGACCCGCGAGCCAGGAGACCUGCCGUCAGCCGUUGUCACGCG,38,28,68,63,197
939,3,CP000250.1/3635632-3635843,AAACAUCGCGCUGCCGACGGUUCCUGUCUGCGGACGGGACGAAGAGGGAAUAUCGGAAGUCAUCAUCCAGACGCGGAUGAUGGCGGUGCCGAAGCUGCUCCCGCAACUGUGAACGGCGAGCCAUCGCAACACGCCACUGGGCAGACGCCUGGGAAGGCUGCGUUGGCCGUGACCCGUGAGCCAGGAGACCUGCCGUCGCCUGCUGAUUGACG,44,33,72,63,212
940,3,CP000250.1/3754381-3754174,UCUGUUUGCCAUGCCUUCGGUGCCUCUCGAAAGAGAGGUGAAACAGGGAAUGCGGUGCGGCGAGCUUUCGCCAAUUCCGCGGCUGCCCCCGCAACUGUAGGCGGAUCGUCCGCGAUCAAGCUGCCACUGAGCGAUCGUUUUGCGCUCGGGAAGGCGAUCCGGACCAUAUCCGCGAGCCAGGAGACCGGCCGCAGGCAAUCGUCCACUU,39,40,65,64,208
941,3,CP000230.1/1707586-1707782,UAGCCUAUGUUGUGUUACGGUUCCCCGGACACCACAAUAUCCGGGGCUAAGAGGGAAGCCGGUGCGAUGCCGGCGCUGCCCCCGCAACUGUCAGCGGCGAGCCUUCAUCCAUUCAUGCCACUGGGGAAAUUCCCGGGAAGGCGGACGAAGGCGACGACCCGUGAGCCAGGAGACCUGCCGUGACCCUUGAAACGUCC,41,33,61,62,197
942,3,CP000283.1/3256000-3255793,GUGCGCGCAUCGACCUUCGGUGCCCUUCUUGGAAGGGUGAAACGGGAAUGCGGUGCGGCGAGCAAUCGCCUAGUCCGCAGCUGCCCCCGCAACUGUAAGCGGAUCGUCUCCGGUCAAAUGCGCCACUGAGUUCGGCUUCAGCCACUUGGGAAGGCGAUCGGGACAUUCUCCGCGAGCCAGGAGACCGGCCGAGGGUCGUUUUGGAUGC,37,40,70,61,208
943,3,CP000250.1/834289-834069,GCUAGCGUGGCCGGCGAUGGUCCUUCCGCGAGGAAGGUGAAAAGGGAAUCCGGUGCGCGAACGCUCUGCAUUGAGCGAUCUCAAUCCCGGUGCUGCCCCCGCAACUGUAAGCGACGAGCCCGCGCCUCGGCCACUGGGAUUCCUCUAAGGACUCCUGGGAAGGCGGCGACAAGGGCAGCGACUCGCGAGCCAGGAGACCUGCCAUCGCGAAUUGUGCUUUG,43,37,74,67,221
944,3,CP000283.1/3256310-3256518,GAAGUCGCUUCAGCCUACGGUGCCUCUCGUCGGAGAGGUGAAACUGGGAAUGCGGUGCGGCGAGAGAUCGCCAAUUCCGCAGCUGCCCCCGCAACUGUGAGCGGAAUAGGUCCGGAUCAAACUGCCACUGAGCUUCGAAGUGAUGCUUGGGAAGGCGAUCCGGACAAUCUCCGCGAGCCAGGAGACCGGCCGAAGGCGUUGUUCAACUC,46,37,68,58,209
945,3,CP000319.1/2878648-2878845,UUCUAAAUGACCGGCGACGGUUCUCCCUCGGGAGAUCAAAAGGGAACGUGGUGCGGGAUCAUCCUAACGCCACGGCUGCCCCCGCAACUGUAAGCGGCGAAUCUGCGUCACAGGCCACUGGGACAUCUCGGCCCCGGGAAGGCGACGCCAGGUAACGACCCGCGAGCCAGGAGACCUGCCGUCAACCGUGGUCACACG,44,28,61,65,198
946,3,CP000463.1/2468338-2468530,GCUAGCGUCGCCACCGAUGGUCCUUCCGUUUGGAAGGUGAAAAGGGAAGCCGGUGCGAGUUCGCUCCAUUCCGGCGCUGCCCCCGCAACUGUAAGCGACGAGCCAUCGCCGAGACCACUGGGGCAACCUGGGAAGGCGGCGAGAGGGCGGCGACUCGCGAGCCAGGAGACCUGCCAUCGCGGACUGUGCUUUG,36,30,68,59,193
947,3,CP000759.1/250860-251074,ACUAUAUAUAGUGUUCUAGGUUCUUUCGAUUCGUUGGGUCGAAAGCUAAGACGGGAAUCCGGUGCGUUUCAUCCAUGACGGAUGCGGCAAUGCCGGAGCUGCCCCCGCAACUGUAAGCGGAGAGUUCUGUCCAUCACGUCACUGGCUUUGGCUGGGAAGGCGGACAGAAUGUUGAUCCGUGAGCCAGGAGACCUGCCUUGAACGAGUACGUCCAC,47,52,64,52,215
948,3,CP000250.1/3754538-3754747,UCUUGUCGGAUCGUCUACGGUGCCUCUCGCGAGAGAGGUGAAACAGGGAAUGCGGUACGGCGCGAAAGCGCCAAAGCCGCGGCUGCCCCCGCAACUGUAAGCGGAUCGUCGCCGAUCACAUGCGCCACUGAGUCCGCCAAGACGGCCUCGGGAAGGCGAUCGGGACAACAUCCGCGAGCCAGGAGACCGGCCGUAGAUUCGUGCAAUGCC,46,30,69,65,210
949,3,CP000283.1/785607-785805,GAUACGGUGAACAUCGACGGUUCCCGCAAGGGAUCAAUAGGGAAUGCGGUGAGGAUUCUCGCGAAUCCAAUUCCGCGGCUGCCCCCGCAACUGUAAGCGGCGAGCCUUUCGCCAAGCGCCACUGGGCUUCGAGCCUGGGAAGGCGGCGAAAGGCAGCGACCCGCGAGCCAGGAGACCUGCCGUCGUCGUGGUCACACGC,42,30,66,61,199
950,3,CP000301.1/4173480-4173288,GCUAGCGUUGCGAACGAUGGUCCUUCCACGUGGAAGGUGAAAAGGGAAGCCGGUGCGAGCGAUUUCAAACCCGGCGCUGCCCCCGCAACUGUGAGCGACGAGCCCGCGCCGAGGCCACUGGGAUGUUCCUGGGAAGGCGGCGAGGGGCUUUGACCCGCGAGCCAGGAGACCUGCCAUCGUGAAGAGUGCUUUG,38,31,70,54,193
951,3,CP000301.1/96643-96430,CUCCUAGAUGAUCGCGACGGUUCCCCUCUGGGGGAUCAAAAGGGAAUGCGGUGCGGGACGGCUCUCGGUUGGAGCAAGCCCAAUGCCGCGGCUGCCCCCGCAACUGUAAGCGGUUAGUCUUUCGUCUGAUGCCACUGGGAAACUCGGUCCUGGGAAGGCGACGAAAGGUUCCGACCCGCGAGCCAGGAGACCUGCCGUCAAUCGUGGUCACACG,42,39,70,63,214
952,3,BA000040.2/5279689-5279475,CGUAGAUUGAUCGGUGACGGUUCUCCGCACGGAGAUCAAAAGGGAACGUGGUGCGAGAUUGUCCCAAUGCCGGGAUUGUCCCAACGCCACGGCUGCCCCCGCAACUGUAAGCGGUGAAUCUUUCGUCAUAUGCCACUGGGAAUCUCGGUCCUGGGAAGGCGACGUAAGGUAACGACCCGCGAGCCAGGAGACCUGCCGUCAGCCGUGGUCACACG,47,40,67,61,215
953,3,CP000140.1/1176516-1176715,ACUUUUGUCACUGUAACAGGCUCCGCUUAUCUCUUUUUCCGGGAGGCGGAUUAAAAGGGAACCGGGUGAGAAUCCCGGACAGACCACGCUGCUGUGAACUUUUAAACAUUCGGACAAUACCUUGGCCACUGGUUUUGUAAUCGGGAAGGCGUCCUGAAUGGAAGUAAGUCAGAAGACCUGCCGGUUCAUAAAUAAAUGUU,53,53,51,43,200
954,3,CP000739.1/543105-542876,ACAUUAACUGGGACCGACGGUUCCCCUACCCGAGAGGUGGAGGGGAUUAAUAGGGAACACGGUGCGGACGACCCAAAAGGGACCAAAACCGUGGCUGCCCCCGCAACUGUAAGCGGAUCGUCGUUCAUCCUCGUGGUGCCGAGGCACCAGCCACUGCGCGACGCGCGGGAAGGUAGAUGAGCGACUUCUGUCCGUGAGCCAGGAGACCUGCCGUCAAAUUCGAUCCAUCG,54,37,72,67,230
955,3,AATQ01000040.1/37497-37304,CUAGAUAUAGGUGCUUCAGGUGCUCGGCGGAAUCAUCCGCCGGCAAGAGGGAAGCCGGUGAAAAGCCGGCACUGCCCCCGCAACUGUAAGCGGCGCGCGAGGCCGAUCAUGCCACUGGGGCUGCCACCCCGGGAAGGCCGGUCAAGCGGGACCCGCCGCGAGUCAGGAGACCUGCCGGAAGCAACAGGAUUUGA,43,24,68,59,194
956,3,AE015928.1/2403656-2403862,AUCUUUGCCCCCCGAAAUGGUUCGGAGUCCGUGUCCAACGGACAACGAUUAAAAGGGAAUCGGGUGUAAAUCCCGUACAGUCCCGCUGCUGUGAAGCUCUAUACAAUGUCUUAUUAAUGAACUAAUUUAUCGCCACUGAUGUUAUUUCGGGAAGGCACUAUAAGACAAGAGUCAGUCAGAAGACCUGCCACUUCGCGUAAAGCGUUC,58,53,47,49,207
957,3,CP000377.1/548354-548161,UCAAUAUCGUGUUGCUUUGGUUCUUUCGAGGCGACUCGCAAGCGAAGAGGGAAACUGGUGAAAAUCCGGUGCUGCCCCCGCAACUGUAAGCGGCAAGCCCUGCCCGUGCCACUGACGCAUCGCUGCGUUGGGAAGGCGGGAGGGGGCGUUUGAGCCGCGAAGCCAGGAGACCUGCCAGAGCACGACACACGACG,42,33,65,54,194
958,3,AAXE02000001.1/9613-9819,UACAUUUGCCACCGAAUCGGUUCUGUAUUUCCCGUUCGGGAAUAUGGAUUAAAAGGGAAUCGGGUGUAAAUCCCGGACAGUCCCGCUGCUGUGAAGCUCCGUUUUAACAUCUUGGAACUACUUUCGCCACUGACUUGUUAUAAUUAAGUCGGGAAGGCUUCAGGAUGGGAGUCAGUCAGAAGACCUGCCGUUCAUUAUAAGGUUCAU,51,61,51,44,207
959,3,CP000664.1/92637-92429,GUCACGCCAUGCCAUGACGGUUCCCGAGGGUCGCACGGCCCGAGGGAUGAAAAGGGAACACGGUGAGGGGGAAACCCCGAGUCCGCGACUGCCCCCGCAACUGUGAGCGGCGAGCCGCCCCGACGGACACCACUGGCCGAUGGCCGGGAAGGUUCGGGGACGGCCACGACCCGCGAGUCAGGAGACCUGCCGUCGGGCGCAUCCGCGCC,40,20,77,72,209
960,3,AARF01000099.1/15166-14989,CUGAUAAAAAUUGAAUAGAAAACUGGGUAGAGAUCAGGGAAAGAGGUGCGAUUCCUCUACAGGCCCUAGCUACUGUGAAGCGGACGAAAUCCCCUUGAUGUCACUGGAACAUUUCCGGGAAGGCGGGAAACUAGAAUGAUGCAAAGUCAGGAGACCUCCUCUAUUCAGCCUAUGCAGC,56,37,47,38,178
961,3,CP000151.1/1842062-1841871,UACGGCCGUUCGUUCGCCGGUGCCCCUCGGGGCCGAAGAGGGAACACAGGGCGCGCCACGCGCCGCUGUGGCUGCCCCCGCAACUGUAGACAGCGAGCCGAUCUCCCCCUCAUGCCACUGGUUCCACCGGGAAGGCCGGGAGCCGGCGCCGACCUGUCAGCCAGGAGACCUGCCGGCCUGAAAGUGCGUGCG,30,25,66,71,192
962,3,CP000250.1/820695-820904,CUCCUAUCGAACCGUUCAGGUGUGCCGGGAGUCUCCCGGCACAGGGAAGCCGGUCCGGGCGCCUCAGGCGGUGCCCCAAGCCGGCGCUGCGCCCGCAACUGUAGGCGGCGAGCGAUCCUUCAUCAUGCCACUGCGCCGAUCGGGCGCGGGAAGGCGAGGGAUUGCGACGACCCGCGAGCCAGGAGACCGGCCUGAGCCACGUCAUCUUCC,34,29,73,74,210
963,3,AM420293.1/5303093-5303317,GCCGAGAGCCGCGACCGCGGCGGUCGAGGCAAGAGGGAACCCGGUGCGAAUCCGGGACUGCCCCGCAGCGGUGAGCGGGAACGAACGCCGUCCCCGGUCCGAGGAGACCGGGAACAGCACUGGACCACAGCGUCUGGGAAGCGACGGCCAGUAGGAACACCCGGCCACGACGAGGCCGGGAAGCGCCCGCGAGUCCGAAGACCUGCCACCGGUGCGUGCACACCC,48,15,84,78,225
964,3,CP000283.1/2565817-2565609,AGAAUACUCGCCUGUCACGGUCUUUCGAGUCGUAUGUGCACGCGAUCCGAGAGCUAAGAGGGAAGCCGGUGCAAAGCCGGCGCUGCCCCCGCAACUGUAAGCGGCGAGCUGACGUCCGAUAGUCGCCACUGGGCCCAUUGGACCCGGGAAGGCAGGACUGACGCUAAGACCCGCGAGCCAGGAGACCUACCGCGACAGUCGCAAUCGUC,47,31,66,65,209
965,3,CP000379.1/1074555-1074362,UUACCCUUGCGCGCUGAUGGUUCCCGGAGACGGGAUCAAAAGGGAACGCAGGUGAGGCAACGCCUCGAAGCUGCGGCUGCCCCCGCAACUGUGAGCGGCGAAUCCGUGCCACCGCAUGCCACUGGGAAACCGGGAAGGCCCGCACGGACGACGACCCGCGAGCCAGGAGACCUGCCAUCGACCCGAGGUCCAGC,42,22,64,66,194
966,3,AP006841.1/2882136-2881925,UUAUCUUUGUCCCGAAUUGGUUUCGAAUGAAGACUUUCGUCAUUCGGAUUAAAAGGGAAUCGGGUGUAAAUCCCGGACAGUCCCGCUGCUGUGAAGCUUCAUCGAUAUCUUGAAACAAUCCUUUCGCCACUGACGUGGGGGGAAUACCUCCGUCGGGAAGGCUUCAAGAUUAGAAGUCAGUCAGAAGACCUGCCGUUCAUCAAAGGCUGUUU,53,59,53,47,212
967,3,CP000463.1/3487953-3488157,ACUAAAUGUUGCUGUCACGGUCUCUCGAAUCGCUUGAUCGAGAGCUAAGAGGGAAUCCGGUGUGGCGAAAGCCGAAGCCGGAGCUGCCCCCGCAACUGUAAGCGGCGAGCCGACGUCACCGAGUGCCACUGGGAGCAAUCCCGGGAAGGCCGACGAAGGCAUUGACCCGCGAGCCAGGAGACCUGCCGCGACAACGACUACGUCC,49,29,65,62,205
968,3,CP000716.1/1854993-1855172,AAUAACCAAUGGAAUAAAGGUGCCUUAAAGGCUUAAUAGGGAAGCUGGUGAAAAUCCAGCGCGGCCCCGCCACCGUAACUGGGGACGAAAGUCGCAAAGUGCCACUGGGAUUUCCUGGGAAGGUGCGACGAGUAGGUUGAUCCAGAAGCCGGGAGACCUGCCUUUGUUCCAAAGUGUUUC,50,36,54,40,180
969,3,CP000662.1/491640-491462,GUCUCAGCUACUGCGUCAGGUGCCGCCCGCGGGCGGAGAAUCGGGAAGCCGGUGCGACUCCGGCGCGGGCCCGCCGCUGUGACGGGGAUGCUUCGGGCAGGAUGCCACCGGUUCGCCGGGAAGGCGCCCGGGGCAGGUGAACCGGAGCCAGAAGACCGGCCUGACAAAGAGGUUCCUGC,29,22,72,56,179
970,3,BA000012.4/6749128-6749334,CUACGGUGGGUGCGUGAUGGUCCCCGCGCCGAAAGGCAAGGGGUGAAAAGGGAACACGGUGAGACCUCAAAAGGUCGAGACCGUGGCUGCCCCCGCAACUGUAAGCGGAGAGCAAGAUCCGACAUGCCACUGGCCGGCAAGGCUGGGAAGGCAGGAUUGCGCUGAGACCCGCGAGCCAGGAGACCUGCCAUCACUGAGUUGACCGGA,51,26,74,56,207
971,3,CP000075.1/3709306-3709505,UUUACCAUGCCGCGCGUCGGUUUCCGAGAGGAACUAACAGGGAAUUCGCACGCCUUUCUCACCAGGCGAAAAACGAAACUGCCCCCGCAACUGUAGGCACCGAGCCUGCUCCAUGACUGCCACUGGAUCGUGAUCCGGGAAGGCCGGAGCCUGGCGAUGACGUGUCAGUCAGGAGACCUGCCGACCCGCUUCAACCCACU,45,35,54,66,200
972,3,AP006841.1/3073837-3073630,UAUAUUUGUCGGCAGAUUGGUUCGCCGAAGCUUUCCUGCUUUGGGCGAUUAAAAGGGAAUCGGGUGUAACUCCCGGACAGUCCCGCUGCUGUGAAGCUUUAUUAUAAACAUUCCGAUAGGAUACUCUUUGGCCACUGACUCGUGUAGUCGGGAAGGCGUUCGGAAUGGAAGCUAAGUCAGAAGACCUGCCACUCUCGCUGAUAAGUCU,48,58,56,46,208
973,3,CP000264.1/2259475-2259261,UGAAAUCAAACUGGUGAUGGUGUUUCGACAUCCAAGACGAUGUCGGACUGAAAAGGGAAUACGGUGAGGACGCGCCUUAGGGCACCAAAUCCGUAACUGCCCCCGCAACUGUAAGCGGUAAGCGACGCCAAAUAUGCCACUGGGACAGCUCCCGGGAAGGUUGGCCAAGCGUUGAUCCGCAAGUCAGGAGACCUGCCAUCAGGUGUUGAAACAUU,60,40,62,53,215
974,3,BA000030.3/2496008-2496226,AGGCUGGGUGGUGCAGCUGGUUCGCCCCGUCCGCCAGGCGGGAGGCGUCGUAAGAGGGAACCCGGCGGGAAUCCGGGACUGCCCCGCAGCGGUGAGUGGGAACGAACGCUGUCAUACGCACUGGGCCCAAAAGGCCCGGGAAGCGACGGCCAGUAGGUGUCCUCCGUACGGAGGGCGUGCUCGCGAGUCCGAAGACCUGCCCGCUGCCCGUGCGCGACC,37,28,85,69,219
975,3,CP000139.1/3926628-3926422,UUAUCUUUGCCCCGAAUUGGUUUCGGAUAGUCUAUCUGCUAUUCGGAUUAAAAGGGAAUCGGGUGCAAAUCCCGGACAGUCCCGCUGCUGUGAAACUCUGCUGGAAUCUUGAAAAAUACCUUUGCCACUGAUGUGACAAUCCUCACAUCGGGAAGGCUUCAAGAUAAGGAGUCAGUCAGAAGACCUGCCAUUCAUUAAAGGCUGUUU,55,58,48,46,207
976,3,CP000661.1/1410118-1410316,CUAUUGAGAAACGGCUUCGGUUCCGGCGUCAUGCCGGAUGAAAAGGGAACGCGGUGAGGGGUGCCCCUCCAAAUCCGCGGCUGCCCCCGCAACUGUAGGCGGCGAGCGACGACCGAUCACGCCACUGGGGUUCCCCGGGAAGGCCGGUCCGAGCGAAGACCCGCGAGUCAGGAGACCUGCCGGAGCGAUCACCCUUUCC,39,28,67,65,199
977,3,AP006841.1/4035424-4035643,UAUAUUUGUCGCCGAAUUGGUUCGGAAUCCGUGGUCAACGGACGAAGAUUAAAAGGGAAUCGGGUGUAAAUCCCGGACAGUCCCGCUGCUGUGAAACUCUGUAUAGCAUCUUAUCAAUCAGCCAAUUUCGUACCACUGACAGAAAAAGCAAACUCUGUCGGGAAGGUCCCGGUAAGAUGUAGAGUCAGUCAGAAGACCUGCCAUUCGUGAAUAAGAGCAU,66,52,55,47,220
978,3,AAMD01000084.1/10237-10455,UAUCCCCGGCCUGUCCUCGGCGCGUCCAUGAAGUCAUGGACGCUCAAGGGAACCCGGUGUGAUUCCGGGACUGCCCCGCAGCGGUGAACAGGAACGACCGCCGUCCACGCAAGCACUGGCCCCUCCCGGGGCUGGGAAGCGACAGCCAGUAGAAGGAGGAUUCCCCCGAACCCUCCGCGCCUGUGAGUCCGAAGACCUGCCGAGGUCCCGUGCCCCGCA,41,30,68,80,219
979,3,AE014291.4/1309296-1309068,UCGCAAUUUUCAGGAGACGGUUCCGCCAUUGCGGCGGAUGAAAAGGGAACACGGUGAAGCCAUAGGGCUGAAACCGAGACUGCCCCCGCAACUGUAACCGGAGAGCUAUCCUCCACAGGCCGCGCAAGCGGCCAAAGCCACUGAAAGCAGCAAUAUGCUGCAAUCGGGAAGGCGGAGGCAAAGCGAAGACCCGGAAGUCAGGAGACCUGCCGUAUCCGGUCACCCAUGC,64,30,69,66,229
980,3,CP000489.1/2543185-2543386,GCACAGACAUGGGGCGCUGGUUCCUGUCCUAUGACAGGCUAAGAGGGAAUGCGACAGGCAACCGCCUGAAAGCAGCCGCCCCCGCGACCGUGACCGGAAAGGUCGCCCCUCUGCCACUGGCGAAAGCCGGGAAGGCGGGGCGGCCGUGGGCCCAGGCCCGAAUCCGCAAGCCGGGAGACCUGCCGGUGCAGAAGGAUUGACC,43,22,72,65,202
981,3,CP000115.1/2411796-2412010,CCCAAACAGAUCGGCGACGGUUCUCCCUUGGGAGAUCAAAAGGGAACGUGGUGCGGGAUCAUCCUAACACCGGGAUCAUUCCAACGCCACGGCUGCCCCCGCAACUGUAAGCGGCGAAUCUGCGUCACACGCCACUGGGACAUCUCGGCCCCGGGAAGGCGACGUCAGGUAACGACCCGCGAGCCAGGAGACCUGCCGUCAACCCGUGGUCACAC,50,30,62,73,215
982,3,CP000489.1/2539767-2539972,GUAACAUAUGCGUGUAUCGGUGCCCCUUUCGGGGCCAAAAGGGAAUGCGGUGCCGUCUCCGGCGUCUUGGGGACCAAAUCCGCAGCCGCCCCCGCGACUGUAGGCGGAGAGCGGACGCCCAUCGUGCCACUGGCCAUCCGGCCGGGAAGGCGGGCGUCAGCCGUGACCCGCGAGCCAGGAGACCUGCCGAUGCGUGAAACCGCAAU,38,30,71,67,206
983,3,AAXF02000050.1/365024-364813,UAUCUUUGCCCCUGAAUUGGUUUCAGAUAGCCAUAUCAACUAUCUGAAUUAAAAGGGAAUCGGGUGUAAAUCCCGGACAGUCCCGCUGCUGUGAAACUCUAUUCAACUUCUUGAUAUUUACUUUUACCACUGACCGGGUAUAGAUAGUCAAGGUCGGGAAGGAAUCAGGAAGGGAGUCAGUCAGAAGACCUGCCAUUCAUACCUUUAUAGCU,60,61,46,45,212
984,3,CP000230.1/1501900-1501675,UACCGUAUUUAGCGUUACGGUUCCUUGGGUAUGCAAUAUCUAGGGUGAAGAGGGAAGACGGUGCGCCCUUGAAGGGCAAUGCCGGCGCUGCCCCCGCAACUGUGAGCGGCGAGCCCGCGUCCAAGACUGCCACUGGUGCGCCGGUCCUUCGGAACCGGCCCCGGGAAGGCCGGACGGGGGCUGUGACCCGCAAGCCAGGAGACCUGCCGUAAUGGCCGCAACGUCC,42,37,78,69,226
985,3,CP000283.1/727646-727425,GAUAGCGUGGCCGGCGAUGGUCCUUCCGCCAGGAAGGUGAAAAGGGAAUCCGGUGCAAGUGAACUCUGUUCGAGUGAUCUCAAUCCCGGUGCUGCCCCCGCAACUGUAAGCGACGAGCCCGCGCCUCGGCCACUGGGAUUUCCUGCUUGGAAAUUCUGGGAAGGCGGCGACAAGGGCGAUGACUCGCGAGCCAGGAGACCUGCCAUCAUGAAUGGUGCUUUG,46,43,73,60,222
986,3,CP000144.1/239679-239466,GUCACGCCGGGCUAUGACGGUUCCCGAACGCCGCAAGGUCAAGGGAUGAAAAGGGAACGCGGUGAGGGGUGCUGACCCCAGUUCCGCGACUGCCCCCGCAACUGUGAGCGGCGAGCCCGCCCCGAAGACGCCACUGGACCGAAAGGGCCCGGGAAGGUUCGGGGAAGGCCGCGACCCGCGAGUCAGGAGACCUGCCGUCGAGCGCGCAAGCGCC,44,21,79,70,214
987,3,CP000301.1/3914520-3914312,GCUACAUGUAGAUGUCACGGUCCCUCGAAUCGCAAGAUCGGGGGCUAAGAGGGAAGCCGGUGCGGCGCGAGCCAAAGCCGGAGCUGCCCCCGCAACUGUAAGCGGUGAGCCGACGUCCAGCCUUUGUCACUGAGGCCGAAAGCCUCGGGAAGACGGACCGAAGCGACGAUCCGCGAGCCAGGAGACCUGCCGCGACAACAGAACGUCUU,50,27,69,63,209
988,3,CP000482.1/1298216-1298027,AGUUUCAUACCGGAUCACGGUGCCCGCAAGGGCUUGAUAGGGAAGAUGGGUGAGCUCCAAAGAGCGAUUCCCCCGCGGACCCGCCGCUGUAAGCGAUGACGAAGGGCACACCGCCACUGGUUUUUGACUGGGAAGGCGCCCGGAGAAUGACUCGCGAGCCAGAAAACCUGCCUGAUCCCAAACACUCGGA,47,30,58,55,190
989,3,CP000661.1/1554899-1555094,CACCACUGCCGCCGCGCUGGUUCCUGUCCGCAAGCGACAGGCGAAGAGGGAAUGCCCCAGAGGCAGCCGCCCCCGCGACCGUGACCGGAGAGGUUGUCCAUGCCACUGGCCGAAAGGCCGGGAAGGCGGACCGCCGCGGGACCGCAAGGCCCCACAUCCGCAAGCCGGGAGACCUGCCAGCGCUGAGACUUACGGG,39,18,68,71,196
990,3,CP000481.1/1939207-1939426,UAGGCUGAGCCCGCAGCUGGUUCGGCCGCAGGCGAUGCAGCCGAGCUAACAGGGAACCCGGUGCGAAUCCGGGACUGCCCCGCAGCGGUGAGUGGGAACGACCGCCGUCAACGGCACUGGGCGACAGCCUGGGAAGCGACGGCCAGUAGGCAACGGUGACCGGCCGCUCCGGCGCCGCCGCCCACAAGUCCGAAGACCUGCCAGCUGCACACCGCCGAUG,43,22,78,77,220
991,3,CP000759.1/1328776-1328542,ACGUAAUAGUGUAACGACGGUUCCCCGACCGAGAGCGAAGGGGAUUAAUAGGGAACACGGUGAGGACGACCCGAAAAGGGGCCAAGACCGUGGCUGCCCCCGCAACUGUAAGCGGAUUGCCGUUCAUCCUCGUGACGUUGAAAGCGUCAUGCCACUGUGCCGGAGAAGCGCGGGAAGGCAGAUGAACAGCAGAUAUUCGUGAGCCAGGAGACCUGCCGUUUAGUGUUGUCCAUUG,60,42,76,57,235
992,3,ABCF01000035.1/16750-16938,UGCAAUGCCGGUAAAUAUGGUGUCUAUAUAGACAAAAUAGGGAAUCUGGUGAAAGUCCAGAACUGUCCCCCGCAACUGUAAGUGCUGACGAAAUAAGCGUUGACCACUGCCUCUGAAUAUAGAGGCGGGAAGGGCUUAAAGUAGGAAGAAGCACAAGUCAGGAGACCUGCCAUAUUUAUAGCGUCUUAU,61,43,49,36,189
993,3,AAVM02000011.1/57485-57690,UAUCUUUGCCGCCGAAAUGGUUCGGAAUCCGUAGCCAACGGACGACGAUUAAUAGGGAAUCGGGUGCAAAUCCCGAACAGUCCCGCUGCUGUGAAGCUCAGUUCAAUGUCUUAUAAAUGAACUAAUUUGACGCCACUGAUGUUCUAUCGGGAAGGCAAAUAAGACAAGAGUCAGUCAGAAGACCUGCCACUUCACGUAAAACGUUC,62,48,48,48,206
994,3,AALV01000001.1/473478-473696,CAAUGCAGGGCGUAUGUUGGUUCCUGUCCCAGACAGGCGAAGAGGGAACGCGAUACGCAUUGAUCCAGCCUUGGGUCAGCGCCAAGCGCAGCCGCCCCCGCGACCGUGACCGGAGAGAGCUUUCAACCACUGGCCCGCAGGCUGGGAAGGUGAAGGUUCGCAAGGCAAGCUGCCUUAGAUCCGCAAGCCGGGAGACCUGCCAGCAUAGUUUGUAACGGG,49,35,72,63,219
995,3,AALV01000001.1/486810-487026,UGACCACCUAUUCCGGACGGUUCCCCGUGCGCCUUCGGGCAAUCGGGGUGAAAAGGGAAUACGGUGCGGUGCCAAAGCAAAGGUGCCAAAUCCGGAACUGCCCCCGCACCUGUAAGUGAAGAGCAACCCGCAUUGCCACUGGGCCACACCGCCUGGGAAGGCGCGGCACGCAUGGACGCACAAAGUCAGGAGACCUGCCGUCAUGGGGAUGAUCCCC,51,31,67,68,217
996,3,BA000040.2/3617290-3617510,AAAUGGUGGCCCGGCGUUGGUUCCUGUCCUAUGACAGGCGAAGAGGGAAUGCGAUAGGGUCCGAAUCGGCAAGAUUUGGGUCCAAAAUGCAGCCGCCCCCGCGACCGUGACCGGAGAGAUGCCCGAGGCCACUGAUCCCUGACGGGAUCGGGAAGGCGGGGAUCGAAGGGCAAAACCCUGCUCCGCAAGCCGGGAGACCUGCCAGCGCGGACGAUUUUGGA,50,33,78,60,221
997,3,CP000140.1/4143906-4143709,UACCUUUGCAUCCGAAUUGGUUCCGUACGCUCGUUCGGGCAUACGGAUUAAAAGGGAAUCCGGUGAGAAUCCGGUACAGUCCCGCUGCUGUGAAACUCCUUUAACAUUCUAAUACUACUUUCGCCACUGGCCUAGUAAGCCGGGAAGGCAUUAGAAUGGGAGUCAGUCAGAAGACCUGCCAUUCAUUUAAGAUUCAUA,52,53,46,47,198
998,3,AM420293.1/6681388-6681576,UCGCCCUGUUGCGGAGAGUGUUCGCAGCAUUCGAGCGGCGACAGGUGGAGGAAGCCGGUGCGAGUCCGGCGCGGUCCCGCCACUGUCACCGGGGAGCGGACUCCAACGACGUCACUGCCCUGCGGGGCGGGAAGGCGGAGCGAGCGCUGAUCCGGGAGCCAGGAGACUCCGGUCGCCGCGACCUACGAC,31,24,74,60,189
999,3,CP000301.1/3909916-3909716,UACAAUAUAUAGUGUUACGGUCUCCACAUGUUACAUCAUGUGGGGCUAAGAGGGAAGCCGGUGUGAAUCCGGAGCUGCCCCCGCAACUGUCAGCGGCGAGCCGCCGUCCAGCGAUAUCACUGAUGCCGCAAGGUGUUGGGAAGAUUGGACGGAAGCUGUGACCCGUGAGCCAGGAGACCUGCCGUAGCAACGUGAAACGUC,48,39,63,51,201
1000,3,CP000283.1/714109-714317,CUUCUAUCGGCAUGUUCAGGUGUGCCGGAGUCUUCCGGCACAGGGAAGCCGGUCCGGGCGCCUUUGGCGGCGCCUCAAGCCGGCGCUGCGCCCGCAACUGUAGGCGGCGAGCGAUCCUUCAUCAUGCCACUGGGCCCGUCGGGUUCGGGAAGGCGGAGGAUUGCGACGACCCGCAAGUCAGGAGACCGGCCUGAGCCACGUCAUCUUCC,32,37,72,68,209
1001,3,AAMD01000003.1/111144-110935,AUGAGAUGUGCUUCGGCACGUUCUUGAUGACGCAGUAGUCUUAAAAGGGAACCCGGUGUGAAUCCGGGGCUGCCCCGCAGCGGUAAGCGAGAACGACCUCCACGACGAGCACUGGUCCCUUCCGGGACUGGGAAGCGGUGGACAGUAGGAACCCGGCGCAAGCCGGAGUGCUCGUGAGCCCGAAGACCUGCCCGCACCUGACGUUGGAGA,46,34,71,59,210
1002,3,AAYA01000006.1/294690-294473,CGCAUCAGCCGGAGUGCUGGUGCCUGUGUCUAGCAGGUGAAAAGGGAAUGCGCAGCCCCGCGUCGGGGUCAGGCGCAGCCGCCCCCGCGACCGUGACCGGAAAGGGCCCGAAGCCACUGGCGACAUCGCCGGGAAGGCCGGGUUCCGUUGGGAUCGGCAGGACUGCCUGCCGCCCAGUUCCGCAAGCCGGGAGACCUGCCAGUGGCCGCGCCGUGGAA,37,27,82,72,218
1003,3,AAKX01000098.1/49369-49176,UUACCCUUGCGCGCUGAUGGUUCCCGGAGACGGGAUCAAAAGGGAACGCAGGCGAGGCAACGCCUCGAAGCUGCGGCUGCCCCCGCAACUGUGAGCGGCGAAUCCGUGCCACCGCAUGCCACUGGGAAACCGGGAAGGCCCGCACGGACGACGACCCGCGAGCCAGGAGACCUGCCAUCGACCCGAGGUCCAGC,42,21,64,67,194
1004,3,AAKL01000016.1/79085-78906,AUCCCGCCUCACGAUGAUGGUGCCCUUCCAGGGUGAAACGGGAACGCGGUGCGAUGCCGCGGCUGCCCCCGCAACUGUAAGCGACGAGCCAGCGCCAACCAGCCACCGCACCAUGACGGGAAGGCGGCGCCGGGCGAUGAUGCGCGAGCCAGGAGACCGGCCAUCUCCUUUUGUCGACGU,35,24,59,62,180
1005,3,AE017283.1/2294565-2294765,AUAGUGACGAAUGCACGUGGUUCCCGUGUUCGCACGGGCCAAGAGGGAAUCCGGUGUGAAUCCGGAGCUGCCCCGCAGCGGUAUAUGAGAACGACCGCCGUCAUGACGCACUGUGCUUUGGCAUGGGAAGCGACGGCUAGUAGGAGUCCGAUCAGGACGAGCUCAUGAGCCCGAAGACCUGCCAGGUGUGGUCCCGCAACC,44,35,67,55,201
1006,3,AM039952.1/3802147-3801923,UACCAUGCGCGCCCCUGAGGUGACUGCCGGUUGGCCGGUGGUUUAAACGGGAAUCCGGUGCGCGCGUCGCCUUGGGCCAGGCGCAAUUCCGGAGCUGCCCCCGCAACGGUGGGCGAGGCCAGGUGCCGCAACAUGCCACUGUGCAGCCGCAUGGGAAGGCGCGGCAUCGGAAGCACCAGCUUCCACUCGCGAGCCCGGAGACCGGCCUGAGGGAUUGACCCGGCA,38,32,81,74,225
1007,3,CP000143.1/2531295-2531502,ACGGAAGGUGCGGGCGACGGUUCCCGGAGGAAGCUCCGGGCGAAGAGGGAAUGCGGUGCGGGCCUGACAGGCCCCAAGCCGCGACUGCCCCCGCAACUGUAGGCGGCGAGCGCGUCCCAUCAUGCCCACUGGCCCAGGACAGGCCGGGAAGGGCGGGACAAGCCCAGACCCGCGAGUCAGGAGACCUGCCGUCGACGGACCUGUAACA,43,19,78,68,208
1008,3,CP000490.1/1566394-1566586,GCUAACUGCAACGGUCAUGGUUGUCCCGGGGCCGACUCGGGGAUGAAAAGGGAAGCCGGUGAAAAGCCGGCACUGCCCCCGCAGCUGUAAGCGGAGAGCGACGCCGGAUCACCACUGGGGCCACGCGCCCCGGGAAGGCCGGCCAAGCCGAGACCCGCAAGUCAGAAGACCUGCCAUGACGCGAAAGGACGAA,48,18,67,60,193
1009,3,CP000441.1/778547-778740,UUACGCUUGCGCGCUGAUGGUUCCCGGGAACGGGAUCAAAAGGGAACGCAGGAGAGGCAGCGCCUCGAAUCUGCGGCUGCCCCCGCAACUGUAAGCGGCGAAUCCGCGCCACCACACGCCACUGGGAAACCGGGAAGGCCGGCGCGAAUAACGACCCGCGAGCCAGGAGACCUGCCAUCGACCCGAGGUCCAAG,46,21,63,64,194
1010,3,CP000774.1/668593-668795,UAGCAUCCGCCCCGCAAUGGUUCCGAAGGCGAAUAGCCGGAGGAUGAAAAGGGAACCCGGUUAAAUACCGGGGCUGCCCCCGCAACUGUAAGCAGAGAGUUCUGCCCAACCACGCCACUGGCGCUCCACCUCGGAGGCCGGGAAGGCUGGGAAAGAACAGUGACCUGCGAGCCAGGAGACCUGCCAUUGCCCGUCAACGCGAA,52,26,62,63,203
1011,3,CP000463.1/2461809-2461608,ACAUACUCUGGUGCCGAUGGUUCCCAAAAUAUGGGAUGAAAAGGGAAUCCGGAGCGUUGCCCGAGAUGGGCCGCGACACCGGAGCUGCCCCCGCAACUGUGACCGGAGAGCCGCCACCAAAUGCCACUGGAUUUCGAUCCGGGAAGGCGGUGCCGGCUGUGACCCGCGAGCCAGGAGACCUGCCAUCGCCUGUGACUGACGC,44,31,65,62,202
1012,3,CP000325.1/2461077-2460867,UUGUCGGCAUCAAGCGGCGGAGGCUUUCGCAGCUUCGUCGUGAGAGGGAACCCGGUGGGAAUCCGGGACUGUCCCGCAGCGGUAUGCAGGAACGAACACCGUCAUCGGCACUGGCCCCACAGCCUGGGACUGGGAAGCGACGGUUAGUAGGAGCACCAUCGUCGGUGCGGGCCUGCGAGUCCGAAGACCUGCCAGUUGCGCCGGGCACGUU,39,35,76,61,211
1013,3,CP000377.1/3101368-3101583,CCGCAUGAGAGGGGCGAUGGUUCCCCGACGCCUAAGGCCGGUGGGAUGAAAAGGGAAUUCGGUGCGGAGGAGCCAAAGGGCGCCAAAUCCGAAACUGCCCCCGCAACUGUAAGCGGCGAGCGCCCCGUCACAGCCCACUGAUCCUCAUGGAUCGGGAAGGGAGGGACGCGCAAUAACCCGCAAGUCAGGAGACCUGCCAUCGCGACUUUUUAACCA,54,29,69,64,216
1014,3,CP000494.1/3290341-3290534,CGUAUCUAACAGGAUGACGGUUCUCCGAAAGGAGAGAUUUAGGGAACACGGUGCGGGUUCUGAACCCAAGGCCGUGGCUGCCCCCGCAACUGUAAUCGGCGAGUGUGAGGCCAAGACACCACUGGGAAACCGGGAAGGUGGUUUCACGCAGCGACCCGAGAGCCAGGAGACCUGCCGUCGACAUUGCUGUUGGC,46,33,64,51,194
1015,3,AE016958.1/2995864-2996105,AUCGAGCGAAGCAACGUUAGUAACGCUUCGUAAGAGGGAACCCGGUGAGAAUCCGGGACUGUCCCGCAACGGUAUGCAGGAACGACCGCCGUCACCAGCACUGGUCGCAAGACUGGGAAGCGACGGCCACUAGGAACUGCCCGGCUCCUCGGCGGCCCUUCGGGACCGCAUCGUCGGCCGGGCACGCACCACCCGGUGCGCGCCUGCGAGUCCGGAGACCUGCCAGCUGUGCCGGGCGCGCC,47,31,81,83,242
1016,3,CP000577.1/1528291-1528485,CACCACUUCCGGCGCGCUGGUUCCUGUCCGACCGGACAGGCGAAGAGGGAAUGCCCCAGAGGCAGCCGCCCCCGCGACCGUGACCGGAGAGGUUGCCCAAGCCACUGGCCGCAAGGCCGGGAAGGCGGGCCGCCGCGGAGCCGCAAGGCCCCACAUCCGCAAGCCGGGAGACCUGCCAGCGCUGAGACUGACGGG,37,16,70,72,195
1017,3,BA000043.1/935017-935212,AUCGUUGCGCCAAGCAAUGGUGUCCAUCAGGACUUAAUAGGGAAUCCGGUGUGAAUCCGGAACUGCCCCCGCAACUGUAUGUGCGGACGAAAUGGGAUGGCCACUGGCGGCAAGAGCCAUUCGGCGCGCCGCUGGGAAGGCCCCAAAGUAGGACGAUGCACGAGUCAGGAGACCUGCCUUGCUUGGAACGUUUCAU,46,37,62,51,196
1018,3,CP000758.1/1918958-1919182,UCGCAAUUCUCAGGAAACGGUUCCGCUGUUCAGGCGGAUGAAAAGGGAACACGGUGAAGCCAUCCUGGUUGAUGCCGCGACUGCCCCCGCAACUGUAACCGGAGAGCUAUCCUCCACAGCCGUGCAAGCGGUAAAAGCCACUGAGAGCAGUCGAUGCACUCGGGAAGGCGGAGGGAAAGCGACGACCCGGAAGUCAGGAGACCUGCCGUAUCCGGUCACCCAUGC,57,34,69,65,225
1019,3,BA000012.4/1149122-1149327,CCUAAAUCCGCUCCAGACGGUCCCUUGCCCGCAACGGCAGGGGCUAAGAGGGAAUGCGGUGCGGGAUUUCGAUCUCAAAUCCGCGGCUGUCCCCGCAACUGUAAGCGAAGAGCCAAGGCCGAAAGCCACUGGGACGUUCCCGGGAAGGCGGCACCCAAGGCGAUGACCCGCGAGCCAGGAGACCUGCCGUCUGCGACAAAAGAAUC,50,27,64,65,206
1020,3,CP000301.1/4742649-4742447,UCUUUUCAGGCCGUCUUCGGUGCCUCUGGUAACAGAGGUGAAACUGGGAAUGCGGUGCGGCGAGAAAUCGCCAAUGCCGCGGCUGCCCCCGCAACUGUAGGCGGACUGUGCCCGAUCGAUAAGCCACUGAUGCCGUGCAUCGGGAAGGCGAUCGGGGACCAUGUCCGUGAGCCAGGAGACCGGCCGAAGACGCUGGUCCAACU,41,36,68,58,203
1021,3,CP000230.1/1340533-1340749,GGCUAGCCUGCGGCUGACGGUUCCCCCCAAGCGCAAGCCGAAGGGAUUAAAAGGGAACACGGUGCAGGCGAAGGAUUUGUCCGAAACCGUGGCUGCCCCCGCAACUGUGAGCGGCGAGCCUUCCUCCGAUGAAAACCACUGGGGCGCGUGCCUUGGGAAGGGGGAUGAAGGCGAUGACCCGUGAGCCAGGAGACCUGCCGUCCGACCCUAAUCCAUG,48,32,73,64,217
1022,3,BA000012.4/1101095-1100897,UAUAGUCAUGCAGUCGUCGGUUCCGUUUUGGAGCCAAGAGGGAAUGCGGUGCGGGCGAAAUUCUUGCCCAAUGCCGUGGCUGCCCCCGCAACUGUGUGCGGUAGUCCUCUCCAUAUGCCACUGAAGAUUCGUCUUCGGGAAGGUGGGGAAGGGCGCUGAUCCGUGAGCCAGGAGACCUGCCGACGACGGCAAAACUGAC,40,42,65,52,199
1023,3,AE015927.1/745345-745529,UGAAUAUGAAAAUAUUCAGGUGCCAUUUUAGGUUUAAAAGGGAAUGUGGUUUAAUUCCACAGCAGCCCCCGCUACUGUAAUUGAGGACGAAUCUUUCACAAACCACUCUUUCAAAAAGGGAAGGGGAAGGGAAAGACAAGGGUGAAUCAUGAGCCAGGAGACCUGCCUGUAUAUGAAAGAUAAAC,65,43,45,32,185
1024,3,AAXE02000001.1/18090-18297,UAAUUUUGUCUUCGGAUCGGUUUCGUAUGAUUAAAUCAGAUGAUACGGAUUAAAAGGGAAUCGGGUGAAAAUCCCGGACAGUCCCGCUGCUGUGAAGCUCCGUUUCAACAUCCUGAAAACUACUUUUGCCACUGGUUUAUGGUUAUAAACCGGGAAGGCUUCGGGAUGGGAGUCAGUCAGAAGACCUGCCGUUCAUUAAAGGCUAUUC,55,60,52,41,208
1025,3,AAKV01000038.1/3066-2875,GUAGCCUUGCCGGUUCGAGGUUCCUCGCCGGCGACGGCGGGGCUAAGAGGGAACGCGGUCGAUGCCGCGGCUGCCCCCGCAACUGUGAACGGCGAUCGUUCCCCAAUGCCACUGCGUGACGCGGGAAGGCGGGGAACCGGCGGAGACGCCAGACCGUGAGCCAGGAGACCUGCCUCGUCGAUCCCGUGGCGC,31,26,72,63,192
1026,3,AAMD01000003.1/140975-140765,UAUAGACGCGCCUGUGCUGGUGUCUGGGCUCACGCCUGGACUUAAAAGGGAACCCGGUGUGAUUCCGGGACUGCCCCGCAGCGGUAAGUGAGAACGAAUCUCGCCAUUGGCACUGGCUCCUCGGGGGCUGGGAAGCGGCGAGCCGUAGGAAUCCGGCCCUGGGCCGGAGCGCUCACGAGUCCGAAGACCUGCCCGCAUCCACCCGUGGGGA,38,35,74,64,211
1027,3,CP000578.1/651773-651962,GCAUCGUCGGCUGGCCCUGGUUCCCGCGGCGAUCCCGCGGGCGAAGAGGGAAGCCGGUGCAAGUCCGGCGCUGCCCCCGCAACUGUGAGCGGCGAGCCAUCUGCCAUGCCACUGGCCCCCACGGGCCGGGAAGGGGCAGCCGGCGUCCGAGCCGCGAGCCAGGAGACCUGCCGGGCCUUGACGACCAUCC,28,21,70,71,190
1028,3,BA000040.2/3634102-3634304,AUCCUAGAUGCUCGCGACGGUUUCCCCCGAGAGGGGAUGAAAAGGGAAUGCGGUGCGGGGAUGUUUCCCCAAUGCCGCGGCUGCCCCCGCAACUGUAAGCGGAUAAUCCUUCGUCAGAAGCCACUGGGUCCUCGGUCCCGGGAAGGCGACGAAGUGGUGACGACCCGCGAGCCAGGAGACCUGCCGUCAGCCGUGGUCACACG,41,33,68,61,203
1029,3,CP000362.1/3701518-3701322,GAAAAUGCAGGGCACGAUGGUUGUUCCGGUUCAGGCCGGGACAUAAAAGGGAACGCGGUGAAAUGCCGUGGCUGCCCCCGCAACUGUAAGCGAAGAGUGCCUCUGUCGCACGCCACUGACCGAAAGACGGGUUGGGAAGGCAAAAGAGGCGCGCUGACCCGCGAGCCAGGAGACCUGCCAUCACAAACGCAACAUAA,55,26,63,53,197
1030,3,AAMY01000011.1/25797-25600,UCCAAACAGAUCGGCGACGGUUCUCCUUCGGGAGAUCAAAAGGGAACGUGGUGCGGAAUCAUCCCAACGCCACGGCUGCCCCCGCAACUGUAAGCGGUGAAUCUGCGUCAUACGCCACUGGGAUAUCUCGGCCCCGGGAAGGCGACGCCAGGUAACGACCCGCGAGCCAGGAGACCUGCCGUCAAACCGUGGUCACAC,47,29,58,64,198
1031,3,CP000490.1/155234-155429,CUACCAAGUCGCUGCAUCGGUUUCCGCAAGGAAUGAAAAGGGAAUCCAGCGCGCCCGAUGGGCGCGAAACGGAACUGCCCCCGCAACUGUAGGCGGCGAGCGCGAUCUGGCAGGCCACUGGGCACGAUGUCCGGGAAGGCAGGAUCCGCGCAACGACCCGCCAGUCAGGAGACCUGCCGGCGCGAAUUCACCAGAC,46,23,64,63,196
1032,3,AAUW01000003.1/68358-68148,AAACCUAGAUCGUGUGAUGGUUUCGCCCGAACAAGCGUAACGGCGGAUGAAAUGGGAACACGGUGAGGCGUACCCAACAGGGACCAAGACCGUGGCUGCCCCCGCAACUGUAAGCGAAGAGCAAAGCCCUUGAGCCACUGGAGCGAUCCGGGAAGGCGGGCUGCGCGGAGACUCGCGAGCCAGGAAACCUGCCAUCCAGCGGUCCCAUUGG,54,28,69,60,211
1033,3,AAYC01000003.1/275906-275694,CGCCUACCUGUUUUCGAUGGUUCCUCAGGGCAGAAUGCUGAGAGGAUGAAAAAGGGAACACGGUGAGGUGUAGCCAACAGGCGCUGAAUCCGUGACUGCCCCCGCAACUGUAAGCGGAUAGCGACGCCAAGCACCCACUGGCCGUAAGGCUGGGAAGGAUGGCGCAGCCAAGACCCGCAAGUCAGGAGACCUGCCAUCGUGAAUUCAACCAAG,57,33,65,58,213
1034,3,AANB01000001.1/641586-641368,GAGCAGUGACCUAUCGAUGGUUCCACUGAAGCCCAAGGCUUUUGGAUGAAAAGGGAAUCCGGUGAGGUGUAGCCAAAAGGCGCCAAACCCGGAACUGCCCCCGCAACUGUGAGCGGCGAGCCACUGGGAUAAGCCACUGAUCUGCACAGCAGGUCGGGAAGGCCCCAGACCGGCCCAGACCCGCAAGUCAGGAGACCUGCCCUCGUGAGUUGACCAUAG,56,32,67,64,219
1035,3,CP000656.1/4145754-4145933,UGUAUGGCUGGUCGACCCGACCGGCCCCGAUGAACAGGCAGGAAGCCGGUGUGAAUCCGGCGCGGUCCCGCCACUGUGACCGGGGAGCGAACCCCACGUCGACCACGGCCGAGAGGCUGGAAGGUCGGGGUGAGCGCUGAUCCGGGAGUCAGGAUACUGCUCUCGUCGGCCCUCUUGCUG,30,28,66,56,180
1036,3,CP000781.1/3651336-3651132,UUUAGUGCCCCUGUCGAAGGUCCCGUGGUCCCACACGGGCGCAAAAGGGAAUGCGGUGCGGGAGGUCUCUCCCAAUGCCGCGGCUGCCCCCGCAACUGUAAGCGGUGAGCCCCUGCCACAUGCCACUGUCGCCGCAAGGCGCCGGGAAGGCGGUGGGGGCGCUGAUCCGCGAGCCAGGAGACCUGCCUUCGACAAGGUCCGCGCC,34,30,71,70,205
1037,3,AM286415.1/2962117-2961936,UACUUAAAUACUGAAACAGGUAUGUCGUGGAUAACACGAUUGGGAAGGGGGUGUAAAUCCCCCGCAGCCCCCGCUGCUGUGAUGCUGACGAACCCGCUGAGACCACUGAUCCAUAGGAUUGGGAAGGUAGCGGGGGAGAGUGACGCUAAGCCAGAAGACCAGCCAAAUCAGUAAAGAGUUUC,53,34,54,41,182
1038,3,CU234118.1/5111792-5111599,CCGUAUCUAACAGAUGACGGUUCUCCGAAAGGAGAGAUUUAGGGAACACGGUGCGGGUCUUCGACCCCAAGCCGCGGCUGCCCCCGCAACUGUAAUCGGCGAGUGUGAGGCCAAGACACCACUGGGCAACCGGGAAGGUGGUCUCACGCAGCGACCCGAGAGCCAGGAGACCUGCCGUCGACAUUGCUGUUGGC,44,31,62,57,194
1039,3,CR555306.1/2373817-2374002,AGUAUUUAACCGUAUCGAGGUGCCCGCGCUCGCGCGGGAGAAUCGGGAAGGCGGUGCGAUUCCGCCACGUGCCCAGCGCCGUGAUGAGGAUCGUCCGGGCAGGCGUCAGCCACUGGCGAAAGCCGGGAAGGCGCCCGGACGAGUCGAGCCUCAGUCGGAAGACCGGCCUCGAGACAUAUUGGCAGC,37,26,68,55,186
1040,3,CP000781.1/4182310-4182509,UAUAGUCGUCCCGUCGUCGGUGUUCGCUUUCGGGCGGACCAAGAGGGAAUGCGGUGCGGGAGUUUCUCCCAAAGCCGCGGCUGCCCCCGCAACUGUCGGCGGUGAGCGGGCCUGCAACAUGCCACUGGAGCAAUCCGGGAAGGCGCAGGCUUCGCAAUGACCCGCGAGCCAGGAGACCUGCCGGCGACAUCCUGCCCGUU,34,34,68,64,200
1041,3,CP000490.1/163550-163337,CCUAUAUGUAGGCAUCACGGUUCUUUCGGGUCGAUCCGACCCGAAAGCGAAGAGGGAAGCCGGUGCGCCUUUCGGGGCAAGGCCGGCGCUGCCCCCGCAACUGUAAGCAGCGAGCCUGCGCCGGAUCACGCCACUGGUGCCGCACGGCAUUGGGAAGGCCGGCAAGGGCAGCGACCUGCGAGCCAGGAGACCUGCCGUGAUGAUGACGAUGAAC,44,31,74,65,214
1042,3,CP000680.1/4136427-4136223,AGUAAGGUUGCCGCCGAUGGUUCCGCCGCCUCUGGCGCGCGGAUGAAAAGGGAACAGGGUGCGGCGCCGCGUCGCCAAUGCCCUGGCUGCCCCCGCAACUGUAAACGGCGUACGACGCUCCCUAUGCCACUGGCCGCCAGGCCGGGAAGGCGAGCGAAGUGGCAAGCCGUGAGCCAGGAGACCUGCCAUCGGCAAACGGGCGUUU,39,28,72,66,205
1043,3,CP000031.1/3058882-3059105,CCGCAUGUCCGCCCUGUUGGUGUCCGGGCAACCGGAUGAAAAGGGAAUGCGCCAGCGGUUCCGGGACAUGAUCCCGGGCAGCCGUCAAGCGCAGCCGCCCCCGCGACCGUGACCGGAGAGGGUGCCCAAGCCACUGGCCAAAUGGCCGGGAAGGCGGGACAUCCGCCAGAGCAGCGCUCUGACAUCCGCAAGCCGGGAGACCUGCCAGCACCCGAACUGCAACC,47,24,74,79,224
1044,3,CP000390.1/3801882-3802094,UAUUCAAUGCAUGUCUGUGGUUCUCCGGGGCGGUUUUGCCGUUCCGGAGCUAAGAGGGAAGCCGGUGCGCGAUGUUGCAAAGCCGGCGCUGCCCCCGCAACUGUAAACGGCGAGCCGAAAUCCACCGGUGUCACUGAGGUGAUAAGCCUUGGGAAGACGGAUUGAAGCGAAGACCCGCGAGCCAGGAGACCUGCCACGGCAAGAAGAAACGUC,50,37,70,56,213
1045,3,AAAP01003877.1/22278-22051,AUUAUAGUGCCGGGUGAUGGUUCCCCGCGUCCGCUUAGGGCAAGGGGUGAAAAUGGGAACGUGGUGCGGCGCCCGAAAAGGGGGCCAAUUCCGCGACUGCCCCCGCAACUGUAGGCGGAGAGGUUCCGGCCGUUAGAGACGCCACUGGCCCUGAAAUGGGGCUGGGAAGGCUAUGCCGGACCCAACGACCCGCGAGUCAGGAGACCUGCCAUCAUCGAGAGUCGCUUG,47,37,81,63,228
1046,3,AE017224.1/478516-478748,CCGUAAUACCGUCAUGACGGUUCCCCGACCGAGAGCGAAGGGGAUUAAUAGGGAACACGGUGAGGACGACCCAUCAAGGGGCCGAGACCGUGGCUGCCCCCGCAACUGUAAGCGGAUUGCCGUUCAUCCUCGUGACGCCGAAAGCGUCAUGCCACUGUGCCCACGGCACGGGAAGGCAGAUGGACGGCGAUUAUCCGCAAGCCAGGAGACCUGCCGUCUUACGUAGUCCAUUG,54,38,72,69,233
1047,3,CP000724.1/1570726-1570905,ACAAAAAAUAGCUUAUAAGGUGCUCUUUCAUAGAGUUAAAAGGGAAAGUGGUGUAAAUCCACUACAGCCCCCGCUACUGUAAAUGGGUAUGAAAUCCGCGAAUGCCAUUGGGAAACCGAGAAGGUCGGAGAGUAAGAUGAUCCAUAAGUCAGGAAACCUGCCUUAUAUUGUUAUAAAACG,64,42,42,32,180
1048,3,CP000386.1/663892-664074,GUUAUCCUGCCCGGCGUAGGCGGGCGAGAGGUCCAGGAAGCCGGUGAGAGUCCGGCACGGUCCCGCCACUGUGACCGGGGAGCGACCCCCGCACGCAGGGCCACUGUCGCCGCGGGCGAUGGGAAGGCCGGGGGAAGCGGAGAUCCGGGAGUCAGGAUACUGGCCUCUCGCCGGAGAAACCCC,32,20,73,58,183
1049,3,AAXF02000043.1/123852-123648,AUCUUUGCCCCCCGAAAUGGUUCAGAAUCCGUAUCCAACGGACGACGAUUAAUAGGGAAUCGGGUGUAAGUCCCGAACAGUCCCGCUGCUGUGAAGCUCUGUUCAAUGUCUUAUAAUUGAACUAAUUUAACGCCACUGAUGUUAAUCGGGAAGGCAAAUAAGACAAGAGUCAGUCAGAAGACCUGCCAUUUUGUGUAAGACGCUC,60,52,47,46,205
1050,3,AL646053.1/765144-764965,AUCCCGCCUCACGAUGAUGGUGCCCUUCCAGGGUGAAACGGGAACGCGGUGCGAUGCCGCGGCUGCCCCCGCAACUGUAAGCGACGAGUCUGCGCCAACCAGCCACCGCACGAUGCCGGGAAGGCGGCGCCAGGCGAUGACGCGCGAGCCAGGAGACCGGCCAUCUCCUUCUGUCGACGU,34,24,59,63,180
1051,3,AANB01000001.1/655385-655158,CGCAAGGGGGUUUUUGUUGGUUCCUGCAAAUUGCAGGCGAAGAGGGAAUGUGACAGGCUGAUAGGGAUUUUUGCUAUCAGCUCUCAAGCACAGCCGCCCCCGCGACCGUGACCGGAAAGGUCUCUGAUGCCACUGGCCCACCGUGCCGGGAAGGCAAGAGCACCGCAGACAGGCAUCGCCCGUCGAAAUCCGCAAGCCGGGAGACCUGCCAACGCAUGAGACAACGAG,55,37,71,65,228
1052,3,CP000738.1/523907-524111,UUAGAUGGACACACUCAAGGUGCCGCCUGAAGGGAGGGCGGAGAAUUGGGAAGCCGGUCAGAUCCCGGCGCUGCCCCCGCAACGGUGGUGGAGCGAACAGCCACGGCAGAAGGCCACUGGACAGCGCGUCCGGGAAGGCGCCGGGUAGGUCCCCCUGCGGGACAGCUCCAGAGCCCGGAAACCAGCCUUGAAGCAGAAACGAAUC,49,22,73,61,205
1053,3,CP000489.1/1337566-1337356,CCAUGAGGGCCGAGCUACGGUUCCGGCGGCGUGCCUCCGGAUUAAAAGGGAAUCCCGGUGCGCCUGACCUGUUCAGGCAAUGCCGGAGCUGCCCCCGCAACUGUAUGCGGUGAGUGACGGUCGAUCAUGCCACUGGCGCGAAUGCGCCGGGAAGGCCGGCCCGAACGAUGACCCGCAAGCCAGGAGACCUGCCGCAGCAAUCACCCAUUUC,42,32,68,69,211
1054,3,AAMQ01000002.1/102723-102924,CACACCGACAUACGCGACGGUUCUCCCGCGAGGGAGCGAAGAGGGAACACCGGUGCGACGCGCGAGCGUCUGGUCCGGGGCUGUACCCGCAACUGUGAGCGGCGAGCGAGGCGUCAACAGCCACUGGAUCGUCAGAUCUGGGAAGGCGGCGCAUCGCAUUGACCCGCAAGCCAGGAGACCUGCCGACGCGGUCGCUCGUUCA,41,26,71,64,202
1055,3,AAMT01000006.1/185943-186161,GCCACAAGGAUAAGGCAUGGUUCCCGACACGGCGCAAAGCGCCAAGGGAGAAUAUGGGAAUGCGGAGGGGUGAUCCAAACCGGAGCCUUCAGCCGCAGCCGCCCCCGCGACUGUGACGCGGCGAGCGCCCGCCGGAUACCACUGAGCCUCGGCUCGGGAAGGUGGCGAAGCGCGACGACCCGCAAAGCCAGGAGACCUGCCAUGUGAAACGAAACCCCA,55,21,73,70,219
1056,3,AE005673.1/502948-503176,GUCUGUUGCCGUUGUCGUGGUCUGCGGACGUUCGCGUCCGGAGCUAAGAGGGAAGUCGGUGAGGGCGUGAAACCCUGAAUCCGGCGCUGCCCCCGCAACUGUGAGCGGCGAGCCGCUGUCCGUUUCGUGUCACUGACGCGCCGAAGCUGGUUCGGGGAUGCGUCGGGAAGGCCAGGGCAGGGGUGACGACCCGUGAGCCAGGAGACCUGCCUCGACAGAUAACGUCCUC,37,42,85,65,229
1057,3,CP000113.1/8100727-8100515,AUCCCCGCUCGCGUCCUCGGUGUCGCCGUGGAGCCACGGUGACUCAAGGGAACCCGGUGUGAAUCCGGGACUGCCCCGCAGCGGUGAGCAGGAACGAACGCCGUCACGUGAAGCACUGGCCCGAAGCGGGCUGGGAAGCGACGGCAAGUAGGUGGGUGCUCCGUGCACCCGCGCCUGCGAGUCCGAAAACCUGCCGAAGACCCGUGCCCUUGG,39,29,75,70,213
1058,3,CP000712.1/3685877-3686075,UCUACCAUGCGGGCCGCCGGUUUCCACCACGGAACUAACAGGGAAUCCCAGGCCUGCCAAUACGGGCCAAACGGAACUGCCCCCGCAACUGUAGGUGCCGAGCCUGCUCCAUCGAUGCCACUGGGCCUGCCGCCCGGGAAGGCCGGAGCCGGGCCGUGACGCACCAGUCAGGAGACCUGCCGGCCUACAUUCACCAACC,41,26,57,75,199
1059,3,CP000662.1/326137-325950,GCAUCGUCGCGGUGCCCUGGUUCCCGCGGUGAUCCCGCGGGCGAAGAGGGAAGCCGGUGCAACUCCGGCGCUGCCCCCGCAACUGUGAGCGGCGAGCCAUCUGCCAUGCCACUGGCCCCCGGGCCGGGAAGGGGCAGCCGGCGUCCGAGCCGUGAGCCAGGAGACCUGCCGGGCCUUGACGACCAUCC,27,23,69,69,188
1060,3,AL591985.1/580383-580598,CAUACCAGAUCAUGUGAUGGUUCCGCCCGACUGAAGAACGGCGGAUGAAAAGGGAACACGGUGAGGACGACCCAUCAGGGGCUAAAACCGUGGCUGCCCCCGCAACUGUGAGCGGCGAGCAAAGUCCAAGGAUGCCAUUGGCCAUGAAUCGGCUGAUAAGGCGGACAAAGCUACGACCCGCAAGCCAGGAGACCUGCCAUCACCUUGGGCGACACG,60,29,66,61,216
1061,3,CP000449.1/2738434-2738239,UAGCUUUCGCGCCGCGAUGGUUCCCUCACGGGAAUAAUAGGGAAGCUGCUCAGGCCUUCGGGCCAAGUCCAGCGCUGUUCCCGCAGCCGUAGGCGGCGAGCGGUGAGGCACAAAGCCACUGGGGGUGACCCUGGGAAGGCGCUUCAUCCGCAUUGACCCGCAAGCCGGAAGACCUGCCGUCGCUGUCGUCUGUCCG,34,35,65,62,196
1062,3,CP000394.1/902076-901862,CUAAGCAUGCCUGGUCGUGGUUCUGCGGGUCCGUCAAAGACGAACGCCGGAGCCAAGAGGGAAUCCGGUGCGCAUCAGCAAAGCCGGAGCUGCCCCCGCAACUGUAAGCGGCGAGCCUGCAUCCACCGACGUCACUGAGGCUUCCGCCUCGGGAAGACAGGAUCGCAGGCAAUGACCCGUGAGCCAGGAGACCUGCCACGACACCAUAAUCGUCC,50,30,65,70,215
1063,3,CP000463.1/575538-575326,GACCUAGAUGGCCGCGACGGUUCUUCGCAAGAAGAUCAAAAGGGAACGCGGUGCGGGGCCUCCCACUUGGAAUGGCCCCUAUGCCGCGGCUGCCCCCGCAACUGUAAGCGGUUAGUCUUUCGUCUGAUGCCACUGGGUGCUUCGGUCCUGGGAAGGCGACGGAAGGUCAACGACCCGCGAGCCAGGAGACCUGCCGUCGAUCGUGGUCACACG,41,38,70,64,213
1064,3,CP000319.1/4032968-4032764,CCAUAGGUUGGUUGUCGAGGUUCUCCGGGUAUUCAUGCUUGGAGCUAAGAGGGAAGCCGGUGCGCUCUUGAGCAAGACCGGCGCUGCCCCCGCAACUGUAAGCGGUGAGCCGUGGUCCAUCAUGCCACUGGGUGUUGUCCCGGGAAGGCCGGACCAAAGCUGAGACCCGCGAGCCAGGAGACCUGCCCCGGCAACAUAGUCGUCC,39,38,68,60,205
1065,3,CP000480.1/6690166-6689959,GUACCGGCCAUCGAGUUCCGUGUGCUGUCACAGGUGCGGAACGAGAGGGAACCCGGUGAAAAUCCGGGACUGUCCCGCAGCGGUAUGCAGGAACGACCGCCGUCAUCAGCACUGGCCCCGCCUAGGGGCUGGGAAGCGACGGCCAGUAGGUGUGCGUCAGCGCACGCGCCUGUGAGUCCGAAGACCUGCCAGCCGUACCGGAUGCGCC,40,30,73,65,208
1066,3,CP000325.1/140970-141190,AUCGCCCCACGCGGUGUCGGCAUCGAGCGAGGCAUCAACGAUGCGUCGUAAGAGGGAAUCCGGUGAGAAUCCGGAACUGUCCCGCAGCGGUAUGCAGGAACGACCGCCGUCAUGAACGAAACAAGCACUGGUCCUUCACGACUGGGAAGCGACGGCCACUAGAAGCACCACCGGGUGCGCGCCUGCGAGUCCGAAGACCUGCCAGUUGUGCCGGGCGCGCC,50,30,72,69,221
1067,3,CP000319.1/4110955-4110750,CUUGUUUGGGAGAUCAUCGGUGCCUCCCGCGGGAGGUGAAACGGGAAUGCGGUGCGGGGAUACUGCCCCCAAUACCGCGGCUGCCCCCGCAACUGUAAGCGGCCAUCCGUAUCCAUUCGGCCACUGACCAUGCCAUGCAUGUGCGGGAAGGCGGAUCCGGAUAACGGCCGCGAGCCAGGAGACCGGCCGGUGACGCAUUCUUAGGC,39,35,69,63,206
1068,3,BA000012.4/4044596-4044395,UUAGAUCAUGUCAUCUCAGGUGCCGCUUCGUGACGACGGGGCGGAGAAUUGGGAAGCCGGUCAAAGUCCGGCGCUGCCCCCGCAACGGUGGUGGAGUUCAAGUCGCAACGGGAGACCACUGGGCAAAAGCCUGGGAAGGUGUCGCGACCGUCCGCAAGGACACUCCAGAGCCCGGAAACCAGCCCGAGAUUUUUGAACUCGA,47,33,66,56,202
1069,3,BA000012.4/6170874-6170694,AGGUCGCCGCCACUGCCUGGUGCCCGCCGCAAGCGGGAGAAUCGGGAACACGGUUGAACUCCGUGGCGUGCCCAACGCUGUAAGGGGGACCGCGCCGGUAAAUGCCACUGUCGAUGACGGGAAGGCACCGGACGCGGGUUGAUCCCGAGCCAGAAGACCGGCCUGGCAGGCAUCGUCAUCC,36,24,64,57,181
1070,3,CP000115.1/3122671-3122449,ACUAAAUAUAGUGGCCAAGGUCUCUCGAGUCGCAACACCGAGAGCUAAGAGGGAAGCCGGUGCGUCUCGGUCCGUGAUCCGGGCAAGGCCGGCGCUGCCCCCGCAACUGUAAGCGGCGAGCCGAAGUCCACUUGAGUGUCACUGGGGCUGCAAGGCUCUGGGAAGACCGGACCGAUGCCUGGACCCGCAAGUCAGUAGACCUGCCGUGGCAAAAAAAGAAUGU,54,35,72,62,223
1071,3,CP000362.1/3352019-3351799,GGAAAGGGUUCUGGGGAUGGUGUUCGGAAAGCCAAAAGCAAUCCGGGCUGAAAAGGGAAUACGGUGCGGCGUUCGUAACAGACGCCAAGUCCGUGACUGCCCCCGCAACUGUAAGCGGUGAGCGACCCCGAUGAUCACCACUGGGUGCAUCCGCAUCCGGGAAGGAUCGGGCAAGCUGUGACCCGCAAGUCAGGAGACCUGCCAUCAUCGAUGUAACUUCA,56,37,70,58,221
1072,3,AAOT01000001.1/134844-135060,GCACAAAGAUCCCCGCAUGGUUCCAGCCGGACGCGUCACGCGGCCGAGGAUCAAAAGGGAAUGCGGUGCGGGCGGAUCCAAACAGGACGCCCAAUGCCGCAGCCGCCCCCGCGACUGUCAGCGGAGAGCGUCUCGCCAUCGCCACUGGGCAACCGGGAAGGCGGCGCGACGCAGUGACCCGCAAGCCAGGAGACCUGCCAUGCACCGGCUUUUGCCG,46,23,72,76,217
1073,3,CP000250.1/112481-112283,AGUACGGUCGCGCCCGACGGUUCCCGCAAGGGAUCAAUAGGGAAUGCGGUGAGGGUCGCGCGCGAUCCGAUUCCGCGGCUGCCCCCGCAACUGUGAGCGGCGAGCCUUUCGCCACACGCCACUGGGCCUCGUGCCUGGGAAGGCGGCGAAAGGCACGGACCCGCGAGCCAGGAGACCUGCCGUCGUUCGUGGUCACACG,34,28,71,66,199
1074,3,AM236080.1/4518994-4518768,ACCAUAUCUAGUGUUCGAGGUUCCGUCGAUUCGUGAGGAUCGGCGGCUAAGACGGAAAUUCGGUGCGCGUCGCCAUCAUGGCGCGGCAAUGCCGGAGCUGCCCCCGCAACUGUGAGCGGCGAGCAACUGUCCGAUUUCAGGUCACUGGAGCAUGAUGCUCCGGGAAGGCUGGGGCAAAGUGCUUUGACCCGUGAGCCAGGAGACCUGCCUCGAAUGAAACGUCCACG,47,44,74,62,227
1075,3,ABCL01000003.1/119153-118953,CUAGGCUGAUCCUGUCAGGGUGCCGCCCUUUGGGGCGGAGAAUUGGGAAGCCGGUGUAACUCCGGCGCUGCCCCCGCAACGGUAAGGGAGGGCAUUUCGGCGAUAGGCCACUGGGCAAUUUGUCCGGGAAGGUGCCGAGAUGCGAGGGCCAUUUGGCCUGCCGCCCAAGCCCGGAAACCAGCCUUGGCGGAUCGUCGAAUC,36,36,72,57,201
1076,3,CP000133.1/2475759-2475573,GAAAUAGAUACCUCGUCAGGUGCCCGCUUUCACGCGGGAGAAUCGGGAAUCCGGUGCAAGACCGGAACGUGCCCAACGCUGUAAGGCCGACGCCCGCCGCUUCAUCAUGCCACUGGGUUUUGCCGGGAAGGCUGCGGCAGACGGAUGACGCCAAGUCAGAAGACCGGCCUGGCAAGAUAGACCCAAC,45,28,58,56,187
1077,3,CP000647.1/4660061-4660248,UUGUAGCAUUCGCCUACCGGUCCUGUGAGUUAAAAGGGAACCCAGUGGAAAUCUGGGGCUGACGCGCAGCGGUAAGGAAGGUGAGAAAUGAGCGCACUCGGUGCAGACACUGCGGCUAGCCGUGGGAAGUCAUUAUUUCUUGAAACAGCCUCCAAGCCCGAAGACCUGCCGGAAUACGUCGCACUGGG,47,36,59,46,188
1078,3,CP000319.1/4033871-4034093,ACUAGAUAUGGUGGUCACGGUCUCUCGAGUCGCAAAAUCGAGAGCUAAGAGGGAAGCCGGUGCGCCCGAGUCUUAAUGGCGGGCAAUGCCGGCGCUGCCCCCGCAACUGUAAGCGGCGAGCUGAAGUCCAUUAUUGUGUCACUGGGACCGCAAGGCCCUGGGAAGACCGGACCGACGCCUAGACCCGCAAGCCAGUAGAUCUGCCGCGACAACAAAAACGUCC,55,35,68,65,223
1079,3,AALY01000002.1/134769-134968,AGCAUUGUCGCCCCUGAUGGUUGCCCGGGACGAAUCCGGGCUGAAAAGGGAACGCGGUGCGGGUCUGACCCAAUUCCGCGGCUGCCCUCGCAACUGUAAGCGGCGAAUGUCUCGCACCAUGCCACUGGCCCUCGGGCUGGGAAGGCGCGACCCAUGAUGACCCGCAAGCCAGGAGACCUGCCAUCCAGGGCGCUGUCCGG,37,31,66,66,200
1080,3,CP000494.1/6303139-6303357,ACCUACUGUGAUGACGACGGUGCCCCAUAACCGGGGCUCAAAAGGGAAUGCGGCGCCGGACGCGUCUCGCGAGGGACAUGAUCGAAGGGCGCAGCUGUCCCCGCUCGUGCAGGCGGCAAAUGACGCGUCAUAGGCCACUCGGAAAUCCUGGUCCCGGAACGACGUCAUGGCGGCUAUGACACGCGAGCCAGGGCACCCGCCGUCAGCGGUGGUCACACG,46,30,74,69,219
1081,3,AP007255.1/306940-307165,AUUAUAGUGCCCGGCGAUGGUUCCCCGCGACCGGCGACGGCGCGGGGUGAAAAUGGGAACGCGGUGAGGCACCCGAAAAGGGGGCCGAUUCCGCGACUGCCCCCGCAACUGUAGGCGGAGAGGUUCCGGCCCUGAGAGAUGCCACUGGCCCGAAAAGGGCUGGGAAGGCUAUGCCGGACCCAACGACCCGCGAGUCAGGAGACCUGCCAUCAUCGAGAGUCGCUUG,48,30,81,67,226
1082,3,CP000539.1/3361819-3361627,UUAUCAUCCCCGUCCUCAGGUGCCCGCUGCCGCAAGGCAAAGGGAGAAUCGGGAAGGCGGUUGGAGUCCGCCGCGUGCCCAACGCUGUAAGGAAGAUGACCCCCGCUCAAUGCCACUGGCCGCCAAGGCCGGGAAGGCGCGGCGGGUCAGAUGAAUCCAAGCCAGAAGACCGGCCUGAACGUUCAUCGCGCUG,42,27,63,61,193
1083,3,AALZ01000005.1/160175-160353,GGCCCAAUGGCCGGGUCUGGUGUCCGCCUCGCGGAAGAAUCGGGAAGCUGGUGAAACUCCGGCACGUGCCCAACGCUGUAAUGGGGAUGGUUUGCGCAUAGGCCACUGGAAUAUUCCGGGAAGGCGCGCGGACCAGACGACCCUAAGUCAGAAGACCGGCCAGACAGUACAGCUUGCCC,40,28,60,51,179
1084,3,CP000480.1/6704143-6703957,GGCUAUUGUUGUGGCGCUGGUCGGCCCGACCGGCCCGAUGAGUAGGUAGGAAGCCGGUGUGAAUCCGGCAUGGUCCCGCCACUGUGACUGGGGAGCGAACCCCACAUCGACCACGGCUUGACGGCUGGAAGGUCGGGGUGAGCACUGAUCCAGAAGUCAGGAUACUGCUCUCAUUGGCCCUCUUGCU,33,38,64,52,187
1085,3,CP000494.1/6305642-6305856,ACCUACUGUGAUGGUGACGGUGCCCCCUGACCGGGGCUCAAAAGGGAAUGCGGUGCCGGACGUCCUUAACGGAUCGUUCGAAGGCCGCAGCUGCCCCCGCAACUGUAAGCGGCGAAUCUCACGUCAGAUGCCACUGGGAAUUCUCGGUCCUGGGAAGGCGGCGUUGAGGUGACGACCCGCGAGCCAGGAGACCUGCCGUCAGCCGUGGUCACACG,42,36,72,65,215
1086,3,CP000301.1/2063662-2063445,AUGCAGUCCAUAGCCGACGGUGCCCUGUCCUCGGACAGGGCGAAGAGGGAAUACCGGGCGCCGGGUUAAGGGAUGGUCCCUUAGGCCGGUGAAGCCGGAGCUGCCCCCGCAACUGUGAGCGGACAGCCUGCACCGAAAACCACUGGGUCUCGACCUGGGAAGGUGGUGCCGGCCAUGACCCGCGAGCCAGGAAACCUGCCGUCGCCUGCGAUUUCGCC,42,32,75,69,218
1087,3,AE015928.1/1832233-1832438,UAUCUUUGUCCCCGCAUUGGUUUGCGACUCUCAUCACGAGGGAAGCGAUUAAAAGGGAAUCAGGUGUAAAUCCUGAACAGUCCCGCUGCUGUAAGUUCCAUAGAUAUGUUGCGAGCAAUCUACUCAAAGCCACUGGAAAGAAAAUUCCGGGAAGGCGCCCGCAACAGGAAUAAGUCAGAAGACCUGCCAUGUAAAAUCCGUUUCAC,62,47,48,49,206
1088,3,CP000667.1/4966842-4966623,AUGGUGUCUCCCGCAGCUGGUUCGACCGCUCCCGCCGGGAGUGGGCGAGGCAAGAGGGAACCCGGUGGGAGUCCGGGACUGCCCCGCAGCGGUGAGUGGGAACGACCGCCGUCAUCACGCACUGGGCUCAUCGAGGCCUGGGAAGCGACGGCCAGUAGGCGACCGGGUCUCCCGGGCGUGCCCGCGAGUCCGAAGACCUGCCAGCGCGCCGCACGCGUCG,34,27,85,74,220
1089,3,CP000283.1/4855579-4855783,CAUCUAGAUGAUUGUGACGGUUCCCCUUCCGGGGAUCAAAAGGGAAUGCGGUGCGGACCUCUUCGGAGGACCAAUGCCGCAGCUGUUCCCGCAACUGUAAGCGGUUCGACUUUCGUCGGAAUGCCACUGGGAAACUCGGUCCUGGGAAGGCGACGAAAGCUAACACCCGCGAGCCAGGAGACCUGCCGUCAUUCGUGGUCACACG,45,40,62,58,205
1090,3,AAYC01000005.1/205052-205266,CUCAUACAUAGCGCUGAUGGUUUUUCCGGGGGACACUCCUGGAAAAUGAAAAGGGAAUACGGUGAGGUGUAGCCAACAGGCGCCAAAUCCGUGACUGCCCCCGCAACUGUGAGCGGAGAGCAUUGCUGCAACAAGCCACUGCCCCAAGGGGUGGGAAGGCGUAGCAAGGCAUCGACCCGCGAGUCAGGAGACCUGCCAUCUAGUAGUUCACCAAC,57,36,64,58,215
1091,3,CP000578.1/48121-47921,GGCUACUCAAUCCUCGUCGGUUUCCGUAAGGAAUUGAAAGGGAAUCCGCCGCCGGACCUGUCCGGCGAACCGGAACUGCCCCCGCAACUGUAGGCGGCGAGGAGCUCGCGAUCAAAGCCACUGUGGCCUCAAGCCAUGGGAAGGCCGCGCCAGCCCUGUGACCCGCCAGUCAGGAGACCUGCCGGCGUUCGAUCUCAACGC,41,31,61,68,201
1092,3,CP000152.1/1678463-1678270,UUACCCUUGCGCGCUGAUGGUUCCCGGAAACGGGAUCAAAAGGGAACGCAGGAGAGGCAGCGCCUCGAAUCUGCGGCUGCCCCCGCAACUGUGAGCGGCGAAUCCGUGCCACUGCAUGCCACUGGGAAACCGGGAAGGCCGGCACGAAUCAGGACCCGCGAGCCAGGAGACCUGCCAUCGACCCGAGGUCCAAG,45,24,63,62,194
1093,3,CP000463.1/3539927-3539727,UACAAGAUAUGGCGUUACGGUCCCCACAUGUCACAUCAUGUGGGGCUAAGAGGGAAGCCGGUGUGAAUCCGGCGCUGCCCCCGCAACUGUCAGCGGCGAGCCGCCGUCCAGCAAUAUCACUGACGCCGCGAGGUGUUGGGAAGAUUGGACGGAAGCUGUGACCCGUGAGCCAGGAGACCUGCCGUAGCAAACGCGUAACGU,46,34,65,56,201
1094,3,CP000031.1/3757898-3758110,CGCUACCGCUGGGUCGAUGGUUCCCGGUCGUGCAUGCGCCGGGAUGAAAAGGGAACACGGUGCGGCCCUCUGGCGACAGAGGACCAAUGCCGAGACUGCCCCCGCAACUGUAAGCGGUGAGCGAUGCCGAAAUGCCACUGGCCCCCGGGCCGGGAAGGCCGGCAAAGCCCGGACCCGCAAGUCAGGAGACCUGCCAUCGCAACCGUAACUCGA,46,26,71,70,213
1095,3,CP000440.1/1742843-1742651,UACGGCCGUUCGUUCGCCGGUGCCCUUCGGGGCCGAAGAGGGAACACAGGGCGCGUAUCGCGCUGCUGUGGCUGCCCCCGCAACUGUAGACAGCGAGCCGAUCUCCCCCCUCAUGCCACUGGUUUCACCGGGAAGGCCGGGAGCCGGCGCCGACCUGUCAGCCAGGAGACCUGCCGGCCUGAAAGUGCGUGCG,30,30,66,67,193
1096,3,CP000662.1/314827-314627,UUCAACGGCAGCGUCAUCGGUUCUUCCGGCAACGGAAGAGGAAAGAGGGAAUGCGGUGAGGCCGGAUGGCCGACUCCGCGGCUGCCCCCGCAACUGUGAGCGGUGAGCGAGGCCGACAUGCCACUGGGCGCCCUGCCCGGGAAGGCCGGCCGAAGCUGUGAUCCGCGAGCCAGGAGACCUGCCGCUGGCGCGCGGGGAGCG,36,24,79,62,201
1097,3,CP000089.1/155783-155587,CCGGCCUUUAUGUCUCUCGGUGCCCGGCCGAUUUAUCGGCGGGAGAAUCGGGAAGGCGGUGCAAAUCCGCCGCGUGCCCAACGCUGUAAGGAGGACGGGCGAUGCGAAAAGCCACUGGUCAGGGAAAACCCGGCCGGGAAGGCGCAUCGGCCGGGUGAAUCCGAGUCAGAAGACCGGCCGGGAGACGAAACCGGGCU,43,26,73,55,197
1098,3,CP000376.1/216700-216497,UACAACUCUGCCCUACGAGGUGCUGUCCGGGCUUUCCGGACGGAGAAUUGGGAAGCCGGUGCGAUUCCGGCGCUGCCCCCGCAACGGUCAUGGGAUUCGCGGGCGUAACAUCUGCCACUGGGAGGAGGACCCGGGAAGGCGUUGCGCUCCGACCAGCAGGUCACCCCCAGAGCCCGGAAACCAGCCUCGGCAGAUAUCGUCAAC,40,32,66,66,204
1099,3,CP000283.1/3260113-3259915,UUAACCGGCCGCAGUACCGGUGCCUCUCGAAGGAGGGGUGAAACGGGAAUGCGGUGCGGGACGCUUGUCCCAAUGCCGCAGCUGCCCUCGCAACUGUGGGCGGAUCGGAGUGUCCUUGACGCCACUGGCCAAUGGCCGGGAAGGCGGACGCUCCAAAGAUCCGCGAGCCAGGAGACCGGCCGGUACCUCUGAAAGAACU,41,30,69,59,199
1100,3,AAYA01000008.1/50513-50733,UGCUUAACGAUCCGCGAUGGUUCCCGGAACGCCAGCAAGCCAACCGGGAUGAAAAGGGAACACGGUGAGGAUGUCCGCAAGGUGCCGAAUCCGCGACUGCCCCCGCAACUGUGAGCGGAGAGCGAUCCUGAGAACACCACUGGGCCGGUAGGCGGCUCGGGAAGGUUCGGGAAAGCGUUGACCCGCAAGUCAGGAGACCUGCCAUCUCCGGCGCGCUCCGC,50,30,74,67,221
1101,3,AAYC01000002.1/248003-247819,UGAGCGGAAUCAGUUUCAGGUGCCCUGCUCUUGUAGGGAGAAUCGGGAAGGCGGUGCAAAUCCGCUGCGUGCCCAACGCUGUAACGGGGACUGGUCGACGAAUAUGCCACUGAAGUCACUUUCGGGAAGGGCGUCGACUGGGGUGAUCCGAAGCCAGAAGACCGGCCUGGAACCCAUAUUGCCGC,41,35,62,47,185
1102,3,CP000577.1/1097204-1097404,AUAUUGAGGAACGGCUUCGGUUCCGGCGUGAUGGCCGGAUGAAAAGGGAACGCGGUGCGGGGAGAUCUCCCCAACUCCGCGGCUGCCCCCGCAACUGUAGGCGGCGAGCGACGACCGACGGCGCCACUGGGAUGUCCCGGGAAGGCCGGUCCGAGCUGCGACCCGCAAGUCAGGAGACCUGCCGGAGCGAUCACCCUUUCC,38,28,71,64,201
1103,3,CP000301.1/4737279-4737476,UUAAACGCCGCGGUCGUCGGUGCCUCUCGCAAGGGAGGUGAAACGGGAAUGCGGUGCGGGACGAUGUCCCAAGGCCGCGGCUGCCCUCGCAACUGUAUGCGGAUCGAGACGUCCAACAUGCCACUGGCCGAUCGGCUGGGAAGGCGGACGAGGAGAUAUCCGCGAGCCAGGAGACCGGCCGGCGACGUCGAUCUUACG,40,29,72,57,198
1104,3,AATQ01000008.1/90798-91010,CGCAUCUGGCACCACGCUGGUGCCUGUGUAAACAGGUGAAAAGGGAAUGCGCCAGCCCGGGAAACCGGGUCAAGCGCAGCCGCCCCCGCGACCGUGACCGGAAAGGUCCUCCACCGCCACUGGCCUUGCGCCGGGAAGGCAGGGGGGCCGCUGGAUGGCGCUGCCAUCCUGCAUCCGCAAGCCGGGAGACCUGCCAGCGCAAGACGACACCAA,45,23,71,74,213
1105,3,AM263198.1/1157829-1158018,CGCAUUGCCGGGUACUAAAAAACUAAAUAGGUGAAUAUAUUAAUCCGGGAAAGAGGUGAAAAUCCUCUACAGGCCCUAGCUACUGUAAUACGGACGAAAGCCAAAUAGACGUCACUGGAAGAAAUUCCGGGAAGACUGGUGAGUAGGAUGAUGUUAAGUCAGGAGACCGCUUUUAUAUUCGAUAUCCAAA,67,43,46,34,190
1106,3,CP000377.1/185492-185258,CGUAGCAUCCAGACAGAUGGUUCCUGCCUCUGUUUGGGGUGGGAUGAAAAGGGAAUACGGUGAGGCUUUGGACCAUUGGGUCCCGCCAAGUCCGUGACUGCCCCCGCAACUGUGAGCGGCGAGUUCCCCGGCAAAGCCACUGACCCCAACGUCGUAACCGGCAAAAAAGGGUCGGGAAGGGCCGGUUCGCGAUGACCCGCAAGUCAGGAGACCUGCCAUCGGCAAUGUAAACCUG,54,41,74,66,235
1107,3,CP000653.1/4368932-4368756,UUGUAGCAUUCUGUUUCCGGUCUCAUGUAAGUGAAAAGGGAAUCCAGUGCAAAUCUGGAGCUGACGCGCAGCGGUAAAGACUGGCGGGAUGAGAGUUGUAGACACUGUGAAAAUGGGAAGUCUUCAUCCGUAAAACGCCACUAAGCCCGAAGACCUGCCGGAAUUACGUCGCAUCUG,49,40,50,38,177
1108,3,CP000304.1/1397689-1397909,AACCUCCGCGUCGCCUCAGGUGCCCCCUGGCCUUGUGCCAGACGGGUGAAACAGGGAAGCCGGUCCAUUCUCACGAAGAUUCCGGCGCUGCCCCCGCAACGGUAGGCGAGUCGAGAAACCGCAACGGCCACUGUGCAUGACGCAUGGGAAGGCGCGGUUUCGGGAUGCCGCAAGGCAUACGCUCGCAAGCCCGGAGACCGGCCUGUCGCAUUUCACUGACA,45,34,69,73,221
1109,3,AAAP01002012.1/63-265,GCACAUCCUGGAAGUGACGGUUCCCUUCGGGGAUCAAAAGGGAACGCGGUGAGGACUUUCGGGUCCGAUGCCGCGGCUGCCCCCGCAACUGUAAGCGGCGAGCCUUUUCACCACCGAUGUCACUGGAUGAGCCUCAUCCGGGAAGACGGUGAGACGGCGACGACCCGCGAGCCAGGAGACCUGCCGUCAGCCGUGGUCACACG,41,32,67,63,203
1110,3,AAAP01003421.1/1751-1551,GGUUAGAAGGUCAGCGACGGUUCCCUUCGGGGAUCAAACGGGAACGCGGUGAGGGUUCGCCCUCGAUGCCGCGGCUGCCCCCGCAACUGUGAGCGGCGAGCCUUUUCACCACCGAUGUCACUGGAUGGGCCUCAUCCGGGAAGACGGUGAGAGGGCGACGACCCGCGAGCCAGGAGACCUGCCGUCAGCCGUGGUCACACG,37,31,71,62,201
1111,3,CP000614.1/1755111-1754922,UACGGCCGUUCGUUCGCCGGUGCCCUUCGGGGCCGAAGAGGGAACACAGGGCGCGCCGCGCCGCUGUGGCUGCCCCCGCAACUGUAGACAGCGAGCCGCGCUCCGCCACAUGCCACUGGUUUCACCGGGAAGGCCGGGAGCCGGCGCCGACCUGUCAGCCAGGAGACCUGCCGGCCAGAAAGUGCGUGCG,30,24,68,68,190
1112,3,AP006840.1/2078690-2078498,AAUACGGGCACAGCGGCAGGUGCUCCCGGCCCCGCGCUCCGGGAGUUAAAAGGGAAGCCGGUGCAAGUCCGGCACGGUCCCGCCACUGUGACGGGGAGCCGUCCCCACGAUGCGCCACUGGCCGGAAGGCUGGGAAGGCGGGGGAAGGCGAUGAUCCGAAGUCAGGAGACCUGCCUGUCGCUGCAACGUCACU,38,24,71,60,193
1113,3,AALY01000002.1/281935-282138,CUAGGCUAAAGCUCUCAGGGUGCCGUCCUCGCAAGGGGCCGGAGAAUUGGGAAGCCGGUGCAAGUCCGGCGCUGCCCCCGCAACGGUAAGGAGGGGUGGUUGGGCGAUAUGCCACUGGGCCGCGAGGCCUGGGAAGGUAGCCCGAUCACAGGCCAGAUGGCCGUCCACCAAGCCCGGAAACCAGCCAUGAGACAACGUCAGAAC,46,26,72,60,204
1114,3,AL954747.1/696804-696577,UCUGCGCCCCUUGUUUGAGGUGUCCCAGAUGCAUUUGCACGAGGGAUGAAACGGGAAGCCGGUGCGCGCUGGAAUCAGCCAGCGCAAUGCCGGCACUGCCCCCGCAACGGUAAAUGAGUCAAUGAUCUGCACACGCCACUGUGCUGUAUGGCACGGGAAGGCGCAGAAUCAGGAAAACACAGCUUCCGCUCAUAAGUCCGGAGACCGGCCUGAAGCAAUAUCAUGUUA,57,42,66,63,228
1115,3,CP000031.1/3073055-3073267,GGCUAAAUGAAGGGGUCUGGUCCUGCCGGAGCAAUCCGGAUGCUAAGAGGGAAUUUGGUGCGACCGCCCGUCGGUUCAGGCCAAAGCCGCCCCCGCGACUGUAAGCGGUGAGCCUCUGUUCAACCAGCCACUCCCGGGUUCGCCCCCGGGGGGAAGGCGAACAGAGGCACUGACCCGCGAGCCAGGAGACCUGCCAGACAGGCACUGUAACAC,46,30,70,67,213
1116,3,AM406670.1/2635166-2635365,AAACUCCCCGGCGUUGAAGGUUCCCCGCCAGGGGAUUAAAAGGGAAGCCGGUGCCGAGCCCAGCUCGAAUUCCGGCGCUGCCCCCGCAACUGUCAUCGGCGAGCGCUUCGCCACCCCAUGCCACUGGAUGCGUUCCGGGAAGGCGGGCGAAGCGCGACGACCCGAGAGCCAGGAGACCUGCCCCAACGUCCAUCCUUGAA,41,27,61,71,200
1117,3,CP000774.1/549380-549581,UACACUCCGCCCGCCUAUGGUGCCCCGGCCGCAAAUCCGGGGUUAAAAGGGAACGCCCGGAGCGCAUGCUCUUUCUUCGAGGCGGCUGCCCCCGCAACUGUAAGCGGCGAGCUUUUUCCGAUUGUGCCACUGGAUGUCCGGGAAGGCAGGGAAGGGCGAAGACCCGCGAGCCAGGAAACCUGCCACAGGCUGUCGUCCGUCU,38,35,64,65,202
1118,3,AATQ01000007.1/84467-84279,UUAAGCGGAGCGGGCCUCGGUUCCGGGCCUUGUCCGGAGAAUAGGGAACGCGGUGCAAACCCGCGACUGCCCCCGCAACUGUGAGCGGUGAGUGCGACCGGCAUAUGCCACUGGGCGAAACGCCCGGGAAGGCCCGCGUCGCGCGAUGACCCGCAAGUCAGGAGACCUGCCAAGGUGAUCACCCUCCCC,37,25,64,63,189
1119,3,CP000158.1/1548021-1548210,ACAUCAACCCCAUCAGAUGGUGCUCCCCUGACAGGGAGCUAAGAGGGAAGCCGGUGUAAAUCCGGCGCUGUACCCGCAACUGUUAGCCGGGAGCUGAUGGCCACUAUGCCACUGGAACGCGAGUUCUGGGAAGGCGGCCAAAGGCGACGAUCGGUGAGCCAGGAGACCUGCCAUCGCGUCGUUUGUCCGG,42,32,62,54,190
1120,3,AAXE02000103.1/317216-317417,UAUUUGCCCUUUGAAACAGGUUUCCCUGUCCUCCUUACAGGACAGGAAUGAAAAGGGAACCGGGUGGAAAUCCCGGACAGACCACGCUGCUGUGAAACUUCGGUAACAUACCGGCAAUACUCAAUGCCACUGAUCGGGGGAUCGGGAAGGUGUCCGGGGAUGGAAGUAAGUCAGAAGACCUGCCGUUUCGGUUUUGAAGAGU,53,45,59,45,202
1121,3,CP000615.1/1891336-1891529,UUACGCUUGCGCACCGAUGGUUCCCGGAGACGGGAUCAAAAGGGAACGCAGCAGAGGCCGAGCCUCCAAUCUGCGGCUGCCCCCGCAACUGUAAGCGGCGAAUCCGCGCCACCACGCGCCACUGGGAAACCGGGAAGGCCGGCGCGGAUGACGACCCGCAAGCCAGGAGACCUGCCAUCGACCCGAGGUCCAGC,44,20,62,68,194
1122,3,AAMY01000005.1/65948-65727,ACUAGAUAUGGUAGCCACGGUCUCUCGAGUCGUCGUACCGAGAGCUAAGAGGGAAGCUGGUGCGCCUCGGUCCAUGAUCCGGGCAAGGCCAGCGCUGCCCCCGCAACUGUAAGCGGCGAGCCGAGUCCAAUUGAGUGUCACUGGAACCGCAGGGUUCCGGGAAGGCCGGACGGACGCUACGACCCGCAAGUCAGGAGAUCUGCCGUGGCGGAAAGAACGUCC,49,34,75,64,222
1123,3,AE005673.1/1924997-1925186,AGCUCUAGCUUCGCGUCAGGUUCCUCGAAAGAGGAUGAAAAGGGAACGAGGUUGAAGACCUCGGCUGCCCCCGCAACUGUAAGCGGCGAGCUUCGCGUCACAUGCCACUGGGCCCAAAAGGCCUGGGAAGGCGACGCCCAGAAGCAUUGACCCGUGAGCCAGGAGACCUGCCCGGCGCAGUCGUUCAUCG,44,29,60,57,190
1124,3,CP000661.1/387171-386964,GCCGAUGGUGCGCGGGACGGUUCCCGGGGGCAGCCCCGGGCGAAGAGGGAAUGCGGUGCGGGCCUGUUCGGCCCCAAGCCGCGACUGCCCCCGCAACUGUAGGCGGCGAGCGCGUCCCAUCAUGCCCACUGGCCCCGGACAGGCCGGGAAGGGCGGGACAAGCCGAGACCCGCGAGUCAGGAGACCUGCCGUCAUCGGACCUGUAACA,36,22,79,71,208
1125,3,AE016825.1/1690702-1690517,AUUCUUGCCAUUCUUGACGGUGCCCCAAAAGGGUGAAACGGGAACGCGGUGGAAUGCCGCGGCUGCCCCCGCAACUGUAAGCGCAGAGUCCACGCCUGACGCCACUGGCCCUUAGCAAGGUCGGGAAGGCGGCGCCCGGACGGCGACGCGCGAGCCAGGAGACCGGCCGUCAAACGUGUCGACGCA,39,24,63,60,186
1126,3,AAAP01003109.1/772-976,CAAAGGUCGUGCGGCCAAGGUUCCUGCGGACUCUUCCCCGUGGGCUAAGAGGGAAUCCGGUCGGUUCGUCCGAUGCCGGAGCUGCCCCCGCAACUGUGAGCGGCGAGCUCCCGCCGCGAGAGGUCACUGGUGCCCCGCACCGGGAAGGCCGGGCGGGGGCGCUGACCCGUGAGCCAGGAGACCUGCCUCGGCACGACGAUAUUCC,32,30,74,69,205
1127,3,ABBP01000344.1/210-416,AUACAGCGUCCGUCGACCGGCGCCCCACGGGGCCCAAGAGGGAACGCAGGGCGCGCCGCGCCGCUGCGGCUGCCCCCGCAACUGUGAGCAGCGAGUCCGCAUCCGAUCCACGCCACUGGCCACGCCGCCCUUUCGCGGCCGCCGGGAAGGCCCGCUGCGGACGACGACCUGCCAGCCAGGAGACCUGCCGGGACGUUUCGUUCGUGC,31,23,70,83,207
1128,3,ABCL01000001.1/663982-664208,UGCAUACCGGACGUGCAAGGUUCCUCGUUUGGGCGCAAAGCGCCUCGGGGAUGAAAUGGGAAUGACGUGCCGGUGGACCCAAUUAGGGCGCCUAUGCGUCAGCCGCCCCCGCGACUGUAAGCGGCGAGCCCCUGCCAGAUGCCACUGAGGUGCCUAUGACCUUGGGAAGGCGGCAGACAGGCGACGACCCGCGAGCCAGGAGACCAGCCCUGCGUUCGUCAAUCCCG,45,35,76,71,227
1129,3,CP000230.1/2009119-2009340,GUAAGCUUUGAGGAUCGUGGUUCUUUGGCACCGUUUUGUCGGGUGCCGGAGCUAAGAGGGAAUCCGGUGAGCCGCGUUUUGGCGAUGCCGGAGCUGCCCCCGCAACUGUAAGCGGCGAGCCGCUGUCAAGACGUGCCACUGCCCCCGGCAAGGGGGGUGGGAAGGCCAGACAGCGGCGACGACCCGUAAGCCAGGAGACCUGCCGCGAUGUCAUAACCUCCC,41,39,78,64,222
1130,3,CP000390.1/2942047-2941844,CUAAAUAUAGCCCAUCACGGUGCUGUCGAGUCGUUCGGGUCGAGAGCUUAAGAGGGAAGCCGGUGUGAGGCCGGCGCUGCCCCCGCAACUGUAAGCAGCGAGCUUGUGUCGCGUAUUGCCACUGGUGCUCCUAGAGCGCUGGGAAGGCCUGACAGAAGCGAUGACCUGCAAGCCAGGAGACCUGCCGUGAUGAGCAUUGAACGU,44,39,68,53,204
1131,3,CP000716.1/891454-891623,AUAUAAAUUGUUACUAUAGGUUAAGGGAACUCCGGUGAAAAUCCGGGGCUGCCCAGCAACCGUAACCGGGGACGAAAUCCACAAAAUGUCACUGGGAAUUUUUCCUGGGAAGGCGUGGAGAGUAGGUUGAUCCGGGAGCCGGGAGACCUGCCUAUAGUAAGGUUAUUUCC,47,39,50,34,170
1132,3,AAQW01000001.1/3968828-3969033,CCCAUCCGGCCCGUUCCAGGUGCCUCCUGCCGCCGCGCAGGAGGUGAAACGGGAAGCCGGUGCGUCACUUCGGUGAUCAGUCCGGCGCUGCCCCCGCAACGGUAAGCGAGCGAAAUCCUCUUCAGGCCACUGUGCUCCGGCAUGGGAAGGCGAGGAUUUCACGACCCUCGCAAGCCCGGAGACCGGCCUGCAACGCCCUGUUGGCA,36,32,65,73,206
1133,3,AE016853.1/1878136-1878350,CCUUCGCGGCUUGUUUCAGGUGCUCUGCAAUCCUCGAUUGGCAGGGUGAAACAGGGAAGCCGGUGUGGAUCGACCGAUCCGAUCCCGGCGCUGCCCCCGCAACGGUAAAUGAGUCAAGGCUGUGCAUCGUGCCACUGUGUUUCGACACGGGAAGGCGCGCAGCCGGGGUAACCCGCUCAUGAGCCCGGAGACCGGCCUGAACCACUCAAUGGCAU,42,40,68,65,215
1134,3,CP000662.1/267567-267380,UCAUCACAGGGACGCUUUGGUUCCCGCGGCAGCACCGCGGGCUAAGAGGGAAGCCGGUGGGAAUCCGGCACUGCCCCCGCAACUGUAAGCGGCGAGCCUUGCUUCGAAACCACUGGCCAAUGGCCGGGAAGGGAAGCCGGGCGCCCGAGCCGCAAGCCAGGAGACCUGCCAGAGCCACAGAGACGACC,42,20,64,62,188
1135,3,AM420293.1/1414592-1414388,AGUGUGUCCCGCGCUGAUGGAUCACCACGGAAGGUGAGGCAACAGGGAACCCGGUGCGAAUCCGGGACUGCCCCGCAGCGGUGAACGGGAACGACCGUCGUGACCGGCUCCGGCCGGUACGGCACUGGGCGCGCACGCGCCCGGGAAGCCACGACCAGUAGGCCGCCCGUGAGUCCGAAGACCUGCCAUCGGUGCGCGCACGAGG,39,22,76,68,205
1136,3,CP000482.1/1312853-1313047,AAUUGAAUAUCUGAUCAAGGUGCCCGAGAGGGCUUGAUAGGGAAGAGGGGUGCCGCUCUCAGUAACGAGCCAUUCCCCCGCGGACCCGCCGCUGUAAGCGAUGACGAAGGGCAGUAUGCCACUGGUGAAUAACCGGGAAGGCGCCCGGAGGAUGACUCGCGAGCCAGAAGACCUGCCUUUUGAUUAUUGCCACAG,48,35,62,50,195
1137,3,CP000489.1/1328400-1328204,CGCUAUGGCGGAGUUGUCGGUUUCCGCAAGGAAUUGAAAGGGAAUCCGCCGGGGCAUCAGCCCCGAACCGGAACUGCCCCCGCAACUGUAGGCGGCGAGCAGGGUGCGAAACAGCCACUGUGGCCCAUGCCAUGGGAAGGCCGCAUCCCUGCCGUGACCCGUCAGUCAGGAGACCUGCCGACGCGAUGACCAACCCG,42,27,64,64,197
1138,3,CP000271.1/1989295-1989475,AGGCAUAAUACAGCCGCCGGUUGCCCUUCGGGGCCGAAGAGGGAACACAGUGCCACUGUGGCUGCCCCCGCAACUGUAUGCAGCGAGUCCGCCUGCGCUUCACGCCACUGGUUCGACCGGGAAGGCCGCAGCGGACCAUGACCUGCCAGCCAGGAGACCUGCCGGCGAGACUGUUCGUGCC,34,27,58,62,181
1139,3,AAQW01000001.1/1951627-1951835,GCUGCGCGCCUUGCGACAGGUGCCCCGCAAGGGGUGAAACAGGGAAGCUGGUGCGUUCCGUCGGAACCAGGCCAGCGCUGCCCCCGCAACGGUAGGCGAAUCAGACAGCCGCUCGAUGACCACUGUGCUCCGGCAUGGGAAGGCGCGGCUGGAAGCGUCCAGCGCUUCGCUCGCGAGCCCGGAGACCGGCCUGACGCACCCACGGCAUC,38,26,73,72,209
1140,3,AAYH02000045.1/230243-230451,UAUCUUUGUCCCAGUUUUGGUUUCACCUCUCCCGGUUCUGUUGGAGAUGAGUGAUGAAAAAGGGAAUCAGGUGCAAAUCCUGAACAGACCCGCUGCUGUAAGUCCUUCCAAAAUCUUUGAAUAUUCUACAAGCCACUGUCCGCCCGGCGGAUGGGAAGGCAUUCAAAGAGGGAUAAGUCAGAAGACCUGCCAAGACAACAUAGUUUUAG,58,54,50,47,209
1141,3,CP000140.1/2695629-2695426,UAUCUUUGCUACAUGCUUUGUUCCCUUUCGGCAAUCGCCGGAUAGGGAUUAAAAGGGAAUCGGGUGAGAAUCCCGGACAGUCCCGCUGCUGUAAGCUUCAUAAACGGGUUGAGCAAUACUGUUGCCACUGUUCAUUCAAGUGAAUGGGAAGGCGCUUAAGACCGGAAGUAAGUCAGAAGACCUGCAAGGCGUGUAUAUUUUCGA,53,54,55,42,204
1142,3,CP000698.1/4850452-4850264,UAAAUAGUUAUUCGAUCUGGUGCGCUCACUAACAAGAGCGUUAAAAGGGAAGGAGGUGUAAUUCCUCCACUGUCCCGCAACUGUGAACGGUGAUGAAAGCCGCUGAUGUGCCACUGAAUAUAAUCGGGAAGGCGCGGCAAGUAAAGUGACCCGUAAGUCAGGAAACCUGCCAGGCUGAUUGCUCAAUGG,55,41,53,40,189
1143,3,CP000383.1/1884029-1884217,ACCUUUGUUCCCGUUAAUGGUUUAUUUCAACGUUUGAAAUAAUUAAAAGGGAAGCCGGUGUAAAUCCGGAACAGUUCCCGCUGCUGUAAGCUCAUCAUUACGUUAUAUUUCAUUUAGCCACUGAAUUUAUUUGGGAAGGCGGAUAUAACAGAGUAAGUCAGAAGACCUGCCACUAACACACUAUUCGAA,58,57,37,37,189
1144,3,CP000382.1/2263667-2263491,AAAUUGUAUAUUAGCUUAGGUGUCUGAUUAAUUUCAGGUGAAAAGGGAAUACGGUGAAAAUCCGUAACAGCCCCCGCUACUGUAAUGUGGACAAAUCUAAAACCACUGGUUUAUAACCGGGAAGGAAGAGGAGGAUGAAACUAAGUCAGGAGACCUGCCUAAGCUUUGGAUAAAGAC,62,42,44,29,177
1145,3,AARF01000375.1/31-230,UUGCAUAUUGUGGAGACAGGUGCUUCGUCUGUAACGAUGAAACUUAAAAGGGAAGAUCGGUGUAAAUCCGUCGCGGUCCCGCCACUGUAACAGAGGAGCCUUGUGCCAGGCAAACGCCACUGGUCUAAGAUGACUGGGAAGGCGGCUUUAAGGCGAUGAAUCUGGAAGCCAGGAGACCUGCCUGUUCUAACGACACUGCU,52,44,59,45,200
1146,3,AL591985.1/66246-66476,ACAUUAACUGGGACCGACGGUUCCCCUACCCGUGAGGUGGAGGGGAUUAAUAGGGAACACGGUGCGGACGACCCAAGAGGGACCAAAACCGUGGCUGCCCCCGCAACUGUAAGCGGAUCGUCGUUCAUCCUUGUGGCGCCAAGGCGCCAGCCACUGCGCGCGUUGCGCGGGAAGGCAGAUGAGCGACUCUGUCCGUGAGCCAGGAGACCUGCCGUCAAAUCGAUCCAACGU,52,37,74,68,231
1147,3,AAQF01000040.1/17254-17069,UUGGGCGAUUGCCGACCUGGUCGCGGGCCUGGGGAGAAUAGGAAAUCGGGUGUAAAUCCCGAGCGGUCCCGCCGCUGUGAACGGGGAGUGAUUCCGGUAAAUGCCACUGGCCGCCAGGCGGCCGGGAAGGCCCGGAAAAACGAUGAGCCGUGAGCCAGAAGGCCUGCCCCUUGGUUAGCCGCCGCC,36,28,69,53,186
1148,3,AASF01001990.1/2185-2411,UCCUGCGGCUCUGCUUCAGGUGUCCCAAGGGUAUCCACCCCCAAGGGAUGAAACGGGAAGCCGGUACGUACUGGUGAAAAUCAGAACAAUUCCGGCGCUGCCCCCGCAACGGUAGGCGAGUUGCGGCGGAUCAUACAGCCACUGCGUUUCGACGUGGGAAGGCGAUCCGCCAGGGUCUGCAAGACCACUCGCAAGCCCGGAGACCGGCCUGGAGCCCAAGGAACCUC,51,35,70,71,227
1149,3,CP000450.1/2027042-2027265,CUCCACUCCCUUGCUUGAGGUGUCCCAGAUGCAUUUGCACGAGGGAUGAAACGGGAAGCCGGUGCGCACUGGAAUCAAACAAUGCAAUGCCGACACUGCCCCCGCAACGGUAAAUGAGUCAAUAUUCUGCACACGCCACUGUGCCAUCCGGCACGGGAAGGCGCAGAAUCAGGAAAUAAAUCUACUCACAAGUCCGGAGACCGGCCUGAAGCAAUAUCAUGUUA,64,41,56,63,224
1150,3,CR626927.1/1843997-1843789,UUAUCUUUGCAGUGCAUUGGUUUGUAUUCUCCGUGUUCCGGGGAUGCAAUUAAAAGGGAAUCAGGUGCAAAUCCUGAACAGUCCCGCUGCUGUAAGUUUCACAUCAGAUUGUUGUAAGCAACCACCACUUGCCACUGGGAAACGUUUCCUGGGAAGGCGCUUAUCAACAGAAACGAGUCAGAAGACCUGCCUGUGCAUCUUUUUCAUUG,52,61,49,47,209
1151,3,AAMV01000013.1/62699-62923,UGCAUACGAGAGUGGCAAGGUUCCUCGUUUCGGUGCAAAGCGCCGCGAGGAUAAAUGGGAAUGACGUGCCGGCGGACCCAAUCAGGGCGUCCAUGCGUCAGCCGCCCCCGCGACUGUAAGCGGCGAGCCCCUGCCAGAUGCCACUGAGGUGUAAAACCCUUGGGAAGGCGGCAGACAGGCGACGACCCGCGAGCCAGGAGACCAGCCCUGCGUUUGUUAAUCCCG,49,34,74,68,225
1152,3,CP000698.1/931897-931705,AACUGAAUAUCGGAUCACGGUGCCCGCAAGGGCUUGAUAGGGAAGAGGGGUGCCGCUCAAACCGAGCCAUUCCCCCGCGGACCCGCCGCUGUAAGCGAGGACGAAGGGCAUUAUGUCACUGGUCGAAAGACCGGGAAGGCGCCCGGAGGAUGAAUCGCGAGCCAGAAGACCUGCCAUGAUCUUAGCACUCAAC,50,28,61,54,193
1153,3,AAXV01000016.1/49194-49376,UCAUAUAAAACGUCGAUAAGUGCUCGAAGAACUCGAGAUAAUAGGGAAAUUGGUGAAAGUCCAAUACAGCCCCCGCUACUGUAAUAGCUGAUGAAAUCGCAAUGCCACCUGUGCAAACUAGGGAAGGUGCGACAGUAAAAUGAAGCUUAAGUCAGGAAACCUGCUUAUCAGAUUGUGCAUGCA,64,40,43,36,183
1154,3,AM406670.1/3903431-3903207,AAGGUGCGGCGCGUUUCAGGUGCCCGAAGGCGGUCCUCGCCCCAGGGUUAAACGGGAAACAGGUGCGCGCCUCCGGCGCAAUGCCUGUGCUGCCCCCGCAACGGUAAGCGAGUGCAAGGCGCAUCAACAGCCACUGGGUCGUCCCCGGGAAGGCGAUGCGUCGGAGCCGGCCACAGCCGCUCCAGCCCGCGAGCCCGGAUACCGGCCCGAGCGCGAACUGGCGGA,41,26,80,78,225
1155,3,AP006840.1/361924-361720,UAUAUUGGGGUUGUGACCGGUGCACCUAUCGGGUGCUGAAAAGGGAACCCUGUGCGAAUCAGGGACUGCCCCGCAGCGGUGAGCAGGAACGACCGCCACAGCAAGCACUGGGCUCCGGCCUGGGAAGCGUGGCCAGUAGGACAGGCGGCAGAUGGUGCCGCCCCGCCUGCAAGUCCGAAGACCUGCCGGUCAUCCGCUUUCAGGG,41,32,72,60,205
1156,3,AAQG01000005.1/141632-141818,AACGGCCGCGCUGCGACAGGUUCCCCGGCGACGGGGAUGAAAAUGGGAACGGAUAACAUCCGGCUGCCCCUGCAACUGUAUGCGGUGAGUCAUCGGCCAUAUGCCAUUGGAAGCGCAGCUUCCGAGAAGGCGACCGACCGGCGUUGACCCGCAAGCCAGGAGACCUGCCCGUCGCCGUCGUCUUUCG,38,30,60,59,187
1157,3,CP000058.1/2582044-2581830,CCUGUACGCCUUGUUUCGGGUGCCCCUCACGGGGUGAAACGGGAAACCGGUGCGCUCACGCUGUCGAGCAAGUCCGGUGCUGCCCCCGCAACGGUAAGCGAGAGAAGGUCUUAUCCACUGUGCUACGGCAUGGGAAGGUGACCUUGCAGGCCUUGAACGCGCGACGUUUGAGCCCCUCGCGAGCCCGGAGACCGGCCCGACAUCGUUGAAUGACA,41,39,69,66,215
1158,3,ABDX01000004.1/114276-114455,UAAUAUUUUAUAUUUUUAGGUUUGAUUUUAAUUAAAAGGGAAAGUGGUUAAAGUCCACUACAGCCCCCGCUACUGUGAUAGGAUACAAGUUUCUAUUUGACCACUGAUUAUAUAAAUUGGGAAGGGAGAAAUGAGGAUAAGCCUUAAGUCAGGAUACCUGCCUAAAGAUCAUGAACUAAG,62,56,37,25,180
1159,3,CP000716.1/734867-735049,AAAUAAUAAAACAUCUAGGGUACCAAGCGGUUUAAAAGGGAACUCCGGUGAAAGUCCGGGGCUGCCCAGCAACCGUAACCGGGGACGAAAUCCACAAAAUGCCACUGGGAAUUUUUCCUGGGAAGGCGUGGAGAGUAGGUUGAUCCGGGAGCCGGGAGACCUGCCUUAGAUGUAUGGACUCCA,54,34,55,40,183
1160,3,AP006840.1/2074430-2074237,AUAGAGCAAACAGCGGCAGGUGCUCCCGACCCUGCGGUCGGGAGUUAAAAGGGAAGCCGGUGCAAGUCCGGCACGGUCCCGCCACUGUGACGGGGAGUCGCCCCUCGGGAUGUGCCACUGGCCCGAAGGCCGGGAAGGCGGAGGGGCGGCGAGGAUCCGGAGUCAGGAAACCUGCCUGCCGCGCUGGCGCUGCU,36,24,76,58,194
1161,3,CP000382.1/1272358-1272535,AAAUUAAAUAAGUCAUUAGGUGCUCUAUUAUAAGAGGUAAAAGGGAAAGUGGUUAAAAUCCACUGCAGCCCCCGCUACUGUAAAUGAGGAUGAAAUCUAAAUUGCCAUCCAUAAGGAGAAGGUUAGAAAGUAAUAUGAUCCAUAAGCCAGGAAACCUGCCUAAUGUACGAUUAUUUAA,69,45,36,28,178
1162,3,AAYC01000008.1/31758-31987,GAUAGCGCUGGAGAGGAUGGUUCCUGCGAGACACAAACUGUGUGUCCAGGAUGAAAAGGGAACGCGGUGCGGCUGGUACUGAUCAGCCAAUUCCGCGACUGCCCCCGCAACUGUAAGCGGUGAGCGGACCGGGUGAACCACUGGCAUGGAGUUUUGCGCUCCAGGUUGGGAAGGACCGGUUUCGCAGCGACCCGCAAGUCAGGAGACCUGCCAUCAUAUGAAAACUCGAA,56,41,75,58,230
1163,3,AE016853.1/3679925-3680123,UUUACCAUGCCGGCCGUCGGUUUCCGAGAGGAACUAACAGGGAAUUCGCCAGCUUUGUUUCAAAGGCCAAAACGAAACUGCCCCCGCAACUGUAGGCAUCGAGCCUGCUCCAAGACUGCCACUGGAUUCAGAUCCGGGAAGGCCGGAGCAUGGUGAUGACAUGCCAGUCAGGAGACCUGCCGACCCGAUUCAACCAACU,51,37,52,59,199
1164,3,CP000702.1/858840-859024,AAGCCUCCCUCACCGUGCGGUACCCUUCGGGGUUCAAAGGGGAAGCCGGUGGAAAUCCGGCGCGGGGCCGCCACCGUGACCGGGGACGAAACCCGCAGAACGCCACUGGGGCGAUCACCCUGGGAAGGUGCGGGGAGUAGGAUGAUCCGGAAGCCGGGAAACCCGCCCGCGGUGAAGGGAAACCA,41,19,69,56,185
1165,3,CP000157.1/1649862-1649676,CGGCUGCUUCACGUCACGGGUUGCCGCGUAACACCGGCCGAAGAGGGAAGGGAGUGCGAUGCUCCCGCUGCCCCCGCAACUGUGACCGGGGAGCGACCCUGCCAAGGGCCACUGGUUUCGACCGGGAAGGCGGCGGGGAAGCGACGAUCCGGGAGCCAGGAGACCUGCCCGAGACCGUCGCUUGAGC,34,23,70,60,187
1166,3,ABDP01000007.1/7251-7432,AUUUAAUAAAAAGAUUUAGGUGCCUUUACAUAAAAGGUGAAAAGGGAAUGUGGUAAAAGCCACAGCAGCCCCCGCUACUGUAAUUGAGGACAAAUCUUUCAUAAACCACUCUUUAAAAAGGGGAAGGGAAAGAUUAGGAUGAAUCAUGAGCCAGGAGACCUGCCUAGAUUUUUAUUAGGGAA,68,44,42,28,182
1167,3,AALV01000003.1/110855-110656,UGUCAUCGAAACCGGGUCGGUUUCCUUCGGGAAAUAAUAGGGAAUUCGCCAUCCGCCCUUUGGUGUGGAUGAACCGGAACUGCCCCCGCAACUGUAGACGGUGAGCUACCUCCAUCAUGCCACUGGGCCUAAAGGUCCGGGAAGGCGGGGACAGCCGCGAUCCGUCAGUCAGGAGACCUGCCGACACUGAACCUGAAACA,47,37,58,58,200
1168,3,AAVM02000005.1/21577-21370,CUAUCUUUGUCGCGCAUCGGUUUGCAACUCUCACAUACGAGGGAAGCGAUUAAAAGGGAAUCAGGUGUAAAUCCUGAACAGUCCCGCUGCUGUAAGUUCCACACAUUACGUUGCGAGCAACCUACUUUUAGCCACUGGAAAGAAACUUCCGGGAAGGCGCCCGCAACAGGAACAAGUCAGAAGACCUGCCGUGCAACCAAUUUCACUG,60,45,48,55,208
1169,3,CP000158.1/1153196-1153386,ACGCCGCCUCACGCAACAGGUGCCCGGAUCAUGGUCCGGGUGAAAAGGGAAGCCGGUGAGAAUCCGGCGCUAUGCCCGUAACUGUGAGCGGGGAGCCGUGUGAGCCAUACGCCACUGGGAAACCGGGAAGGCAGCUCUCUCCGGCGAUGAUCCGCGAAGUCAGGAGACCUGCCUGUUGCCGUCGUUGGCUC,38,31,66,56,191
1170,3,CP000482.1/1280913-1280737,ACACUCAUACCGGAUCAGGGCGCCCGACAGGGCUUGAUAGGGAAGAGGGGUGCGACUCCCCCGCGGACCCGCCGCUGUAAGCGAUGACAAGGGGCAACGGCCACUGGUUUUUGACUGGGAAGGCGCCCGGAGGAUGAAUCGCGAGCCAGAAGACCUGCCACUGAUCCACGCCACUCA,41,24,58,54,177
1171,3,CP000724.1/3721369-3721186,GAUGAAUUAAAUCGAAUUGGUGCUUUAUCAAAGCUUAAUAGGGAAAGUGGUUGAAAUCCACUACAGCCCCCGCUACUGUAAGUGAGGAUGAGUCCAGCAAAACCACUGAUUGUGUCAAUUGGGAAGGUGCUGGGUGUCAGAAGAAUCACAAGUCAGGAGACCUGCCAACCCUAAUUCCAAACAA,61,42,44,37,184
1172,3,CP000036.1/1206778-1206953,UCAUAACAUACGCUGACAGGUGUGGCACAUUUGUGCCUGGGAAGAGAGUGAAAAUCCCUCGCAGCCCCCGCUGCUGUAAUGCUGACAAACCCGAAAAUGCCACUGAUCGCGAGAUUGGGAAGGUCGGGAGAGGAUGACGCUAAGCCAGAAGACCAGCCAGUCAGUCAAUACCAACA,53,30,48,45,176
1173,3,AE015927.1/769982-770164,UUUAAUAUUAUUUUAUUAGGUGCUUUACAAGUUAAAAGGGAAAGUGGUGAAAAUCCACUGCAGCCCACCGUUACUGUAAUGCUGACGAAAUCUUAUAAAAUCCACUAGAUAUAUUUUAUCUGGGAAGGUUAGAAAUUAGGAAGAAGCUAAGCCAGGAAACCUGCCUAAUAAGUGUUAAUUCUU,64,57,35,27,183
1174,3,AE015928.1/1836296-1836502,CUAUCUUUGUCGCGCAUUGGUUUGCAACUCUCAUGCACGAGGGAAGCAAUUAAAAGGGAAUCAGGUGAAAGUCCUGAACAGUCCCGCUGCUGUAAGUUCAUUUUUUGGUUGCGAGCAAUCGACUUUAUAGCCACUGGAAAGCAAAUUCCGGGAAGGCGUUCGCAACAGGAACAAGUCAGAAGACCUACCAUGCAAACUCGUUUCACU,59,52,49,47,207
1175,3,CP000662.1/326212-326417,AAUGACAGGCGCGUGAUCGGUUCACCCGGGCGUCAUGCGUCCGGGGAUUAAAAGGGAACGCGGUGCGCCCCGAAGGGGCAAGACCGCGGCUGCCCCCGCAACUGUGAGCGGUGAGCGACGCCGAAGAUGCCACUGGGAGAUCCCGGGAAGGCCGGCCGAGCCGAGACCCGCGAGCCAGGAGACCUGCCGCUCGCCCGCCGGCCCCC,39,20,76,71,206
1176,3,AAUW01000004.1/197975-198192,GUUUAGGAAGAAACUGACGGUUCCGGAGAAGGCCUUGCCCGAUCCGGAUGAAACGGGAAUCCGGUGAGGGCUUUUCAAGUCCGGGUCCGGAGCUGCCCCCGCAACUGUGAGCGGUGAGUGGCUGUACGAAAACCACUGGCGUCCUGAUGGGGCCGGGAAGGGGUACAGACCGCGCUGAGCCGCAAGCCAGGAGACCGGCCGUCGCAUUGGCAACCCUU,46,36,77,59,218
1177,3,AAMO01000002.1/489939-490150,GGCACAACCGAAAGGCAUGGUUCCUCAGACGGGUCUCAGGCCCGAGGAUCAAAUGGGAAUGCGGAGAGGCGACCCACAUCGGGGCCUUCAGCCGCAGCCGCCCCCGCGACUGUGAGCGGAGAGCAUGUGUCACGAGCCACUGGGCAACCGGGAAGGCGGCACGAUGCGACGACCCGCGAGCCAGGAGACCAGCCCUGCGUCAAUUCUAACCG,49,24,71,68,212
1178,3,CP000557.1/1789202-1789010,UGGCGGUAAGACAAACAAGGUGCCUAGCCCGCUUAGGGCUUGGGUGAAAAGGGAAGCUCGGUGAAAAUCCGGCACGGUGCCCGCCACUGUGAUGGGGAGCUUUGCGGCAACAAGUCACUGAAGGAUGCUUCGGGAAGACGCCGCCAAGCGAUGAUCCUAAGUCAGGAGACCUGCCUUGUUUGGAUCGGACGGA,47,35,66,45,193
1179,3,CP000076.1/5141454-5141221,CCUUCGCGACUUGUUUCAGGUGCUCUGUGGCCCGUGGCCGACAGAGUGAAACAGGGAAGCCGGUCAGGGUCUGUUCCAGUGAUGGAGCCGACGACGAUUCCGGCGCUGCCCCCGCAACGGUAGAUGAGUCAAGACUGCGCCUGACGCCACUGUGUCAAUGACACGGGAAGGCGCGCAGUCCGGCAGCCAUGCCGCUCAUGAGCCCGGAGACCGGCCUGAUCCAUCCAACGGCAU,46,40,75,73,234
1180,3,CP000490.1/1574718-1574933,GCAAUGCGGGGCCGCUACGGUUCCGGCGCGAUCUGCCGGAUGAAAAGGGAACACCGGCGCGCCCAUCGCCGCGAUGCGGACGGGCAAGGCCGGGGCUGCCCCCGCAACUGUAGGCGGUGAGCGAAGGCCGAAGGCGCCACUGGGAAGAUCCCCGGGAAGGCCGGCCCGAGCGAUGAUCCGCCAGCCAGGAGACCUGCCGCAGCGAUCACCCAUUUC,42,22,79,73,216
1181,3,AAYC01000003.1/114698-114499,AAUUUUCCUAUUAAGUAAGGUGUCGUCCCAUUGGGGCGGAGAAUUGGGAAGCCGGUGUGAAUCCGGCACUGCCCCCGCAACGGUAACAUCGGGCAAGGGCGUAGCAAGAGCCACUGGGACGAGGACCCCGGGAAGGCGCUGCGGCCGGUCAUUUGACCCCGAUGAAAGUCCGGAAACCAGCCUUGCCUUGAUAGUCAAAC,48,36,63,53,200
1182,3,AE015451.1/1866934-1867155,CCUUCGCGGCGUGUUUCAGGUGCCCUGCCAGCCCCGACUGGGCAGGGUGAAACUGGGAAGCCGGUGGGCGCCAGCAUGGCGCGAUUCCGGCGCUGCCCCCGCAACGGUGGAUGAGUAAAAGGCCGCGCAGGGCCACUGGAUGCCAGCAUCCGGGAAGGCGCGCAGGCCAGGGCCAAGGCCCACUCACAAGCCCGGAGACCGGCCUGAUACUGCCAACGGCAU,42,27,79,74,222
1183,3,CP000699.1/5269738-5269503,UCCAAUGGAUGCUGUCGAGGUUCCCUGCUCGCGAUCCGGCAACGGGUCGCGCGGCAGGGCUAAGACGGGAAGCCGGUGACGUCCGCGAGGACGGAGUCCGGCGCUGCCCCCGCAACUGUAAGCGGCGAGCGGCGGUUUCAACCAUGCCACUGGCGCCCCGCGAGGAGCGCCGGGAAGGCCGGAGCCGCCGUGACGACCCGUGAGCCAGGAGACCUGCCUCCGACGCGAUAACGUUC,41,30,86,79,236
1184,3,AAMS01000001.1/256679-256898,GGCACAACAUGACGGCACGGUUCCCCGCACGGCGCGCAGCGUCAGGGGAUCAAAUGGGAAUGUGGACGCGCCGAUCCUGUCAGGGAGGCGCCAAGCCACAGCCGCCCCCGCGACUGUAUGCGGAGAGUGCCUUGUUAACAUGCCACUGGGUCCGCCCGGGAAGGCAACAAGGUGCAUCGACCCGCAAGCCAGGAGACCAGCCAUGCACCGGGGAUCGCCC,48,26,73,73,220
1185,3,CP000463.1/4804452-4804231,GUUGGUGAGCACUGCCGAGGUUCCCUGCUGCAGGCGUUUCAGCAGGGCUAAGACGGGAAGCCGAUGGCGCUCGCGUUGAGCGGAAUUCGGCGCUGCCCCCGCAACUGUGAGCGGCGAGCGGCGGUUCGAUGGGUGUCACUGGCGUUUACGAAGCGCUGGGAAGGCUAGAACCGUCGCGACGACCCGUGAGCCAGGAGACCUGCCUUUGGCGUGAUGACGUUC,37,42,83,60,222
1186,3,AM420293.1/6688888-6688698,GACCUCGGUCGCUCUGGAGGUCAGGAUACGACGGCCUGCGGCGCAGGAACCCGGUGCGAAUCCGGGACGGUCCCGCCACUGUGACCGGGGAGCGGACCCGACGUGCGGCCACGGCCCGUGAGGGCUGGAAGGCUCGGGUGACCCGCUGCGAUCCGGGAGUCAGGAGACUCGCUGCCGGCCCCGCGUCGCGC,27,23,76,65,191
1187,3,CP000264.1/2958160-2957972,GAACAGGGUCACGGCGAUGGUGCCCUUCUUGGAGGGCCUAAGAGGGAACGCGGUGAAACCCCGCGGCUGCCCCCGCAACUGUAAGCGGUGAGCGGACCUGCGUAUGCCACUGAGCCGACAAGCUCGGGAAGGCGCAGGCCCCGCCCUGACCCGCAAGCCAGGAGACCUGCCAUCACCUGUGAAACGCAU,41,24,62,62,189
1188,3,AP008230.1/3094247-3094065,AACAAUUUAAGGAUUUCAGGUGCCCUUCGCCAAGAAGGGAGAAUAGGGAACCGGGUGCAAUUCCCGGACGGACCCGCCACUGUAAAGAGGAGUCUCAGCGCUGAAUGCCACUGGGUAACUGGGAAGGCAGCAAGGAGACAAUGACUCGAAGUCAGGAGACCUGCCUGGAUCCGGGGACACAUG,53,29,58,43,183
1189,3,AE015927.1/793516-793697,GAAUAUUAAAAUUUAUAGAGUUACCCAUUUUUGGGGUUAAAAGGGAAGGGGGUUAGAAUCCUCCACGGUCCGGCCACUGUAAUUGGUAAGUUUAUUCCAUAAGCCAUUGAGAUAUUCUCGAGAAGGUGGAAAUAAAUGAUGAACCAUAAGUCAGGAGACCUGCUUUAUAUUUAAGAUGCAGC,59,53,43,27,182
1190,3,AAEW02000025.1/17075-16893,UCUGCGCUGAAAGUUUCAGGUGCUUGUUGCAAGCACAAUAGGGAAUUCCGUGAAAUUCGGGAGUGGGCCCGCCGCUGUAACCAGGGACGAUCAACACAUUUGGCCACUGACUUAGAGUCGGGAAGGCGUGUUGAGACGGAAGAUCUGGAAGCCAGAAGACCUGCCUGAAACGCAAUGGUUGCA,48,38,57,40,183
1191,3,CP000724.1/79239-79421,AGUACAUAGAAUACGUUAGGUGUUUCAUAUGAAACUUAAUUGGGAAAGUGGUGAAAACCCACUGCAGCCCCCGCUACUGUAAGUGCAGAUGAACUCGACAAAAGCCACUAGAUCAAUCUGGGAAGGCGUCGAUAGUAAGGUGAAGCACAAGUCAGGAGACCAGCCUAAAGUAAGAAUCAGCCU,64,37,45,37,183
1192,3,ABCF01000001.1/214794-214982,UACAUAUUGUCGUAAACAGGUGAUUUCAGUCGAAUCUGAAGUCUUAAAAGGGAAGUUGGUGAAAUUCCAACGCGGUCCCGCCACUGUAAAUUGGGAGCAAGCUGUGAUUAACCACUGUACUAAUGUAUGGGAAGGAACAGCGAGCAAUGACCAUAAGCCAGGAGACCUGCCUGUUACUGCUGCACCACA,58,44,47,40,189
1193,3,CP000076.1/4227691-4227479,GUAGCCUUGCGCUUUCGAGGUUCUUCGGCCACGGGUCGAAGCUAAGAAGGGAACGCGGUCGAUGCCGCGGCUGCCCCCGCAACUGUGAAGGGUUCGAUUGCUGCAAGGCCACUGCAUGGGCGUCGACGACGCCGGUGGGAAGGCGCAGCAAUCGCCGGUCCGACGACUGGCAAGCCCUCAGCCAGGAGACCUGCCUCGAUCCCAGAUUCUCAC,40,36,70,67,213
1194,3,CP000482.1/1300492-1300303,AGUUGAAUACCGGAUCAAGGCGCCCGAGAGGGCUUGAUAGGGAAGAGGGGUGAGCUCCGAAGAGCGAUUCCCCCGCGGACCCGCCGCUGUAAGCGAUGACAAAGGGCAACAGCCACUGGUUUUUUGACUGGGAAGGCGCCCGGAGGAUGACUCGCAAGCCAGAAGACCUGCCUGAUCUCUGCACUCAAUA,48,31,61,50,190
1195,3,AAXE02000112.1/379532-379335,UAUAUUUGUCCCAUGCAUUGUUCCUGCUUCGCAAUCUGCGGAAAAGGAUUAAAAGGGAAUCGGGUGCAAAUCCCGGACAGUCCCGCUGCUGUAAGCUUCAAAACGGAUUGGGCAAUUCUUUUAUGCCACUGACGCGAGUUGGGAAGGCGCUCAUACCGGAAGUAAGUCAGAAGACCUGCAACGCAUAUUUUUUCGACG,52,51,50,45,198
1196,3,CP000578.1/1093642-1093821,GCUUUGUGGCAGGGGUCAGGUGCCGCCUUCGGGCGGAGAAUCGGGAAGCCGGUGGAAAUCCGGCGCGGGCCCGCCGCUGUGACGGGGAUGCUUCGGGCAAGAGGCCACCGGUUCGCCGGGAAGGCGCCCGGCGGCAGAUGAACCGGAGCCAGAAGACCGGCCUGACGCAGAGGUUCCCGC,30,22,75,53,180
1197,3,AAYA01000006.1/51136-50945,GCGAUCCCGUCCGUGUCAGGUGCCUCCGUCCUCGGGGGAGAAUCGGGAAGCCGGGGCAGAACCGGCGCGGGCCCGCCGCUGUGACGGGGACGGGGCGGACACAUGGCCACUGGGCGUCAGUCAGGCGCUCGGGAAGGCGUCCGUUCCGGAUGAUCCGAAGCCAGAAGACCGGCCUGACGGCAUGGCGGCCCC,30,23,77,62,192
1198,3,CP000724.1/86468-86650,AAAACUGAAUAUAUUUUAGGUGUUUCACGUGAAGCUUAAUUGGGAAAAUGGUGAAAAUCCAUCACAGCCCCCGCUACUGUAAAUGCAGAUGAAAUCGAUGAAGUCCACUGGAUUUUUCUGGGAAGGAAUCGAGAGUAAAAGGAAGCAUAAGUCAGGAGACCAGCCUAAAGACCAGUAACUACC,66,42,42,33,183
1199,3,AE015927.1/823404-823586,UUAAAUAUUUAUUUAUAAAGUUUCUUGUAAAAGAGAAUUAAAAGGGAAGGAGGCGAAAAUCCUCCACGGUCCGGCCACUGUAAUUGGUGAGUUUAUUCCAUAAGCCAUUGAGAUAUUCUUGAGAAGGCGGAAAUAAAUGAUGAACCAUAAGUCAGGAGACCUGCUUUAUAAGAAUAAAUAUAC,68,52,38,25,183
1200,3,AAMV01000014.1/59909-60128,UUAGGCUGAUCCUGUCAUGGUGCCAUGCCGACAGCAGUCCACUGCUCUCGGGAUGGAGAAUUGGGAAGCCGGUGCGAUUCCGGCGCUGCCCCCGCAACGGUAAGGGAGGGCGUUUCGGCGAUAUGCCACUGGGCGACAAUGCUCGGGAAGGUGCCGCGACGCGAGGGUCAUCCGGCCCGCCAUCCAAGCCCGGAAACCAGCCUUGGCGUGACGUCGAAUC,41,38,75,66,220
1201,3,AE015927.1/793388-793200,AAUAGUAAAUGAAAUUUAGGUGUCCACUUUGUAAAAAUGAUGGAUGAAAAGGGAAUGUGGUUCAAUUCCACAGCAGCCCCCGCUACUGUAAUAGAUGACAAGCCUUUAGUAACCACUCUUUAAAAGGAGGAAGGUAAAGGUUAGAAUGAUUCUUAAGCCAGGAGACCUGCCUAGAUUGUUAAAAUCCUC,66,50,41,32,189
1202,3,CP000248.1/1228186-1228384,UGGCGCGCCGACGCCAGAGGUGCCCGGUAACACGGGCUAAGAGGGAAGCCGGUUCGAUUCCGGCGCUGCCCCCGCAACUGUAACCGGAUAGCGCGUCGCCCAUUCAUGCCACUGGUGUCGGCUUCGGCCAGCACCGGGAAGGCGGGCGACGAGCCGUGACCCGGAAGCCAGGAAACCUGCCCUUGGUUGUCGUUCCGCG,34,30,69,66,199
1203,3,AATQ01000008.1/108753-108536,CAUCACUGACGCAUAUCCGGUCCCGGUGCAGUCUCUGCCCCGGGCGCAAGAAGGGAACGCAGUGCGGCACGGGCCAUUCGGUCACGGCCAAUUCUGCGACUGCCCCCGCAACUGUAAGCGGCGAGCAACGGCUGAUCGUGCCACUGGAGCAAUCCGGGAAGGCCAGCCCGCGCGAUGACCCGCAAGUCAGGAGACCUGCCGGAUACGCGCCCCUGGAA,45,29,69,75,218
1204,3,AE015451.1/3857543-3857766,CCUUAUGCCUCGCGUUCAGGUGCCCCUCAGGGGGUGAAACGGGAAACCGGUGCGUCCCAGGCCCUUCAGCAGGGCCGGACAAUGCCGGUGCUGCCCCCGCAACGGUAAGCGAGUGAAGCGUCUGUACCACUGUGCCUCGUAGUACGGCAUGGGAAGGUGACGCGUUCCAGGAGCCCAGCUCUUCCUCGCAAGCCCGGAGACCGGCCUGGCGUUCAUGAACACCC,41,38,71,74,224
1205,3,AAOE01000043.1/7099-6915,GUUGGCGAUGUCACUGACGGUUUAAGACAAGCUGUACUUGUCUGGGAAUCCGGUUAAAUUCCGGAGCUGCCCCCGCAACUGUAAUGGUCAGGACGAUGUCUGUUUGCCACUGAAAAUUAUUUUCGGGAAGGCGACAUCGAGCCGUAGCCAGAGCCAGGAGACCGGCCGUCGUGCAUCUCGCAUCA,42,44,53,46,185
1206,3,CP000076.1/2504928-2504724,AUAUGCCGCCCAGUUUCAGGUGCCUCCUGCCGCCGUGCAGGAGGUGAAACGGGAAACCGGUGCGCCCCUUUUCGGGCAAGUCCGGUGCUGCCCCCGCAACGGUAAGCGAGUGCUGCAUUCAACAGGCCACUGUACCCAAGGUAUGGGAAGGCGAAUGCCGCCAGACUCGCAAGCCCGGAGACCGGCCUGUGACGUCUGUUUGGCA,40,36,65,64,205
1207,3,AE015927.1/2416636-2416459,AUUUAAUAUUAGAUUUUAGGUGUGAUCUUAUAAUUACUUAAAAGAGAAAGUGGUGAAAAUCCACUACAGCCCCCGCUACUGUAAUAGUGGACGAUUCCUAUUAUCCACCAGUUAACUGGGAAGGAAGGAUAAGGAAGAAACUAAAGUCAGGAGAACUGCCUAAAAUAUAUUACUUCGG,65,49,36,28,178
1208,3,AAQF01000153.1/10735-10925,CCAAGUUGGGCGAUUGCCGGCCUGGUCGCGGGCCCGGGGAGAAUAGGAAAUCGGGUGUAAAUCCCGAGCGGUCCCGCCGCUGUGAACGGGGAGUGAUUCCGGUAAAUGCCACUGGCCGCCAGGCGGCCGGGAAGGCCCGGAAAAGCGAUGAGCCGUGAGCCAGAAGGCCUGCCCCCUGGUUAGCCGCCGCA,37,26,72,56,191
1209,3,CP000139.1/5040129-5040332,GUAUCUUUGCAGUGCAUCGGUUCAUUUAUCUCCCCUCCGAGGUGAAUGAUUAAAAGGGAAUCAAGGUGAGAAUCCUGAACAGUCCCGCUGCUGUAUGUUUCACUAAACGCAUAAGCAAAAUGCCAAUAACCACUGGGAUAAUUUCCGGGAAGGUGCUUAUAGCGGAAACGAGUCAGAAGACCUGCCUGUGCAUUUAUCAAAUCU,60,54,46,44,204
1210,3,CP000680.1/5037130-5036935,UAGCCUUCUCGCUUUCGAGGUUCUUCCCGGCAAGCCGCCGGGGAGCUAAGAGGGAACAGGGUCGAUGCCCUGGCUGCCCCCGCAACUGUAAACGGUCGCAACUCCUUCGAUACACCACUGCCUCAAGCGGGAAGGUGAAGGACGCACAGCGUGCAGACCGUGAGCCAGGAGACCUGCCUCGAUAGACCAGCCACUU,43,33,57,63,196
1211,3,AAYC01000005.1/102065-102276,GCGCAAGGGGGUUCAGCUGGUUCCUGGGGAAACCUGGGCGAAGAGGGAAUGUGACAGCUGGAAUUAUCUGGCAAAAAGCACAGCCGCCCCCGCGACCGUGACCGGAUGAGACCGCCAUGCCACUGGGACACCCCGGGAAGGCAGGAGGGUCGACAGAGCGCACGCUCUGGCAUCCGCAAGCCGGGAGACCUGCCAGCAAGAGGAGAUUUCAA,53,26,74,59,212
1212,3,CP000377.1/2318941-2319180,GCGCAAGGAAAUUUCGUUGGUUCCCGAAGGUGACAGCCUUUGGGCGAAGAGGGAAUGUGUCGGGCCGGGAUCAUCCUUGCUCCAAACACAGCCGCCCCCGCGACCGUGACCGGAGAGGUCUUCCAACGCCACUGGCGCGCCCCUUGUGGGCAGGCCGGGAAGGCAGGGAGACCGUUCGCGCCCCACUCGGGGCGGAUCUAUCCGCAAGCCGGGAGACCUGCCAACGCGUGAGAACCGGCG,46,35,83,76,240
1213,3,AAQG01000024.1/17748-17526,GUUGAAGGAGCCUGUCGAGGUUCCCCGCUUCAGGCAUGACGGCGGGGCUAAGACGGGAAGCCGGUGGUGCCCUUUGGGCAGAGUCCGGCGCUGCCCCCGCAACUGUAAGCGGCGAGUGGUGGCUCCAUUUUGUGUCACUGAGCUUUUGCACGAGGCUCGGGAAGGCCGGAGCCAUUGCGAUGACCCGCAAGCCAGGAGACCUGCCUUCGACGGCAUAACGUUC,39,43,78,63,223
1214,3,CP000578.1/656987-656780,GUCACCUCAUGGCACGACGGUUCCCGAAGGUCGCAAGGCCCGAGGGAUGAAAAGGGAACGCGGUGAGGGGAAACCCGAGGCCGCGACUGCCCCCGCAACUGUGAGCGGCAAGCCGCCCCGACGGACACCACUGGCCGAUGGCUGGGAAGGUUCGGGGAUCGGCCACGACCCGCGAGUCAGGAGACCUGCCGUCGGGCGCAUCCGCGCC,42,21,76,69,208
1215,3,CP000301.1/3897402-3897187,UGCGAUAGUUAACAUGAUGGUGCCUCAAUCUCGAGUCUGCGUGAGUGGAUGCGAUCUUGAGGAUAAUAGGGAACACGGUGCAAAACCGUGACUGCCCCCGCAACUGUAAGCGGUUAGCCUGUCGUCCGAUACCACUGGGAAUUUCGUUUCCUGGGAAGGUGACGAUAGGUCAGCGAGCCGCGAGCCAGGAAACCUGCCAUCGCACGAUCAAUUUCG,52,48,63,53,216
1216,3,AAXF02000053.1/97071-97271,CUAUCUUUGUCGCGCAUUGGUUUGCGACUCCCAUGCGGGGGAAGCAAUUAAAAGGGAAUCAGGUGUAAAUCCUGAACAGUCCCGCUGCUGUAAGUUCCAUGCAUGUUACAAGCAAUUCACUCAUUGCCACUGGAGACUAAUCUGGGAAGGCGUUUGUAACAGGAAUAAGUCAGAAGACCUACCAUGCAAUUAUGUUUCACU,56,54,47,44,201
1217,3,CT573326.1/2524145-2524344,GUAGCCUUGCCGCUUCGAGGUUCUCCGGCGUUGGCCGGAGCUAAGACGGGAACGCGGUCGAUGCCGCGGCUGCCCCCGCAACUGUAGGCACUGGAACGGAUCGGCACAGCCACUGCGCACGCGCGGGAAGGCGCCAUCCCGCUGGCAAUGCUGCCGGCACAGUGCGAGCCAGGAGACCUGCCUCGUGACGUUUUCGACUU,33,33,68,66,200
1218,3,CP000557.1/868974-869170,AUGGUGAUUGCAAGCAAUGGUGUCCAUCAGGACUUAAUAGGGAAUCCGGUGCGAAUCCGGAACUGCCCCCGCAACUGUAUGUGCGGACGAAAUGGGAUGGCCACUGGCGGUGAAAGCUUGCACGGCACGCCGCUGGGAAGGACCCAAAGUAGGACGAUGCACGAGUCAGGAGACCUGCCUUGCUUGGAAGUUUCAUG,49,38,64,46,197
1219,3,CP000377.1/2333297-2333511,GCAUUGUCGACGGCAUACGGUGUCCCAGAGCGCAAAGCGCCGGGACUGAAACGGGAAUGAGGAACGGCGGACCCAAUCGCGGCGCCAAAGCCUCAACCGCCCCCGCGACUGUGAGCGGUGAGCGACAUUCAGCAUCCACUGGCCGCUGGGCCGGGAAGGAGAAUGAUCGCCGCGACCCGCGAGUCAGGAGACCGGCCGUAUGAAACGAGGACAGU,52,24,74,65,215
1220,3,ABCS01000025.1/79736-79534,UAUGAGCGGAGGGCCGAUGGUCCCGCGCGUGCGGGCCCGAGGGAAUCCGGUGGAAAUCCGGAGCUGCCCCGCAGCGGUGAGCGGGAACGAAAGCUGCAUCGAAGGCACUAGGCCACGCCCGGGAAGCCGCAGCGAGUAGGUCACCGGGGUCUCGACCCCGUCGCCCGCGAGUCCGAAGACCUGCCGUCGGUGUUGUCCGUCAC,36,26,76,65,203
1221,3,AAEW02000019.1/41610-41805,GACGUCAUAUUGGAUCACGGUGCCCAACGGGAGCUUAAAUGUCUCGUGAGGCUUGAUAGGGAAGAGGGGUGCAACUCCCCCGCGGACCCGCCGCUGUAAACGUGGACAACAGGCUCCAUGCCACUGGUUUCGACCGGGAAGGCGCCUGAAGGAUGAAGCGUAAGCCAGAAGACCUGCCUGAUCCCAACACUCAAUG,49,34,59,54,196
1222,3,ABBE01000883.1/365-556,UACGCCCGUUCGUUCGCCGGCGCCCCUCGGGGCCGAAGAGGGAACACAGGGCGCGUGCCGCGCCGCUGUGGCUGCCCCCGCAACUGUAGGCAGCGAGCCCGCCUCCAUCUCGCGCCACUGGCUUGUCCGGGAAGGCCUGGAGCGGGCGUCGACCUGUCAGCCAGGAGACCUGCCGGCUUGAAAGUGCGUGCG,26,28,69,69,192
1223,3,AAYH02000049.1/356589-356390,CUAUCUUUGUCCACGUUUUGUUCCGCGUUCUCUAUCCGGAGAAGCGGAUGAAAAGGGAAUCGGGUGAAAGUCCCGAACAGUCCCGCUGCUGUGAGUUCCAUGCUCGGUGUAUCAUACUUGUGCCACUGUUCUUCGGGAAGAACGGGAAGGCGAUGUACCGGGAACGAGUCAGAAGACCUGCAAAACAAAGUCGAAAAAUU,52,48,55,45,200
1224,3,CP000058.1/3489261-3489461,UUUACCAUGCCGCCCGUCGGUUUCCGAGAGGAACUAACAGGGAAUUCGCACGCUUUGUCUGCACAAGGCCAAAACGAAACUGCCCCCGCAACUGUAGGCAUCGAGCCUGCUCCAUGACUGCCACUGGAUUAAGCUCCGGGAAGGCCGGAGCCUGGCGAUGACAUGCCAGUCAGGAGACCUGCCGACCUGCUUCAACCCACU,47,37,52,65,201
1225,3,CP000771.1/268818-268646,AUAAACCUCCCUUUGCAUGUUGAAAGGGAAGCCCGGUGAAAAUCCGGCGCGGGGCCGCCACCGUGAGUGGGGACGAAAUUCACAAUAUACCACUGGCCUAAUUUUGGCUGGGAAGGUGUGAAGAGUAGGAUGAUCCACGAGUCGGGAGACCUAACAUGCAAAGGAAGGGAGCC,49,31,55,38,173
1226,3,CP000489.1/1319736-1319936,AUUUUACCGUCAGAUCAAGGUGCCGGGGAAAUCUCCGGGUAAAAGGGAAUUCGGUGAGGCUGUCGCCAAAUCCGAAGCUGCCCCCGCAACUGUAGGCGGAGAGCCUGUCCGACAUGCCACUGGCGCGGAUUUCGCGCCGGGAAAGCUGGACCAGGUAAAGAUCCGCAAGUCAGGAAACCUGCCUGGAUCAAUCACCUGUUC,49,37,60,55,201
1227,3,CP000232.1/1116483-1116660,CAAAUUUAAUAAACAACAGGUGCCUGCAGGGUUAAAAGGGAAUCAGGUGUAAAUCCUGAGCGGUCGCGCCACUGUAACCGGGGAGUUUUUCCUCAGAGGCCACUGGUGAUCUACUGGGAAGGCGAGGAAAAGUAAUGAGCCGGGAGCCAGGAAACCUGCCUGUUGGUUCAACCCUCGC,49,36,53,40,178
1228,3,AAOX01000008.1/103201-103005,UAAGAAUCCGCAAGCGAUGGUGCCCUUUUAGGGCAUAAUAGGGAAUCCGGUUCAACGCCGGAGCUGUCCCCGCAACUGUAAGUGUGUACGAAAUGAGCAUCCACUGUAUAUGAACGCUGAAUAGGCGCAUAUAUGGGAAGGGCUCAGAGUAGGAUGAAGCACAAGCCAGGAGACCUGCCAUGCUUGUACGAGUUUCG,55,42,57,43,197
1229,3,CP000557.1/2323587-2323388,UUCAUAGACUCGCAGCAAGGUGCCGCGAAGGCUUAAUAGGGAAUCCGGUGGGAAUCCGGAACUGUCCCCGCAACUGUCAAUGCGGACGAAAUGAAAUUGCCACUGUGCGGCUGGAUGGCUUGCGCCGUCUCCCGCAUGGGAAGGCUUCAGAGUAGGAUGAAGCAUGAGUCAGUAGACCUGCCUUGCUUGCGCAAAAGUUU,48,43,61,48,200
1230,3,AAYC01000003.1/148871-149085,CAUUUAGCCAAAGUGACUGGUUCUACGAGUGCUUCAAUGCGCAGUGGAAGAAAUAGGGAACACGGUGCGGCGUACCCAAAAGGGACCAAAUCCGUGACUGCCCCCGCAACUGUGAGCGGUGAGUGACGCUGAACAAGCCACUGGGGUUCUCCCGGGAAGGCCAGCUGAACCAAGACCCGUGAGUCAGGAGACCUGCCGGACACAAAGAACGAUAG,61,33,65,56,215
1231,3,CT573326.1/1440491-1440711,CCUUCGCGGCGUGUUUCAGGUGCCCUGUGAACCCAGGUUCGGCAGGGUGAAACUGGGAAGCCGGUGGGCGCCAGCAAGGUGCGAUUCCGGCGCUGCCCCCGCAACGGUAGAUGAGUCGACGGCUGCGCAAGGCCACUGGAUUUCGUGAUCCGGGAAGGCGCACGGCCCGGGCAUGGCCCCACUCAUGAGCCCGGAGACCGGCCUGUCACUGCCAACGGCAU,38,35,78,70,221
1232,3,AAXE02000101.1/25986-25779,UACCUUUGCCACAGUUUUGGUUUCACGGCUCCCAACCGCUACGGGAGGCGUGAUGAAAAGGGAAUCAGGUGCGAAUCCUGAACAGACCCGCUGCUGUAAGUUCCUCUCCAAAUCUUUGAAUACGCUACAAGCCACUGUCCGUCACCGGAUGGGAAGGCAUUCAAAGACGGAACAAGUCAGAAGACCUGCCAAAACAAACAUAGUUUUA,61,45,48,54,208
1233,3,CP000075.1/4368222-4368008,CCUUCGCGGUUUGUUUCAGGUGCUCUGCAAUCCUCGAUUGGCAGAGUGAAACAGGGAAGCCGGUGUGGGUCGACAGAUCCGAUCCCGGCGCUGCCCCCGCAACGGUAAAUGAGUCAAGGCUGUGCCUGACGCCACUGUGUUUCGACAUGGGAAGGCGCGCAGCCGGGGUGACCCGCUCAUGAGCCCGGAGACCGGCCUGAAUCACUCAAUGACAU,43,42,68,62,215
1234,3,BA000043.1/2300644-2300445,UAAAUCAACUCGCAGCAAGGCGCCGAAAAGGCUUAAUAGGGAAUCCGGUGGGAAUCCGGAGCUGUCCCCGCAACUGUCAAUGCGGACGAAAUGAAAUCGCCACUGUACGGACGGAUGGCUUGCGCUGUUUUCCGUACGGGAAGGCUUCAGAGUAGGAUGAAGCAUGAGCCAGUAGACCUGCCUUGCUUGCCGCAGUUUCC,50,41,59,50,200
1235,3,CP000521.1/3325202-3325408,UGCGUUCAAAUGGAAGCAAGUGUAAGCAAUUGAUGCUUUAGGGAAGCUGGUGAAAGUCCGGCACUGCCCCCGCAACGGUAACAAUGUAAAGCAUAUUUUUAAGUCGAAAUCGACUUACACCACUGCAGUAGUGUGGGAAGGUGAAUAUGUCCAUAAAUGAAUUAUGGCGCUGAAGUCCGGAGACCUACUUGUUUCAUCUAUCUACCC,61,54,50,42,207
1236,3,AAYA01000018.1/10947-10742,CAAGGAAAUCGCAUGUCCGGUUCCGGAGUUUUCACGCUUCGGAGGAAAGAGGGAAUGCAGUGCGGCACGCGAGUGCCUACCCUGCAGCUGCCCCCGCAACUGUAAGCGGCAAGCAGGGCUGAUAUGCCACUGGAGAAAUCCGGGAAGGCCAGUCCAGAUGCGAUGACCCGCGAGCCAGGAGACCUGCCGGACUGGCGCCUCAGGAA,49,30,68,59,206
1237,3,ABCS01000001.1/110390-110179,AUAUGUUGUGCCCGCGAAGGUGCUCGACCCCGGUCGGGCCCGAGAGGGAAUCCGGUGAGAAUCCGGAGCUGCCCCGCAGCGGUAAGCGAGAACGACCGCCACAUCAGAGGCACUGGGACGCCCGUCCUGGGAAGCCGUGGCCAGUAGGUUGGACCGACGUCGAGGUCCAGCGCUCGCAAGUCCGAAUACCUGCCUUCGCCCGGCGCCGGGAG,40,29,75,68,212
1238,3,AATR01000002.1/37098-37316,GCAAACAGGUUUUUGCAUGGUUCCCCAUUAAAGUCAUAAUAAAUGGCUGGGGAUCAAAUGGGAAUGUAGACAGGGACUACCCGAAUGGGGCCUAAAGCUGCAACCGCCCCCGCGACUGUGUGCGGAGAGUGAAGCCCAAAGCCACUGGUGAAAACUGGGAAGGCGGGCAAAACGAUCUAUCCGUGAGUCAGGAAACCAGCCUUGCAACGGCGUUAUCGC,63,40,64,52,219
1239,3,AM420293.1/6698575-6698393,UCUGCGACGAUGCACGGUGGUCCAAGCAAGGAGUGCGUCAGGAAGCCGGUGGGAGUCCGGCACGGCCGGCGCCACUGUGACCGGGGAGCGGACCUCCCCCGCGAGCCACCGGGGCGACCUGGGAAGGCCGGAGGGACGCGGCGAGCCGGGAGUCAGGACACUGCCACCCCUUGUUCCCACCAC,32,19,70,62,183
1240,3,CP000699.1/3500758-3500554,AAAGCGCACGGCGCGACAGGUUCCCGGAAACGGGAUCAAAGGGAAUUCGGAAGCGGGAUCGUCCCGCAAGCCGAAGCUGCCCCCGCAACUGUGAUCGGCGAGCGAUCGUCCAUCCCGCGUCACUGGAUGCUCCGGCAUCCGGGAAGGCCGGACGAGACGCGACGACCCGAGAGCCAGGAGACCUGCCCGUCGCGGUCGUUCCAUC,44,25,68,68,205
1241,3,AAYB01000001.1/493900-494119,GCAAACAGUACCCGUGAUGGUUCCCAAAGCGCCGAAAAUGCGUCUGGGAUGAAAAGGGAAUACGGUGAGGAAGAGCCAAAGCGCGCCAAAUCCGUAACUGCCCCCGCAACUGUGAGCGGCGAGCGACCCCGAUGAUCACCACUGAGCAAACGCUCGGGAAGGGAUCGGGCAAGCAGCGACCCGCGAAGUCAGGAGACCUGCCAUCAAAGGGCGUCGAAAU,65,26,68,61,220
1242,3,CP000482.1/1351280-1351088,AGCAUCAUAUCGGAUCACGGUGCCCGCAAGGGCUUGAUAGGGAAGAGGGGUGCAACUCUUAUACGAGCCAUUCCCCCGCGGACCCGCCGCUGUAAGCGAUGACGAAGGGCAGUAUGCCACUGGUGAACAACCGGGAAGGCGCCCGGAGGAUGACUCGCAAGCCAGAAGACCUGCCUGAUCUUUACCACUGACU,48,32,58,55,193
1243,3,CP000680.1/1925111-1925322,CCUGCGCGCCUUGCUUCAGGUGCCCCGCGUCGUCUCCAUCGACGGCGCCGGGGUGAAACAGGGAAGCCGGUUCCAAUGCCGGCGCUGCCCCCGCAACGGUAGGUGAGUCAAACGCUGUUUCAGGCCACUGUGCAAUGCACGGGAAGGCGCAGCGUCGAACCUUUCAGGUUCGCUCACGAGCCCGGAGACCGGCCUGUCGCAGUUCCACGGCA,36,36,68,72,212
1244,3,AAWL01000006.1/21090-20915,CAUAUGGCAAAGGGAAUAGGUGCCUUGCGGCUUAAUAGGGAAGUCCGGUGAAAAACCGGCACGGUCCCGCCACUGUAAUGGGGAGUCUGGCUGCGUUAUGCCACUGGAGCAAUCUGGGAAGGUGCGGCUAGCAAUGAACCAGAGUCAGGAGACCUGCCUAUUCUAACACACACCGU,46,34,54,42,176
1245,3,AAUW01000028.1/66358-66145,GAGCACUUAGGAAGAGAUGGUUCCCGACUCUGAACUUCGGAGCGGGAUUAAAAGGGAACACGGUGAGACCAGGCCGCAAGGCUUCAAAUCCGUGACUGCCCCCGCAACUGUGAGCGGUGAGCAAACCUGAAAGCGCCACUGGGGAAACCCCGGGAAGGAUCAGGCAAGCUAUGACCCGCAAGUCAGGAGACCUGCCAUUUCACCUUAAACCUUA,61,34,61,58,214
1246,3,AALY01000001.1/1587847-1587653,GGGUGUCACUGCGGCGUCGGUUUUCGAUGGAAACUAAUAGGGAAUCCGCGGCGUCCAGCAGGGCGUCAACCGGAACUGCCCCCGCAACUGUAGGCGGCGAGCUGCAUCUUCAGAACCACUGGGCCGAGGUCUGGGAAGGGAAGAUGACGCCAUGAGCCGUGAGUCAGGAGACCUGCCGACGCAUAACCUGAAACC,45,31,65,54,195
1247,3,AAYH02000040.1/99907-100108,GUAUCUUUGUCAUGCAUUGGUUCGCUCCCCCUCUUCUGGGAAAGCGAUUAAAAGGGAAUCAGGUGUAAAUCCUGGACAGUCCCGCUGCUGUAAGUUUCGUGCAACGUUGCAGACAAUUACUCUAUGCCACUGGAAUAUUCUUCCGGGAAGGCGCCUGCAACAGAAACAAGUCAGAAGACCUGCCAUGCAUACUUUAUCAUUG,52,55,46,49,202
1248,3,CP000771.1/1485865-1486047,AAUAUUCCAAACUGCGAAGGUGCCGAAAGGCUUAAUAGGGAACUCCGGUGAGAAUCCGGGACGGUCGGGCCACCGUGAGUGGGGACGAAAUGCUCAACUGGCCACUGGCUUUUUUAGCUGGGAAGGCGAGCAGAGUAGGAUGAGCCACAAGUCGGGAGACCUGCCUUCGUAGGAUGGCAUUCC,46,35,61,41,183
1249,3,CP000908.1/2947467-2947267,CGUAGCUUGACCGUUGACGGUUCCCGCAAGGGAUCAAAAGGGAACGCGGUGGAGGGCUUUCGAGCUCGAUCCCGCGGCUGCCCCCGCAACUGUGAGCGGAGAGUCCUCCAUCACCACGUCACUGGGCAUGCCUCGCCUGGGAAGACGAUGGAGGGCGACGACCCGCCAGCCAGGAGACCUGCCGUCAGCCGUGGUCACACG,39,30,67,65,201
1250,3,CP000853.1/2361990-2361811,CAAAUUAAAUAGUUUUAAGGUCUUUAGAAUAUAAAGUUAAAAGAGAAAGAGGUUCAAUUCCUCUACAGCCCCCGCUACUGUAAUCAGGUAUGAAAUCUUCAAAUCCACUGGGAAACCGGGAAGGGAAGAUAGUAAGUCGAUCUGUAAGUCAGGAGAACUGCCUUAAAAAUAAGAAUCACA,70,44,36,30,180
1251,3,AE007870.2/441359-441124,CUUAUGUGAGAAAGCGACGGUUCCUACAGCCGAAAGGCGAAGGGAUUAAUAGGGAACAUGGUGCGGGCGAUCUUUUUCGUCCAAUGCCUUGGCUGCCCCCGCAACUGUAAGCGGAUUGUUGUUCAUCCCAGUGACGCUUGAAGGCGUCAUGCCACUGUUUUUUUCGGAAUGCGGGAAGGCAGAUGAGGGACGCAAAUCCGUGAGCCAGGAGACCUGCCGUCAAAAUGGAAACCAUC,58,53,70,55,236
1252,3,AE008691.1/395133-395373,UGAAUAUUAAAGCCUUAUGGUCCCAUGAUGGGUUAAAAGGGAAGACGGGUGAGAAUCCCGCGCAGCCCCCGCUACUGUGAGGGAGGACGAAGCCCUAGUAAGCCACUGUCCGGCACUCAACUGAGCGCGUUAGUAAGGAGAAAAGAGGGAGAGAAAUUGCGUUCAGUUGAGUGCCGGGUGGGAAGGCAGGGUGGAGGAUGAGUCCCGAGCCAGGAGACCUGCCAUAAGGUUUUAGAAGUUC,66,45,82,48,241
1253,3,CP000853.1/1112785-1112962,AGUAAAUAAGAAGCAUUAGGUUCUAAAAGAUUAAUAGGGAAAUCGGUUAAAUUCCGAUACAGCCCCCGCUACUGUAAGUGUGUACGAAACCAACGGGUCCACUGGAUAAUAUCUGGGAAGGUGUUGGGAGUAGGUUGAUCCACGAGUCAGGAGACCUGCCUAAUUGCUUGUAUGAAGU,56,45,47,30,178
1254,3,AP009385.1/1806044-1805855,UACGCGCGUUCGUUCGCCGGUGCCCUUCGGGGCCGAAGAGGGAACACAGGGCGCAUCGCGCCGCUGUGGCUGCCCCCGCAACUGUAGACAGCGAGCCGAUCUCCCCCUCAUGCCACUGGUUUCACCGGGAAGGCCGGGAGCAGGCGCCGACCUGUCAGCCAGGAGACCUGCCGGCCUGAAAGUGCGUGCG,31,28,65,66,190
1255,3,CP000038.1/2154731-2154556,UCAUAACAUACGCUGACAGGUGUGGCACAUUUGUGCCUGGGAAGAGGGUGAAAAUCCCUCGCAGCCCCCGCUGCUGUAAUGCUGACAAACCCGAAAAUGCCACUGAUCGCGAGAUUGGGAAGGUCGGGUGAGGAUGACGCUAAGCCAGAAGACCAGUCUGUCAGUCAAUACCAACA,50,33,49,44,176
1256,3,CP000949.1/2158518-2158320,UCUACCAUGCGGGCCGCCGGUUUCCACCACGGAAAUAAUAGGGAAUCCCAGGCCGCCCAGGCGCGCCAAACGGAACUGCCCCCGCAACUGUAAGUGCCGAGCCCGCUCCAUCGAUGCCACUGGAUCAGCCGAUCCGGGAAGGCUGGAGCCGGGUGAUGACGCACCAGUCAGGAGACCUGCCGGCUUACAUUCACCAACC,45,28,56,70,199
1257,3,AE007869.2/1640673-1640490,CCAUAGCUUCUCCGGUCAGGUGCCCGCCCUUGCGGCGGGAGAAUCGGGAAUCCGGUGAAAGACCGGAACGUGCCCAACGCUGUAAGGCGGAUGCUCUUUUUCUCAUGCCACUGAAGCAAUUCGGGAAGGCGAAAGGGGCGGAUGAAGCUUAGUCAGAAGACCGGCCUGGCAGGAUAGACCGAAC,44,32,60,48,184
1258,3,CP000830.1/164274-164052,CGCAGAACAGUCAGGCAUGGUUCCCCGUGCCCGCGCCAAGCGCCCGGGGGAUCAAAUGGGAAUGUGGAACGGUCCGAUCCAAACCGGAGGACCAAAGCCUCAGCCGCCCCCGCGACUGUAUGCGGAGAGGGAGAUCGACAUGCCACUGGGGCCCGCCCCGGGAAGGCCGAUCCACCCCGAUGACCCGCGAGCCAGGAGACCAGCCAUGCGCGACACCCUUAGC,50,23,71,79,223
1259,3,CP000853.1/1037045-1037222,UGAAUAUCAAAGUAUUAGGGUUCUCUACUUAGAGAUAUUAGGGAAAUUGGUGCAAAGCCAAUACAGCCCCCGCUACUGUAAACAUGGACGAGUUCUAAAAGCCACUGGAUUUAAUCUGGGAAGGCAGAAGGAGGAAGAAGUGUGAGUCAGGAUACCUAACUAAUACUUGGCAUGGUUU,59,45,45,29,178
1260,3,AARL02000087.1/606-795,UUAAAUAGGUCUUAUGUUGGUGGAAUGUAUGUGCAUUUCUGAAAGAGGAAUUCGGUGCGAUGCCGAAACUGCCCCCGCAACUGUAAGGUGGACAAAAAUAGAUAUAACCACUGUACGUUUUAAUGUAUGGGAAGGUGCUAUUGUUGGAUGAAGCCAAGUCAGGAUACUCGCCAAAUAAGCCGGAAGCAAC,59,49,50,32,190
1261,3,CP001025.1/1786797-1786605,UACGGCCGUUCGUUCGCCGGUGCCCUUCGGGGCCGAAGAGGGAACACAGGGCGCGCAUCGCGCCGCUGUGGCUGCCCCCGCAACUGUAGACAGCGAGCCGAUCUCCCCCCUCAUGCCACUGGUUUCACCGGGAAGGCCGGGAGCCGGCGCCGACCUGUCAGCCAGGAGACCUGCCGGCACUGAAAGUGCGUGC,31,28,65,69,193
1262,3,CP000927.1/2970294-2970494,AGUGCAGCUCUCGCGACAGGUUCCUCGAAAGAGGAUGAAAAGGGAACUCGGGUGUGAAACCCGGGCUGCCCCCGCAACUGUAAGCGGCGAGCCCGCGCGUCAUAAACCACUGGGAGCCUCCUUCGGGAGGCCUCUGGGAAGGCGACGCGCACCGGCAUUGACCCGCGAGCCAGGAGACCUGCCCGUCGCGGUCGUCCUUCG,40,29,67,65,201
1263,3,CP000873.1/297626-297839,ACCAUAUCUUGUGUUCGAGGUUCUUUCGAUUCGACGAGUCGGGAGCUAAGACGGGAAUCCGGUGCGCUUGCCCAUGGUGGGCGGGCAAUGCCGGAGCUGCCCCCGCAACUGUAAGCGGCGAGCUUUGCGCCCCAUGCCACUGGCGAAAGCCGGGAAGGCGGGUGGAAGCGUUGAGCCGUGAGCCAGGAGACCUGCCUUGAGCGUGAACGUCCAC,40,40,75,59,214
1264,3,CP001090.1/13752-13558,CAAAAUAAAUCAAAUCACGGUGCCCAUAGGGGCUUGAUAGGGAAGAGGGGUGCAUUUCCAUUUGGAAAGAGUCCCCCGCGGACCCGCCGCUGUAAGCGAGGACAAAGGGCAAUAAUGUCACUGAUCAUUAGAUUGGGAAGACGCCCGGAGGAUGAAUCGCAAGCCAGAAGACCUGCCGAUGAUCUCAACACUCAA,61,34,54,46,195
1265,3,CP000958.1/1840255-1840064,UACGGCCGUUCGUUCGCCGGUGCCCUUCGGGGCCGAAGAGGGAACACAGGGCGCCCCCCGCGCCGCUGUGGCUGCCCCCGCAACUGUAGACAGCGAGCCGAGCUCCCCCUCAUGCCACUGGUUUCACCGGGAAGGCCGGGAGCCGGCGCCGACCUGUCAGCCAGGAGACCUGCCGGCCAGAAAGUGCGUGCG,30,25,66,71,192
1266,3,AE007869.2/877627-877855,GGAUAACAUGUCCGUGAUGGUUCCUUCCGGGCGUUCCGGAAGGUGAAAAGGGAACACGAUAGGGACAAAUCCUCAUUCGUGGCUGCCCCCGCAACUGUGAGCGGAGAGCCUGAAACGAAAUGCCACUGGCAAGCCAUCUCGCCUCCAUCAAGGGGGAAGGCAAUGCCGGGAAGGUGUUUCAGGUUUUGACCCGUAAGCCAGGAGACCUGCCAUCACGGAAAUAUCCAUG,59,43,68,59,229
1267,3,AE008922.1/3631190-3630967,UACCAUGCGCGCCCCUGAGGUGACUGCCGGAAUUCCGGUGGUUUAAACGGGAAUCCGGUGCGCGCAUCGCCUUGGCGAGACGCAAGUCCGGAGCUGCCCCCGCAACGGUGGGCGAGGUCAGGUGCCGCAACAGGCCACUGUGCACACGCAUGGGAAGGCGCGGUACCGGAAGCGCAGGCUUCCACUCGCGAGCCCGGAGACCGGCCUGAGGGAUUGACCCGGCA,42,31,80,71,224
1268,3,CP001090.1/30663-30471,UGAAUAUGCACGAAUCACGGUGCCCGCAAGGGUGAAAAGGGAAGAGGGGUGACGCUCUGACGAGCUAUUCCCCCGCGGACCCGCCGCUGUAAGCGAUGACGAAGGGCAACAACGUCACUGAUCAUUUAGAUUGGGAAGACGCCCGGAGGAUGACUCGCAAGUCAGAAGACCUGCCGCUGAUUGUUGUUACUCG,50,35,60,48,193
1269,3,CP001111.1/542487-542264,AGACUGCGCGCACUUCCAGGUGACCUGCGGCCAUGGCCGGCAGGUUGAAACGGGAAGCCGGUGACGCGUGAUUCCACGCCAUGCCGGCGCUGCCCCCGCAACGGUAAGCACGUCAGUUCCAGGCAACACCGCCACUGUGCCGCAGGCAUGGGAAGGCGCCUGGACGGUGGCCUCGCGCCACCCGGCGGCAAGCCCGGAGACCGGCCCGGAAGCCUCAGGUCGCG,40,26,78,80,224
1270,3,CP001175.1/1515606-1515417,UUAAAUAGGUCUUAUGUUGGUGGAAUGUAUGUGCAUUUCUGAAAGAGGAAUUCGGUGCGAUGCCGAAACUGCCCCCGCAACUGUAAGGUGGACAAGAAUAGAUAUAACCACUGUACGUUUUAAUGUAUGGGAAGGUUCUAUUGUUGGAUGAAGCCAAGUCAGGAUACUCGCCAAAUAAGCCGGAAGCAAC,58,50,50,32,190
1271,3,AL591688.1/954760-954963,UUAGAUGAGGACACUCAAGGUGCCGCCUCGAAGGGAGGGCGGAGAAUUGGGAAGCCGGUCAAAUCCCGGCGCUGCCCCCGCAACGGUGGUGGAGCGAACAGCCACGGCAGAAGGCCACUGGACACCGCGUCCGGGAAGGCGCCGGGCAGGUCCCUUGCGGACGGCUCCAGAGCCCGGAAACCAGCCUUGAAGCAGAAAUAGACC,49,22,72,61,204
1272,3,ABKL02000008.1/4023-4215,UAAAUAUAUAAUAUUAUAGGUUCUUCAAGCAAGAUUAAUAGGGAAAAAGGUUAAAUUCCUUUACAGCCCCCGCUACUGUGAUGCAGACGAAACUUUUGUUAGCCACUAUGAUGAUAUUUUUUAUAUCUCAUGGGAAGGAAGAGGAUUAGGAAGAAGCUAAGUCAGGAGACCUGCCUAAAAUAUUAAAGUAAUU,70,58,38,27,193
1273,3,CP000850.1/3174011-3173839,AUAGCCUCUCGCCGUCAAGGUGCACGGGAAGCCGGUGAAACACCGGCGCGGCCCUCGCCACUGUGACCGGGUAGCGAUCUCCGACUACGCCACUGGGCCCGACCGGGUCUGGGAAGGCCGGAGUGAACGUCGAUCCGGAAGCCAGGAGACCGGCCUUGACAAGGAUCUCAUCC,35,24,57,57,173
1274,3,AP008230.1/4379378-4379199,GAAUAUCAGGCGGAAUAGGGUUGCUUAAAUGCAUUAAUAGGGAACUCCGGUGUGAAGCCGGGACAGCCCCGCUACUGUAAGAAGGACGAGUCCCUUAGAGGAUCCACUGGUGAAAACCGGGAAGGUAAGGGAUGAGGAUGAGUUCAAGUCAGGAUACCUGCCCCAUUCCGGAAACACAAG,55,33,55,37,180
1275,3,CP000853.1/373263-373442,CAAAUGAAUACAUUUUAUGGUUCUUUCUUAUGAAAGCUAAGAGGGAAAGAGGUGAGAAACCUCUGCAGCCCCCGCUACUGUAAGCAGGACGAAAUUCCAAUAAACCACUGUGUAAAUGGGAAGGUAGGAAGAGUAGGAAGAGUGCAAGCCAGGAGACCUGCCAUAAAACGUGAAUGAAGC,65,36,47,32,180
1276,3,CP000943.1/944045-944239,CCUAGCCUAUCGCUCGACGGUGCCCUCCGGGGCCUAACAGGGAACGCGGUGAGGGCUCGCGCCCGAAUCCGCGGCUGCCCCCGCAACUGUGAGCGGCGAGCCCUCCAUCACCACGUCACUGGGGUCAUGCCCGGGAAGACGAUGGGGGGCGGCGACCCGCGAGCCAGGAGACCUGCCGUCGACCGUGGUCACACG,32,24,68,71,195
1277,3,CP000880.1/3464662-3464469,CGGUAGCAUCCGUGGGCCGGUCCUGUGAGUUAAUAGGGAAUCCAGUGAAAAUCUGGAGCUGACGCGCAGCGGUAAGGAAAGGUGAGAUGAGAGCGUAAGCAGACACUGCCUCCGGCGGGAAGUCAUCAUUUCUGCUAUCCAGCCAACGGAUAACCCUCCAAGCCCGAAGACCUGCCGGCUAACGUCGCAUCUGG,49,35,59,51,194
1278,3,AE007869.2/2810186-2809969,UAAGGGUAAGGGACUGACGGUCUUUUCCCGGCAACGGGAAAAGCUAAGAGGGAACACGGUUCCGCCCCGAGAAAGGGUCAUUCCGUGGCUGCCCCCGCAACUGUAAGCGGUAAGCCCGCACCGUAAAGCCACUGAACCUUUAUGAUCGGUUCGGGAAGGCGGUGACAGGGUGUUGAUAGCCGCAAGCCAGGAGACCUGCCGUUUCAGGAAAAAGCGUC,55,38,69,56,218
1279,3,CP001090.1/1002-822,GCAGAAUAUACGAUCAACGGUGCCCAUACGGGCUUGAUAGGGAAGUGAGGUGAAACUCCUCCACGGACCCGCCGCUGUAAGCGAUGACAAAGGGCAACAAUGUCACUGAUCAAUUUGAUCGGGAAGACGCCCGGAGGAUGAUUCGCAAGUCAGAAGACCUGCCUUGAUCUUACAUCAUGAA,54,35,49,43,181
1280,3,AE008691.1/396055-396295,GAAUAUAAAAAGCCUUAUGGUCCCGUGAUGGGUUAAAAGGGAAGACGGGUGAGAAUCCCGCGCAGCCCCCGCUACUGUGAGGGAGGACGAAGCCCUAGUAAGCCACUGUCCGGCACUCAACUGAGCGCGUUAGUAAGGAGAAAAGAGGGAGAGAAAUUGCGUUCAGUUGAGUGCCGGAUGGGAAGGCAGGGUGGAGGAUGAGUCCCGAGCCAGGAGACCUGCCAUAAGGUUUUUAAAAGUU,69,44,81,47,241
1281,3,CP001157.1/3390006-3389785,CCUGCGCGCCUCGCUUCAGGUGCCCCAAGGGUGAAACAGGGAAGCCGGUGCGUGCCGCGACCAUUCGCGGCGCAAGGCCGGCGCUGCCCCCGCAACGGUAGACGAGUCGCGAAACCGCAAUAGCCACUGUGUUGCUCGGACACGGGAAGGCGCGGUUUCGGAAGCCGCCGCAUGGCGCUUCGCUCGUGAGCCCGGAGACCGGCCUGUGGCGAUCCAUGGCGG,37,31,80,74,222
1282,3,AE007870.2/921705-921914,ACAUUGGUUAGCCAUCGUGGUUCUGCGGACGAAGGUCCGGAGCUAAGAGGGAAUUCGGUGAGGGCUUUAAUCACAGCCUGAAUCCGAAGCUGCCCCCGCAACUGUAAGCGACGAGCGAAAGUCCAUCAUGUCACUGAGGCCGGCCUCGGGAAGACGGACCAAAGCUAUGACCCGCAAGCCAGGAGACCUGCCGCGAUAGAUAACGUCCAC,55,35,62,58,210
1283,3,CP000943.1/2696265-2696461,GCUACCUUCCGCCGCGACGGUGCCUCGGCGACGAGGUGAAAAGGGAACGCGGAGCGGGGCCAGCCCCGGAAGCCGCGGCUGCCCCCGCAACUGUGAGCGGUGCGGGCCCGCCAUCGGCCACUGGAGCGAUCCGGGAAGGCGGCGGGCACGGUCCACCAUCGCGAGCCAGGAGACCUGCCGUCACCCCUUCCUCUCGA,32,21,71,73,197
1284,3,CP000924.1/1954621-1954429,GAAUACAAAAAAUCUUAUGGUCUUGAGAAGUUAAAAGGGAAAGCGGUGAAAAUCCGCUGCAGCCCCCGCUACUGUGAGCGAGGAUGAAGCCCUAAUAAGCCACUGCUUGGCACUCAAGAGAUGUGCCGGGUGGGAAGGCAGGGUGGAAGAUGAAUCGCGAGCCAGGAGACCUGCCAUAAGAUUUCGGAAGUUC,59,36,59,39,193
1285,3,ABDO02000001.1/974410-974591,AUUUAAUAAAGAAAUUUAGGUGCCUUUGUAGUAAAAGGUGAAAAGGGAAUGUGGUAAAAUCCACAGCAGCCCCCGCUACUGUAAUUGAAGACAAAUCUUUCAUAGGCCACUCUUUAAAAGGGGAAGGGAAAGAUUAGGAUGAAUCAUGAGCCAGGAGACCUGCCUAGAUUUUUAUUAGGAAA,66,46,43,27,182
1286,3,AP009386.1/1277939-1278133,UUACCCUUGCGCGCUGAUGGUUCCCGCGAGACGGGAUCAAAUGGGAACGCAGUGACGGCGCACGCCGGAAUCUGCGGCUGCCCCCGCAACUGUAAGCGGCGAGUCCGUGCCCUUCGCGCCACUGGGAGACCGGGAAGGCGGGCACCGGGCGGCGACCCGCGAGCCAGGAGACCAGCCAUCGACCGAGGUCCAAGC,37,23,69,66,195
1287,3,CP000908.1/1328850-1328641,CGAAGUUGCUGCGGCCAAGGUUCCCCCGGAUGCAUGUCCGAGGGCUAAGAGGGAAUUCGGUAAGCCCGUCCGGGCGAGGCCGAAGCUGCCCCCGCAACUGUGAGCGGCGAGCCACCGUCGUCGAAGGUCACUGGUGCCCUGCACCGGGAAGGCCGAGACGGGGGCGCUGACCCGUGAGCCAGGAGACCUGCCUUGGCGCGACGAUGUCCC,37,29,77,67,210
1288,3,CP000830.1/546421-546638,AGCGAUGCUCUGAUCGAUGGUUCCCGAAACCCGCGAGGGUGAAGGGAUGAAAAGGGAACACGGUGAGGCGUAGCCAUCAGGCACCAAACCCGUGACUGCCCCCGCAACUGUGAGCGGUGAGCGACCCCGUGGACACCACUGGACCGAUGCGGUCCGGGAAGGUUCGGGGAAGCCGUGACCCGCGAGUCAGGAGACCUGCCAUCGAUGGUGCGCUUUCG,48,32,76,62,218
1289,3,CP001063.1/4163721-4163911,CUGUAGCAUCCACUUGCCGGUCCUGUGAGUUAAUAGGGAAUCCAGUGCGAAUCUGGAGCUGACGCGCAGCGGUAAGGAAAGGUGCGAUGAUUGCGUUAUGCGGACACUGCCAUCCGGUGGGAAGUCAUCAUCUCUUAGUAUCUUAGAUACCCCUCCAAGCCCGAAGACCUGCCGGCCAACGUCUCAUCAUC,44,44,51,52,191
1290,3,CP000908.1/1617572-1617372,CUAUGACCGCUCCGUGACGGUGCCCCGGCAGCGGGGUGAAAAGGGAAUGCGGUGAGAGGUUUUCCAGAAGCCUCGAUUCCGCGGCUGCCCCCGCAACUGUAAGCGGCGAGUUCCUGCCACGAGCCACCGGGUGAUCCGGGAAGGCGGCAGGCACGAUACCAGCCGCGAGCCAGGAGACCUGCCGUCCAGCGAAGUUUUGUU,39,32,69,61,201
1291,3,AE007869.2/70421-70645,ACUAUAUGUGGUGUUCAAGGUUCUUCCGAUUCGCUAGGGUUGGGAGCUAAGACGGGAAUUCGGUGCGUAACGCCAUCACGGCGGAGCAAGGCCGAAACUGCCCCCGCAACUGUGAGCGGCGAGCAUCGUUCCGAUUUGAGCCACUGGAGCCAAAAGCUCCGGGAAGGCUGGAAUAGAUGUUGUGACCCGCAAGUCAGGAGACCUGCCUUGAGCGCAAAUGUCCAC,53,45,70,57,225
1292,3,AL591688.1/1999767-1999554,GGCCAUAUGCCGCCGUCAGGUGCCCGCGAAAUGCGGGGGAAUCGGGAAGCCGGUGCAGUUCCGGCACGUGCCCAACGCUGUGAAGGGGACGUUCUCGCCAAAAAGGGCUCUGAAUCUUUUCAGAGCUUUGCCACUGAAUAUUGAAGCUAUUCGGGAAGGCGGCGCGAACGGAUGAUCCGAAGUCAGAAGACCGGCCUGGCGAGAUAGACCGGCC,49,37,72,56,214
1293,3,CP000094.2/3552647-3552437,GUAGCCUUGCGCUUUCGAGGUUCUUCGGCCCACGCCGAAGCUAAGAAGGGAACGCGGUCCAAGCCGCGGCUGCCCCCGCAACUGUGAACGGUGCUGUUCGCUGCCACGCCACUGCCAACUCAAUCCAGAGCCAGCGGGAAGGCGCAGCGAAUACCGGGCCAAGGCCCGAACACCGUCAGCCAGGAGACCUGCCUCGUCACAGAUUCUCACU,45,32,60,74,211
1294,3,AALF02000008.1/20807-20994,UUACUGAAAUGGUUAUGUCGUGUACGCAUUGGCACUUAAUACACGACAGGGAAGGGGGUGACAAUCCCCCGCAGCCCCCGCUGCUGUGAUGCCGACGAACCCGCUGAAACCACUGAUCCAUCGGAUUGGGAAGGUGCGGGGGAGGAUGACGCUAAGCCAGAAGACCAGCCAAAUCGGUAAAAUAUAUU,52,36,54,46,188
1295,3,CP002156.1/2306524-2306337,GCCAUUCAGCGAAGAGAUGGUUCCGUGAGAGAUCACGGCGAAGAGGGAACCCGGUGGCAAUCCGGGGCUGUACCCGCAACUGUGAGCCAGGAGCUGACAACCGAUACACCACUGGAGGAAACUCCGGGAAGGGGGUUGGAAGCGAUGAUCGGUGAGCCAGGAGACCUGCCAUCGCGUCGUUCGUCCGG,45,28,67,48,188
1296,3,AALC02000021.1/24189-24004,UUUUUUAUAUAUCGAAAUGGUCAUGUUAUGCGCAAAAGCAUAACUGGGAAGGGGGUGACAAUCCCCCGCAGCCCCCGCUGCUGUGAUGCUGACGAACCCGCUGUUACCACUGAUCCAUCGGAUUGGGAAGGUUGCGGGUGAGAGUGACGCUAAGCCAGAAGACCAGCCAGAUCGGUAAAAGAUAUU,50,42,52,42,186
1297,3,CP003056.1/1126059-1125863,AUAUAGUAUGCGAGUAUUGGUGGCUUUGAGAUGCCUGAAAAGGGAAUCCGGUGGGAAACCGGAGCUGCCCCCGCAACUGUCAGUGUGGACGAAAGAGCAAACCACUGUACCGGCUGCUUUUUUUGGCGGCGGUAUGGGAAGGGCUUCAUUAGAAUGAAACACAAGCCAGGAGACCUGCCAAUACUUGAAGUUUCUAU,53,46,58,40,197
1298,3,AALE02000017.1/13768-13947,CUUCAAGAAUAAAAGGCAUGUUAUGCACUAAAGCAUAACUGGGAAGGGGGUGACAAUCCCCCGCAGCCCCCGCUGCUGUGAUGCUGACGAACCCGUAGAAACCACUGAUCCACAAGAUUGGGAAGGUGCGGGAGAGGAUGACGCUAAGCCAGAAGACCAGCCCGCUCAGUAAAAGAUUUU,56,31,49,44,180
1299,3,AALD02000002.1/89872-89688,AUUUGUAGUUACUGAUAGGGUCAUGUUAUGCGCUAAAGCAUAACUGGGAAGGGGGUGACAAUCCCCCGCAGCCCCCGCUGCUGUGAUGCUGACGAACCCGCUGUUACCACUGAUCCAUCGGAUUGGGAAGGUGCGGGGGAGAAUGACGCUAAGCCAGAAGACCAGCCAGAUCGGUAAAAGAUAUU,49,39,55,42,185
1300,4,BAAV01024370.1/684-614,UCAGNNAUCGGGAAUGAUGUUCUCCCCUGGGAUUCCAAAACCGCUGUUUCGCUGAUGACGUCUGCUUUUUU,12,24,16,17,71
1301,4,BABE01001448.1/1961-1891,GUCCGUGACGGCGAUGGAUCCCGCCUGGCCGAUGCCGAACUGCCGAUCUGGCUGAUGGUUCCUGCCCCGUC,8,15,23,25,71
1302,4,BAAV01007000.1/1090-1152,CUUUGCACCGGCUAUGGGAUUAGCCUUUAACCGCCCUUCGGAGCUGAUGAUCCCUACAAUUUG,12,19,14,18,63
1303,4,BABC01000066.1/7792-7723,CUGGGAUUCGGCGAUGGGACCCGCCUGAACUUGUUUCGAACCGCACACUGCUGAUAGUUCCUACACACGA,15,16,18,21,70
1304,4,BABE01006493.1/378-447,UAAGGAACCGGCGAUGGAACCCGCCUGAACUCGUUUCGAACCGCACACUGCUGAUAGUUCCUACACACGA,19,13,16,22,70
1305,4,BABB01014491.1/724-793,UGGAGAACCGGCGAUGGGACCCGCCUGAACUUGUUUCGAACCGCACACUGCUGAUAGUUCCUACACACGA,17,14,18,21,70
1306,4,BABE01000053.1/15068-15137,UGGAGAACCGGCGAUGGGACCCGCCUGAACUUGUUUCGAACCGCACACUGCUGAUAGUUCCUACACACGA,17,14,18,21,70
1307,4,BABF01001201.1/3795-3726,UGGAGAACCGGCGAUGGGACCCGCCUGAACUUGUUUCGAACCGCACACUGCUGAUAGUUCCUACACACGA,17,14,18,21,70
1308,4,BAAY01017851.1/254-182,UAGCUGGCAGGGAAUGAAGUUCUCCCCAGGCAGUGCCUAAACCGCUAUUACAGCUGAUGACUUCUGUUGUUUA,17,21,18,17,73
1309,4,BABB01015950.1/548-449,AAUAUUACUGGGAAUGAGGUUCUCCCAGGAACGAGAUAGAAAUAGCUAAAUCUUUCGUUCAUAACCGCUUGAUUAUAAAGCUGAUGACUUCUGCAAAGCG,33,28,21,18,100
1310,4,BABF01003476.1/1904-1985,CUGUUACCCGGGAAUGAGGUCUCCCAUGGUAGUGUAAUAUUUACCAGAACCGCUUAUGACAGCUGAUGGCUUCUGCAUUGUG,18,25,21,18,82
1311,4,BAAV01013884.1/268-196,AAUAUCAAAGGGAAUGAAGUACUCCCUUGGGAAACCUAAACUGCUUAUUCAAGCUGAUGACUUCUACGAUUUU,24,22,13,14,73
1312,4,BABG01014606.1/762-690,CGAAUGAGAGGGAAUGAAGUUCUCCCUAGGGAAACCAGAACUGCUGAAUAUAGCUGAUGACUUCUACGAUUAU,24,18,18,13,73
1313,4,BAAZ01021286.1/777-699,AGAAUAAACGGGAAUGAAGUUCUCCCGAAGUAACCAGAUUACUUGAACCGCUUUAAAAGCUGAUGACUUCUGCGACGAA,28,18,17,16,79
1314,4,BAAV01021889.1/203-131,GAAACAAAUGGGAAUGAAUGUCUCCCCGGGAUCAUCCCGAACCGCUUAUUAAGCUGAUGACUUCUGUGAUAAC,22,18,16,17,73
1315,4,BABG01014343.1/547-474,AUCCAGAACGGGAAUGAGGUUCUCCCACGAUUUUUGAUCGAAACCGCCAAAAGGCUGAUGACUUCUGUGCAUGG,20,18,19,17,74
1316,4,BABG01003409.1/431-358,AAAGAAAAAGGGAAUGAAGUUCUCCCUCGAAGAGAUUCGAAACCGCUUAUUAAGCUGAUGACUUCUGUGUAAUG,26,19,17,12,74
1317,4,BABC01003766.1/468-402,AAGUGAAUAGGUGAUGGUGUUCGCCUUUAAAUGCUAACGAAAGAUAGCUAAUGACGCCUACUAAAGU,23,18,16,10,67
1318,4,BABF01015109.1/43-109,AAGUGAAUAGGUGAUGGUGUUCGCCUUUAAAUGCUAACGAAAGAUAGCUAAUGACGCCUACUAAAGU,23,18,16,10,67
1319,4,BAAW01000138.1/2195-2134,AGCCUCACAGGGGAUGGCAUUCCCCCUUGAACCGCCAUGUGGCUAAUGAUGCCUGCUUUUUA,12,17,15,18,62
1320,4,CP000254.1/1236994-1237053,AAUCCUGCCGGUGAUGAGAUCCACCGUAAACCGCCCGCUGCUAAUGACUUCUACCCGGAA,15,12,13,20,60
1321,4,CP000822.1/1484941-1485003,UUUUUUACAGGAGAUGGCAUUCCUCCUCAUAACCGCCCUCUGGCUGAUGAUGCCUGCACAUUC,12,20,12,19,63
1322,4,CP000759.1/989075-989138,GUACAUGAUGGGAAUGGGGUUCUCCCGAAACUGCCAGCAAUUGGCUGAUGACUCCUGCUUGAAU,15,17,18,14,64
1323,4,CP000854.1/4256142-4256216,ACUAGCAGCGGCGAUGGGGCUCGCCAGGAAGCUCGACUUCUGAACCGCCAGCCGGCUGAUGGCACCUGCGAACAA,17,10,24,24,75
1324,4,CP000885.1/3806199-3806127,CUUACUGACGGGAAUGAAGUUCUCCCAAGGUUUUACCUAAACUGCUUAUAAAGCUGAUGACUUCUGUGAAUUA,21,24,14,14,73
1325,4,AE004091.2/4914637-4914575,UUGCCGACAGGAGAUGGCAUUCCUCCUUCAACCGCCCCUGGGGCUGAUGAUGCCUACGCAUGA,12,14,17,20,63
1326,4,CP000360.1/3066978-3066906,CAACUUCAUGGCGAUGGAGUUCGCCCUAACCGCCGCAGCCACGUUGCUGCGUGCUGAUAACUCCUGCCGACAC,14,15,18,26,73
1327,4,CP000125.1/1222860-1222794,GCGGCGACCGGAGAUGGCAUGCCUCCGUACAACCGCCGGCGAGCCGGCUGAUGAUGCCUACGCGUUC,11,10,23,23,67
1328,4,CP000545.1/1653068-1653134,GCGGCGACCGGAGAUGGCAUGCCUCCGUACAACCGCCGGCGAGCCGGCUGAUGAUGCCUACGCGUUC,11,10,23,23,67
1329,4,BX950851.1/1468958-1468853,CACUAAAGCGGAGAUGACAUUCCUCCCUACCCUAACGCCGCCAAAAAUGCUGGCAGCCUGAAGUACAAGGUACAACCGCCACCCGGCUGAUGAUGUCUACGUCCAC,30,18,22,36,106
1330,4,CP000270.1/1757402-1757341,UGCUGCGCUGGAGAUGGCAUUCUCCUUUAACCGCCCUUAUGGCUGAUGAUGCCUGCUCGCCC,8,18,16,20,62
1331,4,AAVO02000004.1/13914-13993,AAAUAUAAAGGGAAUGAGGUUCUCCCUAAGUAAUAAAAUUACUUAAACCGCUUAUGAAAGCUGAUGACUUCUGCGAGUAA,31,22,15,12,80
1332,4,CP000547.1/225172-225238,GCGGCGACCGGAGAUGGCAUGCCUCCGUACAACCGCCGGCGAGCCGGCUGAUGAUGCCUACGCGUUC,11,10,23,23,67
1333,4,AAFX01080011.1/664-577,UUUGGGCGCGGUGAUGGAGUUCACCAUCUACUACAAAUAUGGAAAACCGUCCAACUUCUUUAGCCGGACUAAUAACUCCUACCUAUAA,26,24,16,22,88
1334,4,CP000227.1/4763720-4763779,AUAAUUAUAGGCGAUGGAGUUCGCCAUAAACGCUGCUUAGCUAAUGACUCCUACCAGUAU,18,17,12,13,60
1335,4,CP000923.1/40525-40583,AUACCAUAAGGCGAUGGAGCUCGCCAUAAAUGCGGAACGCUGAUGGCUCCUAUUAGGAG,17,12,17,13,59
1336,4,CP000557.1/2739339-2739277,AACAUACUAGGCGAUGGGGUUCGCCAUAACCACCGGCUUCCUGCUGAUGACUCCUGCUGCGUU,12,16,16,19,63
1337,4,AADL01000991.1/122-193,UGUAGUCCGUGGAAUGGCGUUUCCACUAAUUCAAACCGCCGGCUGAAGCUGGCUGAUGACGCCUGCUUGAAA,16,18,20,18,72
1338,4,ABQR01000024.1/52165-52090,UGUUUACAGGGGAAUGAGGUUCUCCCUUAGUGUCAUACUAAAACCGCUUAUUUAAGCUGAUGACUUCUGUGUGAUU,18,28,17,13,76
1339,4,CP001139.1/34842-34908,CCAAAUACGGGUGAUGGAUUUCCACCUUUAACCGCUCUAUUUUAGAGAUAAUGAUUCCUACUAUAGC,19,22,11,15,67
1340,4,CP000744.1/5109630-5109568,UAGCCGGCAGGAGAUGGCAUUCCUCCUUCAACCGCCCCUGGGGCUGAUGAUGCCUACGCAUGA,12,13,18,20,63
1341,4,CP000481.1/804142-804061,CCUGAUGACGGCGAUGGAGUCCGCCUGACCGGUGUGAUCGACACCGGCGAAGUGUCACCUGGCUGAUGGCUCCUACCUCCCA,14,16,25,27,82
1342,4,CP000525.1/1388196-1388262,GCGGCGACCGGAGAUGGCAUGCCUCCGUACAACCGCCGGCGAGCCGGCUGAUGAUGCCUACGCGUUC,11,10,23,23,67
1343,4,CP000975.1/1993796-1993891,GAAAUCCCUGGCAAUGGAGUUUGCCGUCCCGCCGGUUCGAAGUACUUGGGAAAACCUCCUUUCUUGAAAAGAAAGGCUGAUAACUCCUACUUCAAC,26,24,21,25,96
1344,4,FM177140.1/2571522-2571586,AGAAGAACAGGCGAUGAUGUUCGCCGCAAAUGAUUGUGUAGCAAUCUGAUGACGUCUACUGAAAC,21,15,17,12,65
1345,4,AE010299.1/4831358-4831427,UGUAACAAUGGUGAUGAGGUCCACCCUGAUAAUUGUCAAAACCGCUUAUGCUGAUGACUUCUACACAACU,21,20,13,16,70
1346,4,ABQQ01000001.1/79958-80027,UAAGGAACCGGCGAUGGAACCCGCCUGAACUCGUUUCGAACCGCACACUGCUGAUAGUUCCUAUACACGA,19,14,16,21,70
1347,4,ABYT01000096.1/44476-44400,AAUCUUUUUGGGAAUGAAGUUCUCCCUUAGUUUAAAACUAAAACCGCUUUUUAUAGGCUGAUGACUUCUGUGUUUUU,19,33,13,12,77
1348,4,CP000004.1/152206-152146,CCUGGACAAGGGGAUGGGGUUCCCCUGAAACCGCCGCAAGGCUGAUGACUCCUCUGUGCCG,11,11,20,19,61
1349,4,CU695240.1/565243-565309,CCGGCUUGCGGAGAUGGCAUACCUCCCUUAACCGCCGAUCACCUCGGCUGAUGAUGCCUACAAGUUC,13,15,16,23,67
1350,4,ABQC02000019.1/404312-404380,UCGAAUCAAGGGAAUGGGACUUCCCUGUGAUAAACCGCUAAUGAAGUAGCUGAUAGUUCCUACCGGAGC,20,16,18,15,69
1351,4,CU468135.1/2891609-2891537,GUAUCACAAGGUGAUGGUGCUCCACCUUUCCCAACCGCCCUGAUUUUUUCGGGCUGAUGACGCCUGAUAAAAC,16,20,16,21,73
1352,4,ABLC01000083.1/20871-20937,GUUGGCCGUGGAGAUGGCAUUCCUCCCUUAACUGCCGAUUCGUUCGGCUGAUGAUGCCUACACACCC,11,18,17,21,67
1353,4,FM954972.2/699217-699134,UAGCCAUCAGGUGAUGGGGUUCCACCUAAGCUUUUGCUUCAACCGCCCGUUCUUUUGAACCGUGCUAAUGACUCCUACAGAAUC,18,25,17,24,84
1354,4,ABVY01000154.1/6708-6604,UACUAAAGCGGAGAUGACAUUCCUCCCUACCCUCGCGCAGCCAAAACGCUGACAGCCUUAAAAACAGGGUACAACCGCCACUCGGCUAAUGAUGUCUACGUCCAC,31,19,20,35,105
1355,4,AE017198.1/798633-798695,AUUUAAUAUGGUGAUGGUGUUCACCAAUUUAACCGAUUAAUAUCUGACGACGCCUACUUUCUU,17,24,10,12,63
1356,4,CP000884.1/3908908-3908971,CUGCACGAUGGGAAUGGAGCUUCCCGAAACCUCCCUGCGAAGGGCUGAUGGCUCCUGCCUUGGU,11,14,20,19,64
1357,4,CP000697.1/351714-351653,GGCCGCGCCGGCGAUGGGGUUCGCCGUGAACCGCCCGCGGGGCUGAUGACUCCUGUUUCGAU,6,12,24,20,62
1358,4,AAFX01005291.1/667-735,ACGUCGCGUGGUGGUGGAGUCCACCUGAACCGCCGCUCUGACUGGACGGCCAAUGACUCCUACGCAUAG,13,13,21,22,69
1359,4,AP008230.1/2441450-2441510,AAUCAGAUAGGCGAUGGAGUUCGCCUUUAACCGCCGCUUGGCUAAUGACUCCUGCCGGUUA,13,16,16,16,61
1360,4,AAAK03000106.1/3476-3542,AGUGAAUAGGUGUAUGGUGUUCGCCUUUAAAUGCUAACGAAAGAUAGCUAAUGACGCCUACUAAAGU,22,19,16,10,67
1361,4,CP000903.1/4869306-4869365,AUAAUCAUAGGUGAUGGAGUUCGCCAUAACCGCUGCUUAGCUAAUGACUCCUACCAGUAU,17,17,12,14,60
1362,4,CP000678.1/1167738-1167808,UAAUAACUUGGUGAUGGGGUUCACCAGAAACUUAUUUUCAAACCGCAAUUGCUGAUAACUCCUAUGUUAUA,22,24,12,13,71
1363,4,CP000682.1/1397941-1398019,UAGGUUACUGGGGAUGGCGUCCCCCAGGGCUUGUUCCCGAACCGCCUGAUACAUGAAGGCUGAUGACGCCUAUCUCUUG,14,20,23,22,79
1364,4,FM177140.1/2570801-2570747,AAAUUAAAUGGCGAUGGUGUUCGCCUAUACGCAAGUUGAUGACACCUACCUUGAG,16,15,13,11,55
1365,4,CP000863.1/439864-439930,CUAAAACAGGGAGAUGGCAUUCCUCCCUUGAAAAACCGCCGUAUUGGCUAAUGAUGCCUACGUUACC,19,16,14,18,67
1366,4,AM920689.1/2646740-2646665,GGCCAUCUCGGAGAUGGCGUUCCUCCGCGCUGUACCAUCAACCGUAGCGAUCGCUACUGAUGACGCCUACAAGAAC,17,15,19,25,76
1367,4,CP000812.1/982299-982238,AAUAAGCCUGGUGAUGGAGUCCACCGUUAUUUGCCUUAAAGGCUGAUGACUCCUACUUGAAU,16,19,14,13,62
1368,4,CP001001.1/4759637-4759698,CGUCCCGAUGGGGAUGGAGUUCCCCGAAACCGCCCGUCAGGGCUGAUGACUCCUACCGCGAA,12,10,19,21,62
1369,4,CP000011.2/224010-224076,GCGGCGACCGGAGAUGGCAUGCCUCCGUACAACCGCCGGCGAGCCGGCUGAUGAUGCCUACGCGUUC,11,10,23,23,67
1370,4,CP000250.1/3360939-3360999,AACGGCGAUGGGGAUGGAGUCCCCCGACAACCGCCGCGAGGCUGAUGACUCCUACCGGGCG,12,7,22,20,61
1371,4,CP000423.1/2429871-2429817,AAAUUAAAUGGCGAUGGUGUUCGCCUAUACGCAAGUUGAUGACACCUACCUUGAG,16,15,13,11,55
1372,4,ABYW01000007.1/311285-311355,UAAUAACUUGGUGAUGGGGUUCACCAGAAACUUAUUUUCAAACCGCAAUUGCUGAUAACUCCUAUGUUAUA,22,24,12,13,71
1373,4,CR543861.1/406046-406112,CGACAGAUAGGAGAUGACAUUCCUCCUCGCAAAAACCGCCGUUCUGGCUAAUGAUGUCUACGUUACC,18,16,14,19,67
1374,4,CP000780.1/914945-915010,UCUGUCAGGGGCGAUGAAGUCCGCCGUAACCGCCUUACCCUAAAGGCUGAUGACUUCUGUUUUAUG,13,19,17,17,66
1375,4,CP000100.1/2263916-2263989,UACAAGCAGGGUGAUGGAGCUCACCUCAACCGCGCACUCGGCAUGGCCCGAUCGCUGAUGGCUCCUACAGUUCU,15,15,20,24,74
1376,4,BABD01000872.1/1124-1056,CAAAGUCAGGGGAAUGGGACUUCCCUGUUAUAAACCGCUAAUAAAGUAGCUGAUAGUUCCUGCCGGAGU,20,17,18,14,69
1377,4,CP000438.1/5078189-5078127,UUGCCGACAGGAGAUGGCAUUCCUCCUUCAACCGCCCCUGGGGCUGAUGAUGCCUACGCAUGA,12,14,17,20,63
1378,4,CP000967.1/2767544-2767620,UCGGGAUUCGGAGAUGGCGUUCCUCCGCGCAGUUCCAUCAAACCGUAGCGAUUGCUACUGAUGACGCCUACAAGAAC,18,17,20,22,77
1379,4,AM039952.1/2350991-2351059,GGCCGCACAGGAGAUGGCAUUCCUCCUCGAACCGCACGCACCCUGCGCGCUGAUGAUGCCUGCCCACCC,12,10,18,29,69
1380,4,CP001176.1/5025071-5025130,AUAAUCAUAGGCGAUGGAGUUCGCCAUAAACGCUGCUUAGCUAAUGACUCCUACCAGUAU,18,16,12,14,60
1381,4,L39876.1/4762-4825,UGCUGCAACGGCGAGGGAGUCCGCCGAACAAAUGCCAAUGAUGGCUGAUGACUCCUACAAAUAU,19,12,17,16,64
1382,4,AE005176.1/1105212-1105286,AUAAAUGAUGGGUAUGGUGCACACCCGAAACCGCUUUAAGAAUAAAAUCUUAAAACUAAUGGCGCCUACAAACAA,31,16,13,15,75
1383,4,AE014295.3/925740-925809,UGGAGAACCGGCGAUGGAACCCGCCUGAACUCGUUUCGAACCGCACACUGCUGAUAGUUCCUACACACGA,18,13,17,22,70
1384,4,AE008691.1/1847557-1847497,AAUAUUUAAGGUGAUGAAGCCCACCUUAAUUGCCGUAAAGGCUGAUGGCUUCUACGAAGAU,19,17,14,11,61
1385,4,AAPH01000002.1/303167-303249,AUUAUGACGGGAGAUGAUGAUCCUCCUUUAACUGCCUUACUGAAGUUUACCCUUCUUAUAAGGAUGAUGACGUCUAACAACAU,24,27,15,17,83
1386,4,AE016879.1/4823733-4823792,AUAAUCAUAGGCGAUGGAGUUCGCCAUAAACGCUGCUUAGCUAAUGACUCCUACCAGUAU,18,16,12,14,60
1387,4,AAMR01000022.1/13784-13701,UAGCCAUCAGGUGAUGGGGUUCCACCUAAGCUUUUGCUUCAACCGCCCGUUCUUUCGAACAGUGCUAAUGACUCCUACAGAAUC,19,24,17,24,84
1388,4,AP009049.1/304406-304465,AAAUAAUAAGGUGAUGGAGUUCACCAUAACCGCAGAAAUGCUUAUGACUCCUACAAAUAA,25,14,10,11,60
1389,4,CP000485.1/4850198-4850257,AUAAUCAUAGGCGAUGGAGUUCGCCAUAAACGCUGCUUAGCUAAUGACUCCUACCAGUAU,18,16,12,14,60
1390,4,ACIZ01000090.1/22576-22630,GAAUUAAAUGGCGAUGGUGUUCGCCUAUACGUAAGUUGAUGACACCUACCUUGUA,15,17,13,10,55
1391,4,CP000325.1/3045327-3045401,ACUAGCAGCGGCGAUGGGGCUCGCCAGGAAGCUCGACUUCUGAACCGCCAGCCGGCUGAUGGCACCUGCGAACAA,17,10,24,24,75
1392,4,CP001034.1/285558-285483,GGAUUUGACGGCGAUGGAGCUCGCCAGGAUUAAAUUCCAAACUGCUUUCUUAGAAGCUAAUGGCUCCUACCCUAUC,19,21,17,19,76
1393,4,CP000724.1/4518368-4518305,AUGCUCAUAGGCGAUGGAGUUCGCCAUUAACCACUGGAUAACAGUUAAUGACUCCUGCGAAACA,20,15,14,15,64
1394,4,AAXB02000001.1/235634-235709,CUUUUAGAAGGGAAUGAAGUUCUCCCUUAGUGAUCAUACUAGAACCGCUUAUAAAGCUGAUGACUUCUGCGAAUAA,24,23,15,14,76
1395,4,AAOU01000011.1/78540-78473,AUUAUGGCGGGAGAUGAUGUUCCUCCUUAAACCGCCUUUCAAUCAAGGAUAAUGACGUCUAACAACAU,21,19,13,15,68
1396,4,CP000423.1/2430592-2430656,AGAAGAACAGGCGAUGAUGUUCGCCGCAAAUGAUUGUGUAGCAAUCUGAUGACGUCUACUGAAAC,21,15,17,12,65
1397,4,ABBJ01001663.1/1415-1349,GCGGCGACCGGAGAUGGCAUGCCUCCGUACAACCGCCGGCGAGCCGGCUGAUGAUGCCUACGCGUUC,11,10,23,23,67
1398,4,CP000009.1/2355903-2355981,GAGGCAGAAGGCAAUGGAUUCUGCCUGACCGUUCCCGGUCGAACCGCUUCAUCCGGAAGCUGAUGAUUCCUGUCCCUCG,15,18,22,24,79
1399,4,CP000853.1/1242223-1242295,AUUUCUAUAGGGAAUGAAGUUCUCCCUUGGCAAUAGCCUAAACCGCAAAUAUGCUGAUGACUUCUGCGAAAAU,23,21,14,15,73
1400,4,AAQL01009062.1/467-395,AGGCAGAAAGGGAAUGAAGUUCUCCCCCGAUUUUUAUCGAAACCGCCAAUGAGCUGAUGACUUCUGUGCAAUG,21,18,18,16,73
1401,4,AAZP01000053.1/29998-29932,GCGGCGACCGGAGAUGGCAUGCCUCCGUACAACCGCCGGCGAGCCGGCUGAUGAUGCCUACGCGUUC,11,10,23,23,67
1402,4,AE016825.1/2613318-2613254,UUCUAUUGCGGAGAUGGCAUUCCUCCCGUAACCACCCCUAGAGGGUUGAUGAUGCCUACGGUAUU,13,19,16,17,65
1403,4,CP000855.1/737518-737592,GGCUUUUCGGGCGAUGGCGUCCGCCCGGGCUUCGAGCCGAACCGCCCGUUUUGGGCUGAUGACGCCUGUUCUCUG,6,19,26,24,75
1404,4,AM406671.1/1450312-1450238,AAUAAUGAUGGGUAUGGUGCACACCCGAAACCGCUUUAAGAAUAAAAUCUUAAAACUAAUGGCGCCUACAAACAA,31,16,13,15,75
1405,4,CP001146.1/51886-51949,AUCACAAGUGGCGAUGGAGUCCGCCAUAUAAUUGCCGAUAAAGGCUGAUGACUCCUACUUAUGU,18,17,15,14,64
1406,4,AAQK01000307.1/4537-4610,UAAUAACUUGGUGAUGGGGUUCACCAGAAACUUAUUUUCAAACCGCAAAAAUUGCUGAUAACUCCUAUGUUAUA,25,24,12,13,74
1407,4,AL590842.1/2918233-2918170,UCAAGAUCUGGAGAUGACACGCCUCCAUAACCGCCCUAACAAGGCUAAUGAUGUCUACGUGACC,19,13,13,19,64
1408,4,AE015928.1/5995735-5995673,CUUUGCACCGGCUAUGGGAUUAGCCUUUAACCGCCCUUUGGAGCUGAUGAUCCCUACAAUUUG,12,20,14,17,63
1409,4,AAFX01053991.1/352-284,AACGAUAACGGCGAUGGGGUUCGCCAGUCAAACCACUCGCGGCGGCGAGUUGAUGACCCCUACUUCGAG,16,12,21,20,69
1410,4,AP009256.1/922963-923040,CUGGACUGCGGUGAUGGGACUCGCCUGAAGCCGUUACAGGCUUCGAACCGCAAACCCGCUGAUGGUUCCUACGACAUA,17,16,22,23,78
1411,4,CP001283.1/4890016-4890075,AUAAUCAUAGGCGAUGGAGUUCGCCAUAAACGCUGCUUAGCUAAUGACUCCUACCAGUAU,18,16,12,14,60
1412,4,AE016830.1/2384514-2384445,UAGCAACAUGGUGAUGGUGUUCACCACGAACUAUUUAUUGGACGAAUAAAUUAAUGACGCCUACCAAACG,24,18,14,14,70
1413,4,ABXA01000043.1/134014-134086,AUAUUAGAAGGGAAUGAAGUUCUCCCUUAGAAAAAUCUAAAACCGCAUUUAUGCUGAUGACUUCUGUAACUAU,26,23,12,12,73
1414,4,BA000001.2/1278365-1278285,GGUUCCUUGGGCGAUGGCGCCCGCCCGGGGCUUCGAGCCCGAACCGCCUCCCGUUGGGAGGCUGAUGGCGCCUAUUCUGUA,8,17,29,27,81
1415,4,CP001177.1/4829881-4829940,AUAAUCAUAGGCGAUGGAGUUCGCCAUAAACGCUGCUUAGCUAAUGACUCCUACCAGUAU,18,16,12,14,60
1416,4,FM178380.1/1142244-1142180,GGCGUACAAGGUGAUGGGGUGCCACCUACUUAACCGCCAAUUUGGCUGAUGACUCCUACAGUAAA,17,15,17,16,65
1417,4,AAVL02000037.1/287218-287292,UAAAUAAAAGGGAAUGAGGUUCUCCCUCGAUUUAAUCGAAACCGCUUAUAACAAGCUGAUGACUUCUGUGCAAUA,26,21,14,14,75
1418,4,ABHH01000009.1/50257-50182,UACCAUUUUGGGAAUGAAUGUCUCCCUUAGCAUACUGCUUAAACCGCUUAUUAAAGCUGAUGACUUCUGCGCAUAG,20,25,14,17,76
1419,4,CP000254.1/1244505-1244443,GUAAACCAGGGUGAUGGGGUUCACCUGUAACCGCUUUUUCCAGCUGAUGACUCCUCUUCCUGU,11,20,15,17,63
1420,4,AE016853.1/5215709-5215637,CGGCGCAUUGGAGAUGGCAUUCCUCCAUUAACAAACCGCUGCGCCCGUAGCAGCUGAUGAUGCCUACAGAAAC,19,14,18,22,73
1421,4,ABVX01000036.1/35509-35405,UACUAAAGCGGAGAUGACAUUCCUCCCUACCCUCGCGCAGCCAAAACGCUGACAGCCUUAAAAACAGGGUACAACCGCCACUCGGCUAAUGAUGUCUACGUCCAC,31,19,20,35,105
1422,4,AACY023333559.1/192-117,AAUAGUGGCGGGAAUGAAGUGCUCCCUUCAUAUGAUAUGAAAACCGCAAACACGUGCUGAUGACUUCUACGAUUUU,23,21,17,15,76
1423,4,AM889285.1/3856660-3856597,CGUCCGGUCGGAGAUGGAGUACCUCCGUAUAACCGCCCCCAGGGCUGAUGACUCCUGCUCGCAU,11,13,18,22,64
1424,4,CP001337.1/1659433-1659494,UAGCUCAUAGGUGAUAAGGCUCACCGUUGAACUGCCCGCGGGCUGAUGGCCUCUACAGAAGU,14,14,18,16,62
1425,4,CP000789.1/3337036-3337110,AAUGGGCACGGUGAUGGGGUGCCACCGGAAUCGAAAGAUUCGAACCGCUUUAAAGCUAAUGACUCCUACAGAAAC,24,14,20,17,75
1426,4,BAAY01001852.1/271-348,CUGGACUGCGGUGAUGGGACUCGCCUGAAGCCGUUACAGGCUUCGAACCGCAAACCCGCUGAUGGUUCCUACGACAUA,17,16,22,23,78
1427,4,CP000826.1/1310091-1310029,UCGAACGACGGAGAUGACAUUCCUCCUUAACCGCCUUCACGGGCUGAUGAUGUCUACGUAACC,15,15,14,19,63
1428,4,ACGY01000069.1/12451-12387,AGAAGAACAGGCGAUGAUGUUCGCCGCAAAUGAUUGUGUAGCAAUCUGAUGACGUCUACUGAAAC,21,15,17,12,65
1429,4,CP000481.1/805841-805902,ACUGAACGCGGCGAUGAAGCCCGCCGACAAUGCGCCGCCCGGCUGAUGGCUUCUACCGAGUU,12,10,19,21,62
1430,4,ABBQ01000905.1/4347-4281,GCGGCGACCGGAGAUGGCAUGCCUCCGUACAACCGCCGGCGAGCCGGCUGAUGAUGCCUACGCGUUC,11,10,23,23,67
1431,4,ACCE01000005.1/360072-360138,GCGGCGACCGGAGAUGGCAUGCCUCCGUACAACCGCCGGCGAGCCGGCUGAUGAUGCCUACGCGUUC,11,10,23,23,67
1432,4,CP001215.1/4826181-4826240,AUAAUCAUAGGCGAUGGAGUUCGCCAUAAACGCUGCUUAGCUAAUGACUCCUACCAGUAU,18,16,12,14,60
1433,4,ABJD02000101.1/724041-724112,CUAACAAAAGGAGAUGGCAUUCCUCCUGUUUAAAAACCGUCCAAAUAAAGGGCUGAUGAUGCCUGCGUUCAC,23,17,15,17,72
1434,4,CP000605.1/969434-969503,UGGAGAACCGGCGAUGGGACCCGCCUGAACUUGUUUCGAACCGCACACUGCUGAUAGUUCCUACACACGA,17,14,18,21,70
1435,4,CP001078.1/1342444-1342385,UAUAUAUUAGGUGAUGGAGUUCGCCUUUAAACGCGUAAUGCUAAUGACUCCUACAAAAAA,21,18,11,10,60
1436,4,CP000141.1/1888854-1888795,AAAUUUAAUGGCGAUGGGGCUCGCCUAACGCUCAUCUGAGCUAAUAGCUCCUACCGAAAG,17,14,14,15,60
1437,4,CP000650.1/81552-81622,UUGCGGCGAGGUGAUGGCGUUCCACCUUACCCAACCGCUUCCCCUGAGAAGCUGAUGACGCCUGAUAUUAC,14,17,18,22,71
1438,4,AE009950.1/1333263-1333185,GUUCUUUGGGGUGAUGGCGCCGCCCGGGGCUUCGAGCCGAACCGCCUCCCGUUGGGAGGCUGAUGGCGCCUAUUCUGUA,8,19,29,23,79
1439,4,AE005176.1/274025-274097,AUAGUAGAUGGGUAUGGUGCACACCCGAAACCGUUUCAAGAAAUAGCUUGAAUCUAAUGGCGCCUACAAAGCA,25,16,17,15,73
1440,4,CP001407.1/4853207-4853266,AUAAUCAUAGGCGAUGGAGUUCGCCAUAAACGCUGCUUAGCUAAUGACUCCUACCAGUAU,18,16,12,14,60
1441,4,ABSD01000048.1/169379-169321,CAUUUAUAAGGUGAUGGGGCCCACCAAACCGCCGCAAGGCUGAUGGCUCCUUUUGAAAA,16,13,15,15,59
1442,4,CP000957.1/84698-84619,UUUAGCGAUGGUGAUGGAGCUCACCGAAACCGCCCAGGAUUUUUCUUAAUUGCACCUCGGCUAAUGGCUCCUACGCUUCC,16,23,18,23,80
1443,4,AM743169.1/1735698-1735635,GACCGCGAUGGGGAUGGGGCUCCCCCGAUAACCGCCUGAGAAGGCUGAUGGCUCCUGCCAGGAC,12,9,23,20,64
1444,4,CP001132.1/2508708-2508771,AAAACGUGUGGCGAUGGAGUCCGCCCAAUAACCGCCUUUAUAGGCUGAUGACUGCUACUGAUCC,16,15,16,17,64
1445,4,CP000780.1/914829-914764,UUUUUUAACGGCGAUGAAGUCCGCCUCCAACCGCCACGUAUCGUGACUGAUGACUUCUACCGGGGA,14,17,16,19,66
1446,4,CP000822.1/1490183-1490109,AGUUCACAAGGUGAUGGUGUUCCACCUUUCCCAACCGCCGGUUCGCUCGAAUCGGAUGAUGACGCCUGAUAUACA,17,19,18,21,75
1447,4,ABYN01000048.1/132548-132614,UAGGGCAAAGGAGAUGGCAUUCCUCCUGUAACAAACCGCCAUUGUGGCUAAUGAUGCCUACGUUACU,18,17,16,16,67
1448,4,CP001189.1/2909225-2909147,GUCGGCGCAGGCAAUGGAUUUCUGCCUGACCGUCCGGGUCGAACCGCCUCUUUCGGGGGCUGAUGAUUCCUACCCACCG,11,18,24,26,79
1449,4,ABOX02000009.1/3464-3546,AUAUGCAUUGGCAAUGGGGUUUGCCUUCUCGGUCAACGAGAGAACCGCCUGAUUAUUUCGGUGCUGAUAACUCCUAUUGGUAC,18,26,21,18,83
1450,4,CP000478.1/3591388-3591322,UUGAAUUGCGGCGAUGAAGUUCGCCCUGAACCGCCCCGGGCCAGGGGAUGAUGACUUCUACUUCGAA,14,15,20,18,67
1451,4,ABGC03000023.1/52156-52229,AAAGAAAAAGGGAAUGAAGUUCUCCCUCGAAGAGAUUCGAAACCGCUUAUUAAGCUGAUGACUUCUGUGCGAUG,25,18,18,13,74
1452,4,ABQV01000049.1/12339-12285,AAAUUAAAUGGCGAUGGUGUUCGCCUAUACGCAAGUUGAUGACACCUACCUUGAG,16,15,13,11,55
1453,4,CP000924.1/2271016-2270957,AUACCAUAAGGUGAUGGAGCUCGCCAUAAAUGCGGAAACGCUGAUGGCUCCUAUUAGGAG,18,13,17,12,60
1454,4,CP001598.1/4823759-4823818,AUAAUCAUAGGCGAUGGAGUUCGCCAUAAACGCUGCUUAGCUAAUGACUCCUACCAGUAU,18,16,12,14,60
1455,4,CR378667.1/326415-326332,AUUAUGACGGGAGAUGAUGUUCCUCCUUUAACUGCCUUACUGAAGUUUACCCUUCUUAAUAAGGAUGAUGACGUCUAACAACAU,24,28,15,17,84
1456,4,AM889285.1/3849897-3849819,GUCGGCGCAGGCAAUGGAUUUCUGCCUGACCGUCCGGGUCGAACCGCCUCUUUCGGGGGCUGAUGAUUCCUACCCACCG,11,18,24,26,79
1457,4,AANC01000009.1/2226-2162,UCAAUCACAGGCAAUGAGGUCUGCCUCAAACCGCUUCUUAGCAAGCUGAUGACUUCUACUUAACC,18,17,11,19,65
1458,4,ACKA01000027.1/241427-241361,GCGGCGACCGGAGAUGGCAUGCCUCCGUACAACCGCCGGCGAGCCGGCUGAUGAUGCCUACGCGUUC,11,10,23,23,67
1459,4,BA000043.1/2726409-2726347,AAUCGAAUAGGCGAUGGAGUUCGCCAUAACCGCCGGCUUCCGGCUGAUGACUCCUGCUGCAAA,15,13,17,18,63
1460,4,CP000568.1/234427-234485,UGAAUAAAAGGUGAUGGAGUUCACCUGAAAUGCGUAAUGCUGAUGACUCCUACAGGAAU,20,15,15,9,59
1461,4,CP001052.1/1800329-1800268,UUGCGCGCUGGAGAUGGCAUUCUCCCUUAACCGCCCUCGUGGCUGAUGAUGCCUGCUUCGUC,7,18,17,20,62
1462,4,CP001130.1/523442-523357,CAGGUUUAAGGAGAUGGCGUUCUCCUUGAUGCUCAUAAAAGCAUCAAAACCGCCUCACAUAUAAGGCUAAUAACGCCUACCUGCUC,26,21,16,23,86
1463,4,AP009389.1/615295-615357,AUAUUUUCUGGCGAUGGGGCUCGCCUUAAUUUUGCUGAAAAAGCUGAUAGCUCCUACCCGUAA,15,20,14,14,63
1464,4,ABXU01000089.1/23581-23642,GAAGGUCAAGGGGAUGGAGUCCCCCAUGAACCGCAUGUUUUGCUGAUGACUCCUGCCGGACC,13,13,19,17,62
1465,4,AE000666.1/688929-688867,CAUCCUGCAGGUGAUGGAGUCCACCUUUAACCGCUUUUUCUGGCUGAUGACUCCUGCAUAAUA,13,20,13,17,63
1466,4,AE009952.1/1314365-1314302,UCAAGAUCUGGAGAUGACACGCCUCCAUAACCGCCCUAACAAGGCUAAUGAUGUCUACGUGACC,19,13,13,19,64
1467,4,CP000413.1/283109-283169,AAUUGAAUAGGCGAUGACGGUCGCCAUUAAACGAGCAAAAUCUAAUGACGUCUACUAUUUA,22,16,12,11,61
1468,4,CP000004.1/152384-152449,UCCCGACAAGGGGAUGGAGCUCCCCCUUCAACCGCCCUCGCAAGGGCUGAUGGCUCCUACCGCGAC,12,10,18,26,66
1469,4,CP000822.1/1409469-1409541,CCUGUGCAGGGUGAUGGCGUUCCACCUUAUUCCAACCGCCUCGUUUCAGUAGGCUGAUGACGCCUGAUAUGAC,13,20,19,21,73
1470,4,CP000413.1/1279279-1279217,AUUAUAAUAGGUGAUGGCGUUCACCAAUUUAACCGAUUAAGAUCUGACGACGCCUACUUUCUU,18,21,11,13,63
1471,4,CP000230.1/293075-293134,GACGAUACUGGGAAUGGGGUCUCCCGAAACCGCCGAAAGGCUGAUGACUCCUACCGCGUA,15,10,18,17,60
1472,4,AP008232.1/1344619-1344556,CUUUCCCCAGGAGAUGAAAUUACUCUUUAUAACCGCCGCUCUGGCUGAUGAUGUCUACGUUCAU,14,21,12,17,64
1473,4,CP000943.1/4458865-4458926,UGGCGGUCUGGGGGUGGAGUUCCCCAUAACCGCCCACCCGGGCCGAUGACUCCUACCGCGUG,8,11,21,22,62
1474,4,ABYS02000004.1/646163-646241,CUUACCGGUGGCGAUGGGACUCGCCUGGGGCCUGCAAGGAUUCCCGAACCGCAAUUCCGCUGAUGGUUCCUAUUGACGC,13,18,24,24,79
1475,4,ABSD01000048.1/33401-33462,UCUGCUUCGGGUGAUGGCGUCCACCCCGAAACGCCCGCGUGGCUGAUGACGCCUUUUCGCAU,8,15,18,21,62
1476,4,CU459141.1/3434387-3434321,UUAAAACAGGGAGAUGGCAUUCCUCCCUUGAAAAACCGCCGUAUUGGCUAAUGAUGCCUACGUUACC,19,17,14,17,67
1477,4,CP000254.1/1238338-1238398,UGUCAUACUGGUGAUGGAGUUCACCAAAACCGCCGUUCGGGCUGAUAACUCCUACAGGAUG,15,15,16,15,61
1478,4,BA000040.2/2887392-2887315,CGCACAGAUGGGGAUGGAGUCCCCCGACAACCGCCCGGCGGUAGGUGACCGUGAUGGGCUGAUGACUCCUGCUUGAGG,14,13,29,22,78
1479,4,ABYL01000251.1/1837-1776,UUCGCGGCUGGAGAUCGCAUUCUCCAUUAACCGCCCCUGGGGCUGAUGAUGCCUGCUACGCC,9,15,17,21,62
1480,4,CP001069.1/247334-247411,CCCCGUUGUGGAGAUGGCAUGCCUCCCUUAACCGCCGGUUAGCGCGUAACGAUACCGGCUGAUGAUGCCUACAAGUUC,15,18,21,24,78
1481,4,BA000019.2/2723228-2723309,AUUACUAAUGGCGAUGGAGUUCGCCAAAACCGCUAUUCUAGUCAAAAAAUUAAUCUAGAAGGCUGAUGACUCCUACUUUUCU,26,25,14,17,82
1482,4,ABVL01000003.1/298778-298860,GCCCGUAACGGCAAUGGAUUUCUGCCGCCCGAGUGAUCGGGGAACCGCUUGGUAACGGCCAGGCUGAUGAUUCCUGUUUUCAC,15,20,25,23,83
1483,4,FM209186.1/5248344-5248282,UUGCCGACAGGAGAUGGCAUUCCUCCUUCAACCGCCCCUGGGGCUGAUGAUGCCUACGCAUGA,12,14,17,20,63
1484,4,AE013598.1/2682944-2683020,UCGGGAUUCGGAGAUGGCGUUCCUCCGCGCAGUUCCAUCAAACCGUAGCGAUUGCUACUGAUGACGCCUACAAGAAC,18,17,20,22,77
1485,4,AAQL01004413.1/1469-1396,AAAGAGAAAGGGAAUGAAGUUCUCCCUCGAAGAGAUUCGAAACCGCUUAUUAAGCUGAUGACUUCUGUGUAAUG,25,19,18,12,74
1486,4,ABCM01000001.1/151944-151879,UUGCCUAAGGGAAAUGGUGUCCUUCCAAUUUAACCGCUUUUAGAAGCUGAUGGCGCCUGCAAUGAU,16,20,16,14,66
1487,4,AAWO01000020.1/7863-7793,AGGAAGACAGGCGAUGGGGUUCGCCAAAACCGCCCCGGAGAACAGCGGGAGCUGAUGACCCCUACUCCAUU,19,9,22,21,71
1488,4,CP000764.1/3708919-3708978,AAUGAAUACGGCGAUGGAGUUCGCCACAACCGCUGCUUAGCUAAUGACUCCUACCAGGAU,17,13,14,16,60
1489,4,AE008691.1/1840761-1840702,UGCAUAAAAAGUGAUGGAACCCACUUUAACCGCCGAAAGGCUGAUGGUUCCUACUUGUGA,18,15,14,13,60
1490,4,CU468230.2/2879674-2879608,UUAAAACAGGGAGAUGGCAUUCCUCCCUUGAAAAACCGCCGUAUUGGCUAAUGAUGCCUACGUUACC,19,17,14,17,67
1491,4,AAHW02000001.1/301150-301084,GCGGCGACCGGAGAUGGCAUGCCUCCGUACAACCGCCGGCGAGCCGGCUGAUGAUGCCUACGCGUUC,11,10,23,23,67
1492,4,AJ248285.1/89834-89914,GUUCUCUUGGGCGAUGGCGCCCGCCCGGGGCUUCGAGCCCGAACCGCCUCCCAUGGGGAGGCUGAUGGCGCCUAUUCUUGA,9,17,28,27,81
1493,4,AAMY01000002.1/145285-145345,GAAAUCGAUGGGGAUGGAGUUCCCCGAUACCCGCCGCAAGGCUGAUGACUCCUACCGGGCG,13,10,20,18,61
1494,4,ABSD01000050.1/82708-82766,CAUUUAUAAGGUGAUGGGGCCCACCAAACCGCCGCAAGGCUGAUGGCUCCUUUUGAAAA,16,13,15,15,59
1495,4,AAFX01041918.1/509-577,AAGUCCGAAGGCGGUGGAGUCCGCCACAACCGUCAUGCGCCUGCCGUGGCCAAUGACUCCUGCGGGGUU,12,12,23,22,69
1496,4,AE006641.1/885812-885728,AAUGAAGUAGGGGAUGGCGUCCCCCUGGGGAUAACCCCGAACCGCCUCUUGAUUAAUGAUAGGGGCUGAUGACGCCUACUUCACC,20,18,24,23,85
1497,4,ABCH01000002.1/2875-2939,UGCAACCAAGGUGAUGGGGUUCCACCUACUUAACCGCCAAAUCGGCUGAUGACUCCUACAGUUUC,16,16,14,19,65
1498,4,CP000099.1/4790369-4790299,UAUCCUAUAGGUGAUGAAGUCCGCCAAGAUUUACAGUCUAAACCGCUUAUGCUGAUGACUUCUACAUUAAU,21,23,12,15,71
1499,4,CP001364.1/429603-429664,AAUCGAUUGGGUGAUGAGGCUCACCCUCAACUGCCAUUACGGCUGAUAGCCUCUACAGGGAA,16,14,16,16,62
1500,4,ABGR01000008.1/95568-95493,AUUGGGGUUGGUGAUGGGGUGCCACCGGAAUCGAAUGAUUCAAACCGCUUGUAUAGCUGAUGACUCCUACAGAGAC,19,19,23,15,76
1501,4,AE017355.1/4836662-4836721,AUAAUCAUAGGCGAUGGAGUUCGCCAUAAACGCUGCUUAGCUAAUGACUCCUACCAGUAU,18,16,12,14,60
1502,4,CP000668.1/3010272-3010335,UCAAGAUCUGGAGAUGACACGCCUCCAUAACCGCCCUAACAAGGCUAAUGAUGUCUACGUGACC,19,13,13,19,64
1503,4,AAWP01000027.1/44793-44868,AAUGCACACGGUGAUGGGGUGCCACCAGAAUCGAAAGAUUCAAACCGCUUUUACAGCUGAUGACUCCUACAGAAAC,25,15,17,19,76
1504,4,AE008923.1/2352963-2353030,GGCCGCACAGGAGAUGGCAUUCCUCCUCGAACCGCACGCACCCGCGCGCUGAUGAUGCCUGCCCACCC,12,9,18,29,68
1505,4,AACY020346117.1/2623-2561,UUGCGCGCUGGAGAUGGCAUUCUCCAUUAACCGCCCUUGAUGGCUGAUGAUGCCUGCUUCGCC,9,18,17,19,63
1506,4,ABCM01000022.1/54798-54866,UUGCAAUACGGAAAUGGUGUCCUUCCGAUUCAACCGCUUUUUUCAAAAGCUGAUGGCGCCUACAAUAGA,19,20,14,16,69
1507,4,AAFX01046182.1/76-12,AACCCCAAGGGAAAUGGUGUCUUCCCUGCACAAACCGCUUGAAAGCUGAUGACGCCUUCAAAUCG,19,13,14,19,65
1508,4,AAQL01000312.1/1879-1949,UAAUAACUUGGUGAUGGGGUUCACCAGAAACUUAUUUUCAAACCGCAAUUGCUGAUAACUCCUAGGUUAUA,22,23,13,13,71
1509,4,AAEW02000001.1/156146-156076,CAUGUUAACGGGAAUGGAGUUCUCCCGGUAACCGCCUGUCGAUUUUUCAGGCUGAUGACUCCUGUAUGAGG,14,21,20,16,71
1510,4,ABCC02000039.1/237860-237932,AUAAGUACCGGGAAUGAAGUUCUCCCUUAGUCUGACUAGAACCGCUUAUAAAGCUGAUGACUUCUGCAUUAUG,21,22,15,15,73
1511,4,CP001186.1/4973458-4973517,AUAAUCAGAGGCGAUGGAGUUCGCCAUAACUGCUGCUUAGCUAAUGACUCCUACCAGUAU,17,16,13,14,60
1512,4,ABBM01000878.1/872-806,GCGGCGACCGGAGAUGGCAUGCCUCCGUACAACCGCCGGCGAGCCGGCUGAUGAUGCCUACGCGUUC,11,10,23,23,67
1513,4,CP001111.1/1611287-1611224,GGCGACGAUGGGGAUGGGGCUCCCCCGAUAACCGCCUGAGAAGGCUGAUGGCUCCUGCCAAGAC,13,9,23,19,64
1514,4,CP000679.1/782565-782643,GAAUAUAGAGGCGAUGGAGUUCGCCUUAAAUUGCCACAAGAAUGAAAAAUACCUUGUGGCUGAUAACUCCUGUCCGUAU,25,21,18,15,79
1515,4,AL954747.1/1838968-1838902,AUAAUAAUUGGAGAUGGCAUUCCUCCAUUAACCGCCGCAAUCUGUGGCUGAUGAUGCCUACGACUGG,17,18,16,16,67
1516,4,CP000358.2/504027-504091,AGCAACACAGGCGAUGGCAUGCGCCUUGAACCGCCCCGCGUCCGGCUGAUUAUGCCUACCUUCCC,12,12,16,25,65
1517,4,CP000319.1/1049491-1049431,CUGGAAACAGGGAAUGGUGUCUCCCUUUCACCGCCGACUGGCUGAUGACUCCUGCUGACUG,11,15,17,18,61
1518,4,CP000975.1/1995740-1995815,CUCUUAUUGGGCGAUGGGGCUCGCCGACCGUUAACCGCCGUUCUUUUCAAAGAAGGCUGAUAGCUCCUACCUCUAA,15,21,18,22,76
1519,4,AAXG02000029.1/31858-31932,GUGAAUCAGGGGAAUGAAGUGCUCCCCGGGGCGUGGCCCCGAACCGCGUUUGACGCUGAUGACUUCUGCAUUUUG,13,18,25,19,75
1520,4,ABLD01000041.1/16968-17073,UUGCGUGCUGGAGAUGGCAUUCUCCAAUGGGUGUCCGGCGUGCGCUUCAACACACGCGCUCGCGCGAACCCAUUAACCGCCUCGUGCUGAUGAUGCCUGCUUCCCC,16,25,29,36,106
1521,4,AADL01001839.1/2172-2233,UUCAAGAAAGGCUAUGACGUUAGCCUUUAAGCGCCCUCCGGGCUGAUAACGUCUGAUCUUUA,15,18,14,15,62
1522,4,CP000884.1/1926512-1926446,GCAGCGCAAAGAGAUGGCGUGCCUCUAAAACCGCCGCACUAGUGCGGCUGAUGACGCCUACAGAACC,18,9,19,21,67
1523,4,AAPS01000002.1/29498-29423,AAUGGGUUCGGUGAUGGGGUACCACCGGAAUCGAAAGAUUCGAACCGCUGUUAAAGCUAAUGACUCCUACAGAAAC,24,16,20,16,76
1524,4,CP000115.1/166253-166313,GAAAUCGAUGGGGAUGGAGUCCCCCGAUAACCGCCGCAAGGCUGAUGACUCCUACCGGGCG,14,9,20,18,61
1525,4,AM406671.1/272338-272410,AUAAUAGAUGGGUAUGGUGCACACCCGAAACCGUUUCAAGAAAUAACUUGAAUCUAAUGGCGCCUACAAAGCA,27,16,15,15,73
1526,4,AADL01002490.1/18401-18475,AUGACGAGGGGUGAUGGAGUCCACCUGAACGGCCCUUUCUUUCAUAAGGAAAGGGAUGAUGACUCCUGUGAGAGA,20,17,24,14,75
1527,4,CU914166.1/1142118-1142184,CCGGCUUGCGGAGAUGGCAUACCUCCCUUAACCGCCGAUCACCUCGGCUGAUGAUGCCUACAAGUUC,13,15,16,23,67
1528,4,AL646052.1/1941892-1941826,CCGGCCUGCGGAGAUGGCAUGCCUCCCUUAACCGCCGAUCCCAUCGGCUGAUGAUGCCUACAGGUUC,11,14,18,24,67
1529,4,ABLC01000046.1/24103-24037,GUCACGCGUGGAGAUGGCAUUCCUCCUUUAACCGCCGAUUCGCUCGGCUGAUGAUGCCUACGUGCCC,10,17,18,22,67
1530,4,CP000702.1/1794817-1794880,AACCCAACGGGCGAUGAGGCCCGCCCAAACUGCCCUGAAGAGGGCUGAUGGCCUCUACUGGCUU,14,10,19,21,64
1531,4,ABXP01000064.1/2857-2798,UGCAUAAAAAGUGAUGGAACCCACUUUAACCGCCGAAAGGCUGAUGGUUCCUACUUGUGA,18,15,14,13,60
1532,4,CP001130.1/516815-516883,UAACCACAAGGAGAUGGCGUUCUCCUUUAAGCGCCUCCUUCAAAAGAGGCUGAUAACGCCUACAAGCUC,20,15,14,20,69
1533,4,CU458896.1/2498027-2498099,UUCGUCAGGCGCGAUGGAUCUCGCCAGGGCUUGUCCCGAACCGCCACUGACGGCUGAUAGUUCCUGUGUUGAU,11,19,22,21,73
1534,4,CP000021.2/1258800-1258735,AUACGUAAAGGUGAUGGGGUUCCACCUACUUAACCGCCAAUGUUGGCUGAUGACUCCUACAGAAUA,19,17,15,15,66
1535,4,ABXP01000064.1/9651-9591,AAUAUUUAAGGUGAUGAAGCCCACCUUAAUUGCCGUAAAGGCUGAUGGCUUCUACGAAGAU,19,17,14,11,61
1536,4,CP001196.1/1408427-1408488,AUUGUUGAUGGGGAUGGAGUUCCCCCGAUAACCGCCGCAAGGCUGAUGACUCCUACCGGACG,13,13,19,17,62
1537,4,CP000117.1/118149-118230,GUUACUAAUGGCGAUGGAGUUCGCCCAAACCGCUAUUCUAGUCAAAAAAUAAAUCUAGAAGGCUGAUGACUCCUACUACUCU,26,22,15,19,82
1538,4,CP001043.1/2012557-2012617,GCGCGCGCCGGAGAUGGCAUUCUCCUUAACCGCCCUCGUGGCUGAUGAUGCCUGCUUCGCC,7,14,18,22,61
1539,4,CP000240.1/171311-171206,CCGGCAACCGGCGAUGGAGUUCGCCGCAACCGCCUCACUUGGAAUUUUUCUAUAGAGGAAGAGGGUUCUAACCUCAAAAGCUGAGGCUGAUGACUCCUACACUUCU,26,25,26,29,106
1540,4,CP000859.1/3573766-3573832,AGAAACGAUGGGGAUGGGGUCCCCCGACAACCGCCGCACUGGACAGGCUGAUGACUCCUGCCGAUAC,16,9,21,21,67
1541,4,CP000930.2/1203106-1203045,AAGGGAAUACGCGAUGGAGUUCGCGGUAAAGCCGUUUUGCGGAUGAUGACUCCUACUCGAUU,15,16,19,12,62
1542,4,AP006878.1/440492-440567,UUCAGCGCGGGCGAUGGCGUCCGCCCGGGGCUUCGAGCCCGAACCGCUCGAAAGGGCUGAUGACGCCUGUUCUACU,11,14,26,25,76
1543,4,AAWL01000036.1/2586-2647,UAAGUUUGCGGCGAUGGAGUUCGCCAUAAGUCCGCAUAAGCGGUAAUGACUCCUACCAGGAC,16,14,17,15,62
1544,4,AAHO01000134.1/6134-6200,GCGGCGACCGGAGAUGGCAUGCCUCCGUACAACCGCCGGCGAGCCGGCUGAUGAUGCCUACGCGUUC,11,10,23,23,67
1545,4,AP006620.1/61342-61253,GAGUCCGCAGGCGAUGGAUCUCCGCCGAGACGACCGACCUAUGGGCCGUCUGAACCGCCCCGGUCCGGGGCUGAUGGUUCCUUCCCCACG,13,15,29,33,90
1546,4,ACNB01000166.1/6496-6555,AUAAUCAGAGGCGAUGGAGUUCGCCAUAACUGCUGCUUAGCUAAUGACUCCUACCAGUAU,17,16,13,14,60
1547,4,ABEY02000020.1/92291-92375,AUUAUAAAAGGGAAUGAGGUUCUCCUCUGGAAAACCUGAAUGGGCAACCUAAACUGCUAAUAUAGCUGAUGACUUCUACGAUUAU,29,24,17,15,85
1548,4,CP000950.1/3331346-3331409,UCAAGAUCUGGAGAUGACACGCCUCCAUAACCGCCCUAACAAGGCUAAUGAUGUCUACGUGACC,19,13,13,19,64
1549,4,CP000697.1/677221-677283,UCCGAUGCCGGUGAUGGAGUUCACCGUGUAACCGCCCGUGGGGCCGAUGACUCCUGUUCAUAU,10,16,19,18,63
1550,4,AF359557.1/22906-22967,AUCUGCACAGGAGAUGGCAUUCCUCCUUGAAACCGCCUCGUGCUGAUGAUGCCUACGUAAAC,15,15,14,18,62
1551,4,CP001133.1/1365444-1365379,AUACGUAAAGGUGAUGGGGUUCCACCUACUUAACCGCCAAUGUUGGCUGAUGACUCCUACAGAAUA,19,17,15,15,66
1552,4,AE016877.1/4975681-4975742,AUAAUCCUAGGCGAUGGAGUUCGCCAUAAACGCGCUGCUUAUCUUAUGACUCCUACCAGUAU,16,18,12,16,62
1553,4,ABXW01000051.1/16406-16474,GUCUUGUUAGGAGAUGGCAUUCCUCCUAGUUUAACCGUCCUUUUGUGGACUGAUGAUGCCUACGUAAAC,14,24,16,15,69
1554,4,CP000319.1/237736-237676,GACAUCGAUGGGGAUGGAGUUCCCCGAUACCCGCCGCAAGGCUGAUGACUCCUACCGGGCG,12,10,20,19,61
1555,4,CP000239.1/520035-519935,CCGGCAACGGGCGAUGGGGUUCGCCGCAACCGCCUCAGGCAGAUCCUAGGGAUAAAGUUUCUCUAAGACUUAGAGCUGGGGCUGAUGACUCCUACUCUUCU,21,23,29,28,101
1556,4,AE000782.1/1391410-1391471,AUCGGUAUGGGUGAUGGCGUCCACCUUCAACCGCCGCUAAGGCUGAUGACGCCUGUUCUCAG,11,15,18,18,62
1557,4,ABBP01001115.1/6777-6711,GCGGCGACCGGAGAUGGCAUGCCUCCGUACAACCGCCGGCGAGCCGGCUGAUGAUGCCUACGCGUUC,11,10,23,23,67
1558,4,BAAZ01017612.1/714-637,CUGGACUGCGGUGAUGGGACUCGCCUGAAGCCGUUACAGGCUUCGAACCGCAAACCCGCUGAUGGUUCCUACGACAUA,17,16,22,23,78
1559,4,ACAN01000070.1/46719-46650,UAGCAACAUGGUGAUGGUGUUCACCACGAACUAUUUAUUGGACGAAUAAAUUAAUGACGCCUACCAAACG,24,18,14,14,70
1560,4,ABSD01000051.1/73291-73230,UCUGCUUCGGGUGAUGGCGUCCACCCCGAAACGCCCGCGUGGCUGAUGACGCCUUUUCGCAU,8,15,18,21,62
1561,4,CP001052.1/4147651-4147580,GAAGCUUUCGGAGAUGGCAUUCCUCCCGUAACCGCCCUGCAUUCCCGCAGAGCUGAUGAUGCCUACGAGUUC,14,17,18,23,72
1562,4,AAHS03000001.1/321518-321584,GCGGCGACCGGAGAUGGCAUGCCUCCGUACAACCGCCGGCGAGCCGGCUGAUGAUGCCUACGCGUUC,11,10,23,23,67
1563,4,AAIR02000026.1/4415-4481,GCGGCGACCGGAGAUGGCAUGCCUCCGUACAACCGCCGGCGAGCCGGCUGAUGAUGCCUACGCGUUC,11,10,23,23,67
1564,4,AADL01000572.1/2844-2904,CCGGCGGAUGGCGAUGGGGUUCGCCUAAUCCCGCAUUUCGGGUGAUGACUCCUACCAUGGG,9,14,21,17,61
1565,4,CP000020.2/35443-35510,CCAAAUACGGGUGAUGGAUUUCCACCUUUAACCGCUCUAUUUUUAGAGAUAAUGAUUCCUACUAUAGC,19,23,11,15,68
1566,4,AAKV01000114.1/24659-24721,UUGCCGACAGGAGAUGGCAUUCCUCCUUCAACCGCCCCUGGGGCUGAUGAUGCCUACGCAUGA,12,14,17,20,63
1567,4,CP000517.1/1061364-1061422,AACUAAAUAGGUGAUGACGUUCACCAUUAACCGAGAGAUCUAAUGACGGCUACUUUAUC,20,16,11,12,59
1568,4,CT573326.1/3719897-3719836,CGUGGCCCAGGAGAUGGCAUUCCUCCUUGAACCGCCUCAGCGCUGAUGAUGCCUACGCAACC,12,12,16,22,62
1569,4,AP008971.1/1641037-1640963,AUAGAUUUGGGGAAUGAAGUGCUCCCUUGUUAUUAACUAAAACGCAAAAAUUUUGCUGAUGACUUCUGUUUUUUA,22,29,14,10,75
1570,4,AL954747.1/1756266-1756341,UGAAGAUAAGGAGAUGGUGUUCCUCCUUUUGAAGAAACCGCAGCCGUUUAGCGCUGCUGAUGACGCCUACAGGACC,19,18,21,18,76
1571,4,CP001147.1/1737215-1737284,UUUAAAAAAGGCGAUGGAGUUCGCCUGUAAGUGCCUCUGAUUUUCAGGGGCUGAUAACUCCUACCUUAAA,19,21,16,14,70
1572,4,ABVK02000003.1/30981-31043,UGCCCUUAGGGCGAUGGAGUCCGCCUUAACCGCCCGCUUCGGGCUGAUGACUCCUACCGGGUU,8,15,19,21,63
1573,4,AE017225.1/4825068-4825127,AUAAUCAUAGGCGAUGGAGUUCGCCAUAAACGCUGCUUAGCUAAUGACUCCUACCAGUAU,18,16,12,14,60
1574,4,AAZW01000073.1/10424-10341,UAGCCAUCAGGUGAUGGGGUUCCACCUAAGCUUUUGCUUCAACCGCCCGUUCUUUUGAACCGUGCUAAUGGCUCCUACAGAAUC,17,25,18,24,84
1575,4,AE017334.2/4823859-4823918,AUAAUCAUAGGCGAUGGAGUUCGCCAUAAACGCUGCUUAGCUAAUGACUCCUACCAGUAU,18,16,12,14,60
1576,4,ABBF01000636.1/6946-6880,GCGGCGACCGGAGAUGGCAUGCCUCCGUACAACCGCCGGCGAGCCGGCUGAUGAUGCCUACGCGUUC,11,10,23,23,67
1577,4,CP002952.1/944770-944695,AGGGGGACGGGCGAUGGCGUCCGCCCGGGGCUUCGAGCCCGAACCGCCCGCUCGGGCUGAUGACGCCUGUUCUACC,9,11,29,27,76
1578,4,CP001793.1/4378898-4378958,AUUGAAUGAGGCGAUGGAGUUCGCCAUAACCGCUUCCAUAGCUAAUGACUCCUACCAGAGG,17,14,15,15,61
1579,4,FP929050.1/1488806-1488733,GUAUGAAACGGGAAUGAGGUUCUCCCACGAUUAAUUCGAAACCGCUAAAUUUAGCUGAUGACUUCUGUGUAGAC,22,21,17,14,74
1580,4,AE008692.2/542148-542071,UAUAGACAAGGUAAUGGAAUCUACCUGAUCCUUUCUAUGGAUCGAACCGCCCUUUAGGCUGAUGACUCCUGCUCAAAC,21,22,15,20,78
1581,4,CP002372.1/388527-388452,GUUUAGUCGGGCGAUGGCGUCCGCCCGGGCUUCGAGCCCGAACCGCCCGUUAAGGGCUGAUGACGCCUGUUCUACC,10,16,25,25,76
1582,4,ABXV02000011.1/470942-470875,AUUUAUUUGGGAGAUGGCAUUCCUCCUACCCAAACCGUCCAUAUUGGACUGAUGAUGCCUACGUAAAC,18,20,13,17,68
1583,4,AALF02000002.1/247760-247698,GCAAGAUCUGGAGAUGACAUUCCUCCAUAACCGCCCUUCAAGGCUGAUGAUGUCUACGUAACC,17,15,13,18,63
1584,4,CP002222.1/1678154-1678089,AAGUUAAUCGGCGAUGACGUUCGCCACAUAAUAAUUGAUAAUCAAUUUGAUGACGUCUACUGUUUG,20,22,13,11,66
1585,4,CP001656.1/4006535-4006595,AGUGAAUAAGGCGAUGGAGUUCGCCAUUAACCGCCUGCGGGCUAAUGACUCCUACCAAUGU,16,14,16,15,61
1586,4,CP001638.1/886398-886457,AGAGUAAUAGGCGAUGGAGUUCGCUAAACUAUCGUUCGGGCUGAUGACUCCUACCAGUAA,17,15,16,12,60
1587,5,BAAV01000055.1/2897-2982,UGAGUUUUCUGCGACUGACGGAUUAUUGCAGAGCACUGCAAGGGAACAGAAAAACUCUUUUUCAGCCGACCGUCUGGGCACACCUG,22,21,22,21,86
1588,5,BAAU01012305.1/993-909,UGAGUUUUCUGCGACUGACGGAUUAUUGCAGAGCACUGCAAGGGAACAGAAAAACUCUUUUCAGCCGACCGUCUGGGCACACCUG,22,20,22,21,85
1589,5,BABG01015168.1/550-636,AGCUGACCCUUCUGCUGACGGAUCUUGUGGAGCACCACAGUGCAGAAGGGGAGAGAAGCUUUAAUGCCGACCGUCUGGGCAGCCUUG,19,18,28,22,87
1590,5,BAAU01017791.1/392-305,AACGGGUUUGCCUGCUGACGGAACGUUGUGGAGCACCACAGUGCAGACAAAACCGGGUUUUGUUACGCCGACCGUCUGGGCAGCCUUG,18,19,28,23,88
1591,5,BAAY01004625.1/493-580,AACGGGUUUGCCUGCUGACGGAACGUUGUGGAGCACCACAGUGCAGACAAAACCGGGUUUUGUUACGCCGACCGUCUGGGCAGCCUUG,18,19,28,23,88
1592,5,BAAU01002505.1/255-341,AGACCGUAUCUCUGCUGACGGAACCUUGUGGAGCACCACAGUGCAGGGAUGGCGGGAGAGUCAAUGCCGACCGUCUGGGCAGCCUUG,18,16,30,23,87
1593,5,BAAX01023463.1/777-691,AGACCGCAUCCCUGCUGACGAAACCUUGUGGAGCACCACAGUGCAGGGGUGCUGGGGAUGUCAAUGCCGACCGUCUGGGCAGCCUUG,17,16,29,25,87
1594,5,BAAU01027299.1/88-174,AGACCGCAUCCCUGCUGACGGAACCUUGUGGAGCACCACAGUGCAGGGGUGCUGGGGAUGUCAAUGCCGACCGUCUGGGCAGCCUUG,16,16,30,25,87
1595,5,BABF01003966.1/1020-1104,UCAGCGUGUCGUGACUGGCGAACAGGUGGGCCACCACCGGGGAGCGACGCGUCGGCAUCGAUAGCCGCCCGCCUGGGCUAGAGGC,14,11,33,27,85
1596,5,BAAY01025330.1/152-59,CGCAAGGCCGCUGACCGACGGGAUAUUGUGGGGCUUACCACAGGGGACGCGGCGUUAUCACUUGCCUUUUAAGCCGACCGUCUGGGCUGCAUAC,17,20,30,27,94
1597,5,BABA01016569.1/75-168,CGCAAGGCCGCUGACCGACGGGAUAUUGUGGGGCUUACCACAGGGGACGCGGCGUUAUCACUUGCCUUUUAAGCCGACCGUCUGGGCUGCAUAC,17,20,30,27,94
1598,5,BAAX01001391.1/197-281,GAAAGCACAGGCAACUGACGGAACGUGGAGCACACCACAUGGGAGCCUGCUGUAAUACGAACUGUCGACCGUCUGGGCAAACCUG,25,12,25,23,85
1599,5,BAAX01000081.1/4230-4146,AGAUCCGUACAGGACUGACGGAAUCAAGUGGAGUCACCACGUGAACUGUACGGACCCUUUCAUGCCGACCGUCUGGGCAAGAGUA,23,16,24,22,85
1600,5,ABEF01039966.1/1068-1153,UGACCCCGAUACGACUGGCGGAGAGAGUGGGUAACCACGAGGGAGUAUCGGGGCCAGCGAGAUCGCCGACCGCCUGGGCACUGACA,20,10,32,24,86
1601,5,BAAV01020765.1/806-725,AAAAAGAUCCGUGACUGACGGUUUUUGUGGGGCACCACCAGGGAGCGGAUUCUUAAAAAGGCCGACCGUCUGGGCAGCAUCU,21,17,25,19,82
1602,5,BAAY01013765.1/896-1010,CAGAUUCCCUGCAACUGACGGACACAGGUGGAGCGCAAACCACCGGGGAGCAGGGAGUUCCGUAAUCAGAUGCACCGUGAAGUGUAUCUCAAUGCCGACCGUCUGGGCAGUGUCG,28,20,36,31,115
1603,5,ABEF01017404.1/1032-947,GAUUCCUGGUGUAACUGGCGGAUUUGUGGAAACGAACCACAGGGGAGCACCGGGAAAUGAAAUAGUCGACCGCCUGGGCUGAGCAA,24,15,29,18,86
1604,5,BABE01005334.1/246-164,AAGGUCUUCGGUGACUGACGGAAUUGUGGGACUAACCACAAGGGAGCCGGAGAUUUGAUGAGUCGACCGUCUGGGCAGUAUUU,20,20,28,15,83
1605,5,BAAY01012400.1/201-108,UUUAAGCCAUGCGACUGACGGAAGUGGUGGAACCACGUGGAGCAUGGCCGGGUGCCUGCGGGCGUCCCUCUUGCCGACCGUCUGGGCGCACUCA,15,18,33,28,94
1606,5,BABF01008002.1/701-620,AACAACAUACAAUGCUGACGGAUUAGUGGAAUUAACCACGUGUAUUGUAUGCGAAGAAACGCCGACCGUCUGGGCAGAAGAU,28,17,21,16,82
1607,5,BABA01021702.1/659-750,AAACGACCAUACGACUGACGGAAGUGGAGCAACCACAUGGAGUGUGGCCGGACGUAAACCGCGUCCUCUUGCCGACCGUCUGGGCACACUGA,24,14,27,27,92
1608,5,BAAY01000038.1/8293-8388,UAGGCGCCGUGUAACUGACGGAAAGCCCAUUUGGGCAGGCAGGCUAAACUGCCGGGGAACGCGGCGUAUAAAAAGCCGACCGUCUGGGCAGCCUCU,23,15,32,26,96
1609,5,BAAV01000327.1/435-340,UAGGCGCCGUGCAACUGACGGAAAGCCCAUUUGGGCAGGCAGGCUAAACUGCCGGGGAACGCGGCGUAUAAAAAGCCGACCGUCUGGGCAGCCUCU,23,14,32,27,96
1610,5,BABG01000244.1/657-739,AUGAGGUCAUAUGACUGACGGAGCACGUGGAAUCAACCACAUGGGAGUAUGAUCAUUAAUCGCCGGCCGUCUGGGCAAUCUUG,22,19,24,18,83
1611,5,BABD01005042.1/856-936,AGGCAGUUAUACGACUGACGGAAGUGGAAAUGACCACAGGGAGUAUAGCGUGAGAAGAGGCCGACCGUCUGGGCAGAAGAA,27,11,29,14,81
1612,5,BAAV01011945.1/1060-974,CAUUAGUUAUAUGACUGACGGAAGUGGAAUUGACCACAGGGAGUAUAAUAAAUCAAAAUGAAGAAGCCGACCGUCUGGGCAAAGAAG,34,17,23,13,87
1613,5,BAAX01007901.1/363-439,AGACAGUUAUAUGACUGACGGAAGUGGAUAACCACAUGGAGUAUAACAGUUGAUUGCCGACCGUCUGGGCGCACAUU,23,18,21,15,77
1614,5,BABG01000490.1/211-374,UAUAAGCUGUACAACUGGCGGAAAGCAUAUAUAGAAUAUCAGAUAGAGCAUUCAGCAUGGUGUUGAAGUAUGUAUCAUUGCAUUGAAGUAAGUAUAUGUGGUGGGAUUACCCACAGGGAGUACAGUAAUAAUAUGUUUAUCAGCCGACCGCCUGGGCAACCCUG,52,44,41,27,164
1615,5,BAAX01006362.1/459-383,UAGACGCUGUGCAACUGACGGAAGUGGAUGACCACAGGGAGCACAGGGAAGAAGAGCCGACCGUCUGGGCACAGCCU,22,9,27,19,77
1616,5,BABG01005810.1/129-214,AAGACACCGCGGAACUGACGGAAUGAUGUGGAAUCGACCACGUGAACCGCGGAUGAUCUGAUUGGCCGACCGUCUGGGCAGGGAAA,24,13,29,20,86
1617,5,BAAY01015723.1/323-408,AAGGAUAGGAAGAACUGACGGAUUCUGUGGAAUUGACCACGUGAACUUCCUAUUUCGAAAACAAGCCGACCGUCUGGGCAGGGAAA,28,17,24,17,86
1618,5,BABA01029967.1/180-94,ACACCUCUUCGCCACUGGCAGAUAAGUGGACAAAACCACAGGGCGGCGCAGGGGAUUGGGUUUACGCCGGCUGCCUGGGCAACAUGG,20,14,29,24,87
1619,5,BAAW01014873.1/349-270,UAGGCACCAUGUGACUGGCGCUGAAGACAGAAUACUGUCGGGGAGCAUGGUCGACGUCGCCGCGCGCCUGGGCAUUACCG,16,14,28,22,80
1620,5,BAAW01002219.1/737-658,UCGUCACCAUGUGACUGGCGUUUUAGACAGGUCACUGUCGGGGAGCAUGGUUGCCGCCGCCGCGCGCCUGGGCAUCACUU,11,19,26,24,80
1621,5,AAQK01001363.1/401-486,CAUUAGUUAUAUGACUGACGGAAGUGGAAUUGACCACAGGGAGUAUAAUAAAUCAAAUGAAGAAGCCGACCGUCUGGGCAAAGAAG,33,17,23,13,86
1622,5,AACY022905908.1/566-649,UGACGCCAUCGCAACUGGCGUGUAGAUGGGUCACCAUCGGGGAGCGACACAGAAGCAGAUUGGCCGUACGCCUGGGCCACCUGC,18,13,28,25,84
1623,5,BA000030.3/4242005-4241916,CCGACGGGCCGUGACUGGCGCGCUGGGAUGGGACCGACCAUCGGGGAGCGGCCUGAAUGCGAAUGUGUGCCGUGCGCCUGGGCCGAACGU,13,13,38,26,90
1624,5,CP000673.1/3903782-3903862,AAUGUGUUGUAUGACUGACGGAAGUGGAUUCAACCACAGGGAGUACAGCGUUUUGGAAAGCCGACCGUCUGGGCAUGAUGC,21,19,26,15,81
1625,5,AE001437.1/2562148-2562228,AGAAAAUCAUGCAACUGGCGGAAAUGGAGUUCACCAUAGGGAGCAUGAUUAAUAUAAGAAUCGACCGCCUGGGUAAAUUAA,31,17,20,13,81
1626,5,CP000270.1/613445-613553,UCAUCCCUGCGUGACUGGCGAUAGAACCGGUUCAAACAACCGGAUUCAAGGUGGAGCAACCCACCGUGAAGCGCAGGGUGCCGUUUUGCCGUUCGCCUGGGCAGCCGUG,22,21,34,32,109
1627,5,CP000721.1/4111764-4111685,UAGAGGUUAUACGACUGACGGAAGUGGAAUAAACCACAUGAAGUAUAACAAGUAAUAAGCCGACCGUCUGGGCAAAAGUC,31,15,20,14,80
1628,5,AAQL01005444.1/915-834,CAGAAGCUGCAUGACUGGCGGAAAGUAGGAUUACCUACAGGGAGUGCAGUGAAGUGAGAAGCCGACCGCCUGGGCAGCCUGA,23,12,29,18,82
1629,5,AAMN01000004.1/194357-194435,CUCACGGGUGACGACUGGCGCAGGUGGACCACCACCGGGGAGUCACAUGGGACACGCAUCGCCCGCCUGGGUGCACCCG,14,9,28,28,79
1630,5,AM711867.1/2838330-2838247,CGGACCCGUCGCGACUGGCGUUCGGAUGGGUCACCAUCGGGGAGCGACUCACACGGUUGGUGGCCGUACGCCUGGGCCACGACG,12,13,32,27,84
1631,5,ABBI01001009.1/7408-7308,UAGUCCCUGCGUGACUGGCGAUACGACCUUUCUGGGUCAAGGUGGAGCAUCCCACCGUGAAGCGCAGGGCGUCGUUUUUGCCGUUCGCCUGGGCAGCCGUU,14,25,33,29,101
1632,5,CP000927.1/5164264-5164343,GCCCGUUCGCGUGACUGGCGCUAGUGAUGGGGAACCAUCGGGGAGCGCGAACCACAUCGCCGCGCGCCUGGGCUCCUCGA,12,12,29,27,80
1633,5,AAWL01000017.1/16393-16312,GACAGGAUACAGGACUGGCGGAUUAGUGGAAGCAACCACGUGGACUGUAUCCGAAGAAAAGCCGACCGCCUGGGCAAAAAUU,27,12,25,18,82
1634,5,AATO01015318.1/246-81,AGCGGGGCACGCAACUGGCGAUAGGCGCGCAAGUCCCACCGGGCUGCGCUGCUGACGUGGAGACCCGCAAAAACAAGCCGUUUUUUGCAAACCACUGGGGAGCGUGCCGCGCGGAACAAGGCAGCGUUUGCCCCGCCGCGAUCCGUCGUUCGCCUGGGCAGCCCUU,31,25,55,55,166
1635,5,CP000614.1/815126-815226,UCACCCCUGCGUGACUGGCGAUAGAACCCUUCGGGUUCAAGGUGGAGCAUCCCACCGUGAAGCGCGGGGCGCCGUUUUUGCCGUUCGCCUGGGCAGCCGUU,14,22,33,32,101
1636,5,CP000667.1/2367924-2367834,CCCUCGGGCCGUGACUGGCGCGAUCUGGGAUGGAGCACCAUCGGGGAACGGCCCAUCACGAGGACGCACGCCGAGCGCCUGGGCCUCCACA,16,10,32,33,91
1637,5,CP001096.1/33229-33147,CACGCCUCGCGCGACUGGCGACGUUAGGAUGGAGCACCAUCGGGAAGCGCGGGACGUAUCUGCCGCGCGCCUGGGCAUAGCUU,14,13,30,26,83
1638,5,CP001348.1/2599825-2599904,AAACUGUCAUACAACUGGCGGAAGUGGAGAUUACCACAUGGGAGUAUGACUUUAAUAAGCCGGCCGCCUGGGCAUCAUAA,25,17,21,17,80
1639,5,AACY024109839.1/883-800,UGAUGCCAUCGCAACUGGCGUGAAGAUGGGUCACCAUCGGGGAGCGACACAGAAGCAGAUUGGCCGAACGCCUGGGCCACCUGC,20,12,28,24,84
1640,5,CP000721.1/1211931-1212029,UAUUAGUCAUAUGACUGACGGAAGUGGAGUUACCACAUGAAGUAUGACUAGGCAUAUUAUCUUAUAUGCCACAAAAAGCCGACCGUCUGGGCAAAAAAA,36,24,21,18,99
1641,5,CP000726.1/3402727-3402637,AAUAAAUCAUAUGACUGGCGGAAGUGGAAUUAACCACAGGGAGUAUGAUUUAGAAAUUUAAGUUAGAAUGUCGACCGCCUGGGCAAUAAAA,35,22,22,12,91
1642,5,AP009385.1/718103-718202,UCACCCCUGCGUGACUGGCGAUAGAACCCUCGGGUUCAAGGUGGAGCAUCCCACCGUGAAGCGCAGGGCGCCGUUUUUGCCGUUCGCCUGGGCAGCCGUU,15,21,32,32,100
1643,5,CU234118.1/352539-352459,CGGCUCUCGCGCGACUGGCGACUUUGGAUGGAGCACCAUCGGGGAGCGCGGGAUCGACCGCCGUGCGCCUGGGCAACUGAA,13,12,31,25,81
1644,5,CP000850.1/78653-78732,CUCGGGCAGCGCGACUGGCGAGGGUGGUGAACCACCGGGGAGCGCUGAUGGCUGGAGCAUCGCCCGCCUGGGUGCUUCUC,10,13,33,24,80
1645,5,CP000875.1/3502313-3502228,GCAUGAAUCGGUGACUGGCGAUACACAAACGUGGGCAACCACGGGGGAGCCGAUUUGCGCAGAUGCCGCUCGCCUGGGCAAAGGGC,20,12,31,23,86
1646,5,AACY020353424.1/798-906,UCAUCCCUGCGUGACUGGCGAUAGAACCGGUUCAAACAAUCGGAUUCAAGGUGGAACAACCCACCGUGAAGCGCGGGGUGCCGUUUUGCCGUUCGCCUGGGCAGCUGUG,22,23,34,30,109
1647,5,AACY023075686.1/109-271,ACCGUUCGGCGUGACUGGCGGAGCGCAGGCAAUUACCCUGUGUGGACUGCAUCCUGGAUCUGUCGUGGUUAGUUUCCCCGGCAAUCCAUUGCCGCAUUAGCGCAAAGCGUUCCCUAACCACGGGUAGCGUUGAACUGAACCGCCGACCGCCUGGGCACGCCCG,29,34,48,52,163
1648,5,AACY020521775.1/559-642,UGACGCCAUCGCAACUGGCGUGUAGAUGGGUCACCAUCGGGGAGCGACACAGACGCAGAUUGGCCGAACGCCUGGGCCACCUGC,18,12,28,26,84
1649,5,AACY022405903.1/398-315,UGACGCCAUCGCAACUGGCGUGUAGAUGGGUCACCAUCGGGGAGCGACACAGACGCAGAUUGGCCGAACGCCUGGGCCACCUGC,18,12,28,26,84
1650,5,CP000090.1/861611-861511,UCCACCUUGCGCGACUGGCGAUGUCAGUGGGUACUACCACGAGGAAGCGCAAGUUCUCUGGCGUGAAGUUCAGACGCCUGCCGCUCGCCUGGGCAGCGAAU,19,20,32,30,101
1651,5,CP001408.1/3257848-3257748,UAGUCCCUGCGUGACUGGCGAUACGACCUUUCGGGGUCAAGGUGGAGCAUCCCACCGUGAAGCGCAGGGCGUCGUUUUUGCCGUUCGCCUGGGCAGCCGUU,14,24,34,29,101
1652,5,CP000727.1/3299834-3299744,AAUAAAUCAUAUGACUGGCGGAAGUGGAAUUAACCACAGGGAGUAUGAUUUAGAAAUUUAAGUUAGAAUGUCGACCGCCUGGGCAAUAAAA,35,22,22,12,91
1653,5,AE001437.1/1127408-1127485,UAAGAAUCGUAUAACCGGCGGAAGUGGAAUAACCACAGGGAGUACGAUUUUAAAAAGCCGACCGCCUGGGCAAAAAGA,30,12,21,15,78
1654,5,CP000151.1/810912-811012,UCACCCCCGCGUGACUGGCGAUAGAACCCUUCGGGUUCAAGGUGGAGCAUCCCACCGUGAAGCGCGGGGCGCCGUUUUUGCCGUUCGCCUGGGCAGCCGUU,14,21,33,33,101
1655,5,AACY021675814.1/503-420,UGACGCCAUCGCAACUGGCGUGUAGAUGGGUCACCAUCGGGGAGCGACACAGAAGCAGAUUGGCCGUACGCCUGGGCCACCUGC,18,13,28,25,84
1656,5,CP000728.1/3519944-3519854,AAUAAAUCAUAUGACUGGCGGAAGUGGAGUUAACCACAGGGAAUAUGAUUUAGAAAUUUAAGUUAGAAUGUCGACCGCCUGGGCAAUAAAA,35,22,22,12,91
1657,5,ABBG01000261.1/19106-19005,UAUCCCCUGCGUGACUGGCGAUAAGACCUUUCGGGGUCAAAGGUGGAGCGUCCCACCGUGAAGCGCAGGGCGUCGCUUUUGCCGUUCGCCUGGGCAGCCGUU,15,23,34,30,102
1658,5,CP000086.1/1555456-1555556,UACCCCCUGCGUGACUGGCGAUACGACCUUUCGGGGUCAAGGUGGAGCAUCCCACCGUGAAGCGCGGGGCGUCGCUUUUGCCGUUCGCCUGGGCAGCCGUU,13,22,34,32,101
1659,5,AP006627.1/3516508-3516431,GAAUCUGUAUGUGACUGGCGCGAAGUGGAUAACCACAAGGGAGCAUACGGAUCAAAGCCGUGCGCCUGGGCAAAGGAA,24,12,26,16,78
1660,5,AACY021007951.1/190-107,UGACGCCAUCGCAACUGGCGUGUAGAUGGGUCACCAUCGGGGAGCGACACAGACGCAGAUUGGCCGAACGCCUGGGCCACCUGC,18,12,28,26,84
1661,5,AAQL01002083.1/670-587,AAGCAGUUGUACGACUGGCGGAAAAGCAGGGUUACCUGUGGGGAGUACAACGUUAUCCUGAUGCCGACCGCCUGGGCGACCGCU,19,16,28,21,84
1662,5,AACY020990021.1/376-489,AUGCAAGCGCAUGACUGGCGAUGAAAGGUGGAAGACCACCGGGAAGUGCGCAGGGUUUGAGUGCAUCCAAGGAUGGUGUGAGUCAGCCCAAAGCCGCUCGCCUGGGCACUUUGA,28,20,40,26,114
1663,5,AACX01000007.1/312508-312608,UACCCCCUGCGUGACUGGCGAUACGACCUUUCGGGGUCAAGGUGGAGCAUCCCACCGUGAAGCGCGGGGCGUCGCUUUUGCCGUUCGCCUGGGCAGCCGUU,13,22,34,32,101
1664,5,AAKY01000114.1/32845-32745,UCACCCCUGCGUGACUGGCGAUAGAACCCUUCGGGUUCAAGGUGGAGCAUCCCACCGUGAAGCGCAGGGCGCCGUUUUUGCCGUUCGCCUGGGCAGCCGUU,15,22,32,32,101
1665,5,CP000512.1/3298357-3298515,CGAGGGGUACGCGACUGGCGAUAGGCGCGGUGCAUCCGCGAAGGCGGACGCCGCCGCUGACGUGGAAACCGGCAGGCACUUUCACCUGCGAACCACUGGGAAGCGUGCCGCACGGGCUGCAAGGCCCGUUGUGUUCCGCCGUUCGCCUGGGCAGCCCUU,25,24,58,52,159
1666,5,ABED02000029.1/984986-984900,AGACCGCAUCCCUGCUGACGGAACCUUGUGGAGCACCACAGUGCAGGGGUGCUGGGGAUGUCAAUGCCGACCGUCUGGGCAGCCUUG,16,16,30,25,87
1667,5,BA000040.2/6500011-6499926,GUCCUAUCGCGCGACUGGCGAGCUAACGUGGAAUCGACCACGGUGAAGCGCGAAGGGUUCCGACGCCGAUCGCCUGGGCAACCAAU,19,13,28,26,86
1668,5,ABCC02000037.1/46406-46317,GGUAGGGCGUGUGACUGGCGGAUAGUGGAGCAACCACAGGGAGCACGCAGUACCAUGAACUAUUUUGAGCCGACCGCCUGGGCACGCAUG,21,15,32,22,90
1669,5,AACY023312929.1/255-91,UACAGGGUACGCAACUGGCGAUAGGAGCCUGGCAUUCGCAAACUUCUGCGAGCCAACUCUGACGUGGAAAUGGGUGGGCUUGUUCCCUUCCUCAACCACUGGGGAGCGUGCACCUUGUACUGGUGUUUGGGUUCAAGGUUUCAGCCGUUCGCCUGGGCAGCCCAU,30,41,50,44,165
1670,5,CP000570.1/3132286-3132186,UAGUCCCUGCGUGACUGGCGAUACGACCUUUCGGGGUCAAGGUGGAGCAUCCCACCGUGAAGCGCAGGGCGUCGUUUUUGCCGUUCGCCUGGGCAGCCGUU,14,24,34,29,101
1671,5,CP000774.1/674390-674303,UAUCCUCCGCGCGACUGGCGAAAUCAGAUGGGUCACCAUCGGGGAGCGCGGAGACUGGUCUUUCGAGCCGAUCGCCUGGGCAGCACUU,16,17,29,26,88
1672,5,CP000958.1/862927-863027,UCACCCCUGCGUGACUGGCGAUAGAACCCUCAGGGUUCAAGGUGGAGCAUCCCACCGUGAAGCGCGGGGCGCCGUUUUUGCCGUUCGCCUGGGCAGCCGUU,15,21,33,32,101
1673,5,BA000030.3/688247-688162,GGUGUGGGCCGUGACUGGCGCUGAGGUGGAGCACCACCGGGGAGCGGUCUGACGAGACGUCGUUGCCGUGCGCCUGGGCGAGUGGU,10,15,40,21,86
1674,5,AACY020525716.1/1032-1115,UGACGCCAUCGCAACUGGCGUGAAGAUGGGUCACCAUCGGGGAGCGACACAGACGCAGAUUGGCCGAACGCCUGGGCCACCUGC,19,11,28,26,84
1675,5,CP000269.1/2768093-2767971,UUCGUCUCACGUGACUGGCGAAUCCGACUGGUUUUCCUGCUGUUUAUAGGUAAAUUACGUCGUAAGGUGGGCUUACCCACCGUGAAGCGUGAGAUUUCAUUGCCGUGCGCCUGGGUAGCCCGA,22,36,35,30,123
1676,5,CP001025.1/786181-786281,UCACCCCUGCGUGACUGGCGAUAGAACCCUUCGGGUUCAAGGUGGAGCAUCCCACCGUGAAGCGCGGGGCGCCGUUUUUGCCGUUCGCCUGGGCAGCCGUU,14,22,33,32,101
1677,5,AAQK01000738.1/824-909,CAUUAGUUAUAUGACUGACGGAAGUGGAAUUGACCACAGGGAGUAUAAUAAAUCAAAUGAAGAAGCCGACCGUCUGGGCAAAGAAG,33,17,23,13,86
1678,5,AARF01000447.1/2648-2568,GAGCCCCGGUGUAACUGGCGACAGGUGGAGCGAACCACAUGGAAGCACCGGGGAAUACGGCCGGUCGCCUGGGCAAAGAGC,20,8,31,22,81
1679,5,AACY020548403.1/122563-122663,UCACCCCCGCGUGACUGGCGAUAGAACCCUUCGGGUUCAAGGUGGAGCAUCCCACCGUGAAGCGCGGGGCGCCGUUUUUGCCGUUCGCCUGGGCAGCCGUU,14,21,33,33,101
1680,5,CU207211.1/2356811-2356707,UUCGUCUCACGUAACUGGCGAAUCCGACCGAUCACACCGUGUCGUAAGGUGGGCCUAUCCACCGUGAAGCGUGAGAUUUUAUUGCCGUGCGCCUGGGUAGCCCGA,20,25,30,30,105
1681,5,CP001052.1/844994-845102,UCAUCCCUGCGUGACUGGCGAUAGAACCGGUUCAAACAACCGGAUUCAAGGUGGAGCAACCCACCGUGAAGCGCAGGGUGCCGUUUUGCCGUUCGCCUGGGCAGCCGUG,22,21,34,32,109
1682,5,AACY021101856.1/474-633,AGCGGGGUACGCAACUGGCGAUAGGCGUGGUCCAGGAAGGUUGAAAAACCGGGCCACCGCUGACGUGGAAACCAGCAGAUGCUUGCCGUCUGUGAACCACUGGGGAGCGUACCGCCCAGGCUGAGCCUGAAGCGUUCCGCCGUUCGCCUGGGCAGCCCUU,32,26,55,47,160
1683,5,AP009049.1/1156093-1156015,AAGGAAUCGUAUAACCGGCGGCAGUGGAAUUAACCACAAGGAGUACGAUUUUUAAAAGCCGACCGCCUGGGCAAUCAAA,28,14,20,17,79
1684,5,AACY023502772.1/158-61,AGCGAUCCACACAACUGGCGACAAAAGGCUGAGCCUUAAGAUGGAUGAAACCAUCGGGGAGUGUGAAAAGAACCUAGCCGCUCGCCUGGGCAUAGACA,32,14,28,24,98
1685,5,AAQK01007158.1/471-387,AAGUACUUUUGUAACUGACGGAAUACAAGAUGGGGACAUCGUGGAGCAAAAGUAUGAAAAUGAGCCGACCGUCUGGGCAGUGUUU,27,20,25,13,85
1686,5,CP000612.1/48258-48175,CUACAGUUGCAUGACUGGCGGAUUUUUGUGGAGCACCACAAAGGAUUGUAACUGUUUUUUAAGCCGACCGCCUGGGCAAUACAC,21,23,21,19,84
1687,5,AAQL01000770.1/335-416,GUUAAGUUAUACGACUGACGGAAGUGGAAUAAACCACAGGGAGUAUAAUCGUGUAAAAGAGUCGACCGUCUGGGCUAAGAAU,29,18,23,12,82
1688,5,AAQK01002083.1/535-449,CAGUAGUGCUGUGACUGACGGGUAUACGCGGGCAACCGCGGGGGAGCAGCGCGAACAUACUCAGUGCCGACCGUCUGGGCAAGCCGU,18,13,32,24,87
1689,5,AAXB02000001.1/5878-5961,AGAAGAUCUGAUGACUGACGGAUAAUGUGGAGUACCACAGGGGAAUCAGAUACUUGGUAAGAGCCGACCGUCUGGGCAGCAUUU,25,18,26,15,84
1690,5,ABAX03000024.1/304792-304708,CAUAAGUCAUAUGACUGACGGACAAGUGGAGUUUACCACAGGAAGUAUGACAACGAAUUUUUAGCCGACCGUCUGGGCACCCUGC,25,19,21,20,85
1691,5,AE016822.1/1921306-1921208,GGCCUUCGUCGCGACUGGCGCUCAGAUGGUCACCAUCGGGGAGCGACGACGGUACCUCGAACGAACGGGUGGAUUCGGCCGCGCGCCUGGGUCGAUAGC,16,16,37,30,99
1692,5,CP000539.1/1721986-1721827,AGCAGGGCACGCAACUGGCGAUAGGCGCGGAGGUCUUCCGGGACACCGCCGCUGACGUGGACACCGGCAGGAAACAGCGUUUUUCUGCAAACCACUGGGGAGCGUGCCGCGCGGCAGGCACCAGCCCCGCAGCGAUCCGUCGUUCGCCUGGGCAGCCCUU,29,22,55,54,160
1693,5,ACOM01000001.1/496623-496702,UAUAGGUUAUACAACUGACGGAAGUGGAAUAAACCACAUGAAGUAUAACAAGUAAUAAGCCGACCGUCUGGGCAAAAGUC,32,16,18,14,80
1694,5,CP000267.1/2925225-2925356,CGGGUGGCACGCGACUGGCGAUAGGCUCUCAACCCGGCAAGGGCGUGAGACGCUGAAGUGGGAACACCACGGGGGAGCGUGCCGCAUUGCCAAUGUGGCAACUGUGUUUAGCCGUUCGCCUGGGCAGCCCUG,24,22,49,37,132
1695,5,AACY023798967.1/1144-1061,UGACGCCAUCGCAACUGGCGUGUAGAUGGGUCACCAUCGGGGAGCGACACAGAAGCAGAUUGGCCGUACGCCUGGGCCACCUGC,18,13,28,25,84
1696,5,AACY022292946.1/74-157,UGACGCCAUCGCAACUGGCGUGUAGAUGGGUCACCAUCGGGGAGCGACACAGACGCAGAUUGGCCGAACGCCUGGGCCACCUGC,18,12,28,26,84
1697,5,AAQK01001691.1/259-341,AUAGAAUCUGAUUACUGACGGAGAAAUGUGGGAUACCACAGGGGAAUCAGAUUUGCAGGAUGCCGACCGUCUGGGCAACAUUU,25,19,24,15,83
1698,5,AACY024046541.1/1198-1115,UGACGCCAUCGCAACUGGCGUGUAGAUGGGUCACCAUCGGGGAGCGACACAGAAGCAGAUUGGCCGUACGCCUGGGCCACCUGC,18,13,28,25,84
1699,5,CP001043.1/2749838-2749724,UCACCCCUGCGUGACUGGCGAUAGAACCCAAUGCUGUCAAGCGUGGCGGGUUCAAGGUGGAGCGUCCCACCGUGAAGCGCAGGGUGCCGUUUUGCCGUUCGCCUGGGCAGCCAUG,19,23,39,34,115
1700,5,AACY024110163.1/611-528,UGACGCCAUCGCAACUGGCGUGUAGAUGGGUCACCAUCGGGGAGCGACACAGAAGCAGAUUGGCCGUACGCCUGGGCCACCUGC,18,13,28,25,84
1701,5,AACY020310666.1/1673-1756,UGACGCCAUCGCAACUGGCGUGUAGAUGGGUCACCAUCGGGGAGCGACACAGAAGCAGAUUGGCCGUACGCCUGGGCCACCUGC,18,13,28,25,84
1702,5,AACY020539641.1/41-124,UGACGCCAUCGCAACUGGCGUGUAGAUGGGUCACCAUCGGGGAGCGACACAGAAGCAGAUUGGCCGUACGCCUGGGCCACCUGC,18,13,28,25,84
1703,5,CP001068.1/718457-718329,UCCACCUUGCGCGACUGGCGAAUCCUGAAGCCGCUUCAGCGGCUUCGACAUGUGGGCAGCGACCACGAGGAAGCGCAAGGUUUCUGGCGUCAUGCACAACGGCGCCUGCCGCUCGCCUGGGCAGCGAAU,24,22,41,42,129
1704,5,CP001098.1/2532894-2532806,AAAGGGUCAUACGACUGGCGGUAUUAUAUGGAAUUAACCAUAGGGGAGUAUGACCGAUACUGGAAUAGCCGACCGCCUGGGCAGAUAGA,28,18,27,16,89
1705,5,CP000378.1/359253-359353,UCACCCCUGCGUGACUGGCGAUAGAACCCUCAGGGUUCAAGGUGGAGCAUCCCACCGUGAAGCGCGGGGCGCCGUUUUUGCCGUUCGCCUGGGCAGCCGUU,15,21,33,32,101
1706,5,AL939121.1/191211-191300,ACCCCGGGCCGUGACUGGCGCGCUGGGAUGGGACGAACCAUCGGGAAGCGGCCCCGGAAACACCGAGAGCCGUGCGCCUGGGCCAUCCGU,16,9,34,31,90
1707,5,AACY021099823.1/580-497,UGACGCCAUCGCAACUGGCGUGUAGAUGGGUCACCAUCGGGGAGCGACACAGAAGCAGAUUGGCCGUACGCCUGGGCCACCUGC,18,13,28,25,84
1708,5,CP000750.2/2906133-2906236,GACCGUGGCCGCGACUGGCGCAGGGUGGGUCACCACCGGGGAGCGGCCACGGGCACCCGCAGGGGCGUCCGCCGUUCACGGGGUCGUCCGCCUGGGCCUCGCGU,10,12,44,38,104
1709,5,CP000142.2/3231175-3231262,AAGGUCUCCCGUAACUGGCGUCUCGAGGUGGAUCACCACCGGGGAGCGGGGCCAAAAGACCUUACAGCCGUACGCCUGGGCCCCCUUU,17,15,27,29,88
1710,5,CP000458.1/907214-907314,UCACCCCUGCGUGACUGGCGAUAGAACCCUCAGGGUUCAAGGUGGAGCAUCCCACCGUGAAGCGCGGGGCGCCGUUUUUGCCGUUCGCCUGGGCAGCCGUU,15,21,33,32,101
1711,5,CP000352.1/2912877-2912979,UCCACCUUGCGCGACUGGCGAAGUCAGUGGGUACUACCACGAGGAAGCGCAAGUUCAUUGGGCGUGAUAUUCGAUGCGCCUGCCGCUCGCCUGGGCAGCGAAU,20,21,33,29,103
1712,5,AACY023845234.1/1152-1235,UGACGCCAUCGCAACUGGCGUGUAGAUGGGUCACCAUCGGGGAGCGACACAGACGCAGAUUGGCCGAACGCCUGGGCCACCUGC,18,12,28,26,84
1713,5,AACY021685826.1/176-92,GGUCAAAAGCGCGACUGGCGUUAGGUAAGUGGGAAACCACUGGGAAGCGCUGAAGCAUCAAAAAUCGCACGCCUGGGUUUUUGUC,23,17,27,18,85
1714,5,ABBH01000544.1/39713-39813,UACCCCCUGCGUGACUGGCGAUACGACCUUUCGGGGUCAAGGUGGAGCAUCCCACCGUGAAGCGCGGGGCGUCGCUUUUGCCGUUCGCCUGGGCAGCCGUU,13,22,34,32,101
1715,5,CU914168.1/2467319-2467448,UCCACCUUGCGCAACUGGCGAAUCCUGGGGCUGCCGCCGGCAGUACCCGGCAGUGGGCAUUGACCACGAGGAAGCGCAAGGUCUCUGGCGUCAUGCACAACGACGCCUGCCGCUCGCCUGGGCAGCGAAU,24,20,42,44,130
1716,5,AACY021818080.1/421-338,UGAUGCCAUCGCAACUGGCGUGUAGAUGGGUCACCAUCGGGGAGCGACACAGACGCAGAUUGGCCGAACGCCUGGGCCACCUGC,18,13,28,25,84
1717,5,CP001581.1/3668607-3668517,AAUAAAUCAUAUGACUGGCGGAAGUGGAAUUAACCACAGGGAGUAUGAUUUAGAAAUUUAAGUUAGAAUGUCGACCGCCUGGGCAAUAAAA,35,22,22,12,91
1718,5,ABGC03000034.1/58026-58108,AUAAGGUCAUAUAACUGACGGAGCACGUGGAAUUAACCACAUGGAAGUAUGAUCAUUAAUCGCCGACCGUCUGGGCAAUCUGU,26,20,20,17,83
1719,5,AACY023809027.1/335-252,UGACGCCAUCGCAACUGGCGUGAAGAUGGGUCACCAUCGGGGAGCGACACAGACGCAGAUUGGCCGAACGCCUGGGCCACCUGC,19,11,28,26,84
1720,5,CP000850.1/2571296-2571207,UCCUCGGGCCGGGACUGGCGCGGUUGGGAUGGAGCACCAUCGGGGAACGGCCCGUGACGAGGACGCACGCCGGGCGCCUGGGCCUCCACA,13,10,37,30,90
1721,5,CP000868.1/2806670-2806571,UCACCCCUGCGUGACUGGCGAUAGAACCCUCGGGUUCAAGGUGGAGCAUCCCACCGUGAAGCGCAGGGCGCCGUUUUUGCCGUUCGCCUGGGCAGCCGUU,15,21,32,32,100
1722,5,ABAW02000024.1/334916-334999,UAGAUGUUAUAUGACUGACGGAUAAAGUGGAAAUGACCACAGGAAGUAUAAUGUUGAUAAAAGCCGACCGUCUGGGCAGAAAAG,32,18,23,11,84
1723,5,AACY020038179.1/1074-1209,AGUUUUGCACGCGACUGGCGAUAGGCUGGCGGCUUUAGAAACAAAUUCAAAGCUUGCCCGGCUGACGUGGAAUACCACUGGGAAGCGUGCCGCACUGUUUAACUGGUGCGUUCAGCCGUUCGCCUGGGCAGCCCUG,27,31,42,36,136
1724,5,AACY023807203.1/1083-1000,UGACGCCAUCGCAACUGGCGUGUAGAUGGGUCACCAUCGGGGAGCGACACAGACGCAGAUUGGCCGAACGCCUGGGCCACCUGC,18,12,28,26,84
1725,5,CP001340.1/32806-32887,CCGCGUUCGCGCGACUGGCGUUCGGAGGGAAAUGACCCUCGGGAAGCGUGGACUUUCAGAGCCGUUCGCCUGGGCGCCUAAC,13,15,29,25,82
1726,5,CP000927.1/52674-52595,CGCCGUCCGCGUGACUGGCGAUCACAGGGAGCACCCUGAGGGAGCGCGGACGUCAUGAGCCGUUCGCCUGGGCGCCCCAC,12,10,29,29,80
1727,5,AAFX01055788.1/246-86,ACCGCGGUACGCAACUGGCGAUAGGCGCGGCCCACCGAGCGGCCGGCGCCGACGUGGACAUCAGCACAGGGGCUGCCUGAAGCGGGCAGCCGAUUGUUCCACCACGGGGAAGCGUGCCGCCGGGGUCUUCCGGUGUUCAGCCGUUCGCCUGGGCAGCCCUU,24,23,59,55,161
1728,5,AACY020107892.1/280-377,AGCGUCGCACACAACUGGCGACAAGAGGCUUAGCCUUAAGAUGGAUGAAACCAUCGGGGAGUGUGAAAAGAAUAUAGCCGCUCGCCUGGGCAUAUACA,31,17,28,22,98
1729,5,CP000249.1/708324-708410,GCCCGGAGUCGUGACUGGCGCAUCGAGGUGGAACUGACCACCGGGGAGCGAUCGAGCGGAACGGUGCCGCGCGCCUGGGCACCCCCG,14,9,35,29,87
1730,5,AAVO02000004.1/47771-47851,CAACGACUGCAUGACUGGCGGAAGUAGGAUGAACUACAGGGAGUGCAGUAAGUGAACGUGCCGACCGCCUGGGCAGCCUGG,21,12,29,19,81
1731,5,AACY020992384.1/614-461,AACGGGGUACGCGACUGGCGAUAGGCGCUGCAUUUAGCCAAUGGAUGCAGCCGCUGACGUGGAAACCAGCAAGAACCUACUUCUUGUGAACCACUGGGAAGCGUGCCGCAGGGGCCCUGCCCCGUGCGUUCAGCCGUUCGCCUGGGCAGCCCUU,30,28,49,47,154
1732,5,CP000774.1/1504618-1504701,GCUGCCUUGCGUGACUGGCGAGAAGGGGUGGAGCCAACCACCGUGGAGCGCGAGGCAAUCGCGCCGCUCGCCUGGGCACCCUUU,13,13,31,27,84
1733,5,CP000316.1/3034848-3034979,AGGGAGGUGCGCGACUGGCGAUAGGUAUCAUGGUCUUGCCGGCCAUUGAUGCUGACGUGGGGACACCACUGGGAAGCGCACCGCUCAAAGCCGUUUGGCCACAGCGUUCAGCCGUUCGCCUGGGCAGCCCUU,23,26,45,38,132
1734,5,AACY023813097.1/490-407,UGAUGCCAUCGCAACUGGCGUGAAGAUGGGUCACCAUCGGGGAGCGACACAGACGCAGAUUGGCCGAACGCCUGGGCCACCUGC,19,12,28,25,84
1735,5,BA000040.2/625249-625331,GCUCGCUCGCGCGACUGGCGACCUUGGAUGGAGCACCAUCGGGAAGCGCGGGACUUAAGACGCCGCGCGCCUGGGCAUAGACA,16,11,30,26,83
1736,5,CP000463.1/30517-30436,CCUCGCUCGCGCGACUGGCGACCUUGGAUGGAGCACCAUCGGGAAGCGCGGGCCAUAUCUGCCGCGCGCCUGGGCAUCGUAU,12,14,28,28,82
1737,5,AAOX01000008.1/65010-65093,UAAAGGCGCAGUGACUGACGACGAUAGUGGAAGAAACCACAGUGGAGCUGCGUGCAUAUAUAGCCGGUCGUCUGGGCAGCCAGC,23,14,28,19,84
1738,5,AAXG02000001.1/53805-53882,AGUGCGCUAUAUGACUGACGGAAGUGGGUUGACCACAUGGAGUAUAGCGGACAUGAGCCGACCGUCUGGGCACGCUGC,18,15,27,18,78
1739,5,CP000494.1/329370-329290,CGGCUCUCGCGCGACUGGCGACUUUGGAUGGAGCACCAUCGGGGAGCGCGGGGUGGAUCGCCGUGCGCCUGGGCAAAUUGA,12,14,33,22,81
1740,5,AAQL01010485.1/981-899,AUGAGGUCAUAUGACUGACGGAGCACGUGGAAUCAACCACAUGGGAGUAUGAUCAUUAAUCGCCGGCCGUCUGGGCAAUCUUG,22,19,24,18,83
1741,5,CP000820.1/2987702-2987614,GCGAAGGGUCGUGACUGGCGCGCUCGGGUGGAAGCAACCACCGGGAAGCGACGAAGCUGCUGGCGGCGCCGUGCGCCUGGGUGCCUCCG,13,11,38,27,89
1742,5,AE005673.1/88947-89027,CCGCGUUCGCGUGACUGGCGCUAGUGAUGGGGAACCAUCGGGGAGCGUGGACAUCAUAAGCCGCGCGCCUGGGCUCCCUUU,12,16,29,24,81
1743,5,AAFZ01025325.1/141-230,UUACCCUGCCGUGACUGGCGAGUUUUUGCGUGGAACUAACCACGGGGAAGCGGCAGGGGGCUGCACCUGCCGAUCGCCUGGGCGCUUUUC,13,20,31,26,90
1744,5,CP000885.1/835881-835983,AUUACAAUGUACGACUGGCGGAAACUGUAGGAGACUACAGGUGGGGAUAACCCACAGGGAGUACAUUUAAUAACAAUAAGAGCCGACCGCCUGGGCCACCACC,34,17,27,25,103
1745,5,AACY020523850.1/190-107,UGAUGCCAUCGCAACUGGCGUGAAGAUGGGUCACCAUCGGGGAGCGACACAGACGCAGAUUGGCCGAACGCCUGGGCCACCUGC,19,12,28,25,84
1746,5,CP000440.1/762627-762727,UCACCCCUGCGUGACUGGCGAUAGAACCCUUCGGGUUCAAGGUGGAGCAUCCCACCGUGAAGCGCGGGGCGCCGUUUUUGCCGUUCGCCUGGGCAGCCGUU,14,22,33,32,101
1747,5,CP000529.1/3062025-3062156,AGCGCGGUGCGCGACUGGCGAUAGGCCUCAUGGUUUCACAACUCUGAAGGCCGACGUGGGACACCACGGGGAAGCGCACCGUUUGAGGUCAUCUGGCCAAAAAGCGUUCAGCCGUUCGCCUGGGCAGCCCUU,26,24,43,39,132
1748,5,AACY020296783.1/43-126,UGAUGCCAUCGCAACUGGCGUGAAGAUGGGUCACCAUCGGGGAGCGACACAGACGCAGAUUGGCCGAACGCCUGGGCCACCUGC,19,12,28,25,84
1749,5,AL646052.1/778049-777920,UCCACCUUGCGCAACUGGCGAAUCCUGGGGCUGCCGCCGGCAGUACCCGGCAGUGGGCGUUGACCACGAGGAAGCGCAAGGUCUCUGGCGUCAUGCACAACGACGCCUGCCGCUCGCCUGGGCAGCGAAU,23,20,43,44,130
1750,5,AACY024109386.1/572-489,UGACGCCAUCGCAACUGGCGUGUAGAUGGGUCACCAUCGGGGAGCGACACAGACGCAGAUUGGCCGAACGCCUGGGCCACCUGC,18,12,28,26,84
1751,5,AAVL02000036.1/176021-175941,UAUAUUCCAUAUGACUGGCGGAUUAGUGGGAUUACCCACAGGGAGUAUGGAUGCACGUAGUCGACCGCCUGGGCAACCCUC,19,19,23,20,81
1752,5,CP000359.1/539910-539993,GAGCGGGUGGUGACUGGCGCUGAACGUGGGCCAACCACGGGGAAGCCAUCCGCAUUGCUGUGAUCGCGCGCCUGGGUCGGACGC,13,13,34,24,84
1753,5,AAUJ02000001.1/1536455-1536301,GCGGGUGUACGCAACUGGCGAUAGGCGCAGAGUUUUCUGCCGCUGACGUGGAAACCGGCAGACUGCAAGGUCUGUGAACCACCGGGGAGCGUACCGCCCAGAGCCGCAGCGACUGCAGCCUGCAAGCGUUUCAGCCGUUCGCCUGGGCAGCCCUU,29,26,52,48,155
1754,5,AARF01000325.1/402-322,GAGCCCCGGUGUAACUGGCGACAGGUGGAGCGAACCACAUGGAAGCACCGGGGAAUACGGCCGGUCGCCUGGGCAAAGAGC,20,8,31,22,81
1755,5,ABCF01000005.1/78206-78117,GACAAAAGCAGUAACUGGCGAAAACUGUGGAACCAACCACAAGGGAGCUGCUUUUCUUACGCUUAAUAGCCGUUCGCCUGGGCUGAGGCU,25,19,24,22,90
1756,5,AACY021145871.1/594-676,CUGAUGCUACGCAACUGGCGUAAUGAUGGAUAACCAUCGGGGAGCGUAAGGAAGCGUGCUGGCCGUACGCCUGGGCUGACACG,19,15,29,20,83
1757,5,CT573213.2/1191460-1191545,GCUGGGAGUCGCGACUGGCGCACAGAGGUGGAACUGACCACCGGGGAGCGAUGAGCGGGUCGGUGCCGUGCGCCUGGGUGCCUCCG,12,12,38,24,86
1758,5,CP000572.1/3148595-3148495,UAGUCCCUGCGUGACUGGCGAUACGACCUUUCGGGGUCAAGGUGGAGCAUCCCACCGUGAAGCGCAGGGCGUCGUUUUUGCCGUUCGCCUGGGCAGCCGUU,14,24,34,29,101
1759,5,ABBM01000487.1/14069-13969,UACCCCCUGCGUGACUGGCGAUACGGCCUUUCGGGGUCAAGGUGGAGCAUCCCACCGUGAAGCGUAGGGCGUCGCUUUUGCCGUUCGCCUGGGCAGCCGUU,13,23,34,31,101
1760,5,AACY020539987.1/444-527,UGACGCCAUCGCAACUGGCGUGUAGAUGGGUCACCAUCGGGGAGCGACACAGACGCAGAUUGGCCGAACGCCUGGGCCACCUGC,18,12,28,26,84
1761,5,AACY021513409.1/321-238,UGACGCCAUCGCAACUGGCGUGUAGAUGGGUCACCAUCGGGGAGCGACACAGACGCAGAUUGGCCGAACGCCUGGGCCACCUGC,18,12,28,26,84
1762,5,AAYI02000004.1/189562-189478,UAAGCGUGUCGUGACUGGCGAACAGGUGGGCCACCACCGGGGAGCGACGCGUCGGCAUCGAUAGCCGCCCGCCUGGGCUAGAGGC,15,11,33,26,85
1763,5,AAYI02000004.1/2328470-2328386,GGGAGACGCCGCGACUGGCGAGGGUGGAUGACCACCGGGGAGCGGCCGCAUUUCCCGCGAGGCGUCGCCCGCCUGGGCGCCUGGG,10,9,38,28,85
1764,5,ABAX03000018.1/2486-2565,UGAAAGCUGUGCGACUGGCGGAUAGUGGAGAAACCACGGGGAGCACGGCAGCAGAAAUGCCGGCCGCCUGGGCAACUUUU,20,12,29,19,80
1765,5,AAVO02000015.1/35242-35324,AAAGUCUCUGGUAACUGGCGGAGUAGUGGAAAUCACCACAUGGGAAUCAGAGAUUUGCAGAGCCGACCGUCUGGGCAGUAUUU,23,19,25,16,83
1766,5,AE000513.1/880781-880696,CUGCGGAAGGUGACUGGCGCGAAAACGUGGGAAGACCACGGGGAAGCCUUCUGGCAUAGCAAAGACCGUGCGCCUGGGUCGGACGC,20,11,33,22,86
1767,5,CP000667.1/2571803-2571720,UGGAAACGAUGCGACUGGCGGCACCGAGGAUGGAACGACCAUCGGGGAGCUCGUCGCGGAGGGUCGACCGCCUGGGCCUUUCCG,15,12,33,24,84
1768,5,CP001644.1/756294-756165,UCCACCUUGCGCGACUGGCGAAUCCUGAAGCUGCUUUGAGCGGCUUCGACAUGUGGGCAGCGACCACGAGGAAGCGCAAGGUUUCUGGCGUCAUGCACAACGGCGCCUGCCGCUCGCCUGGGCAGCGAAU,24,24,42,40,130
1769,6,CP000141.1/711593-711712,AAAAAUAAGCUGCUCCGAGUAUUUUCACCUAAAGCUUUAGGCCAUGGUGAAAAUACCAAAGGGUACUACCGGGAAACCGGGGUGCCUCCCGUUUUGGAAAGGAGUUAUCAAAGCGCCUUU,36,29,29,26,120
1770,6,CP000448.1/1172054-1171931,AAAAGAAUAGAGCUCCGAGCCUUAUUAAUCUAAAGACUGCGGUUCAUGAUUAUAGGGCCUAUAGGUAUAAGUGGAAACGCUUAUGCCUCCCCGUAUUGUGGAAAGGAGUACUUAUUUAGCUGUU,37,37,29,21,124
1771,6,AP009389.1/593165-593047,AAAAAUCAUACUCUCCGAGCCAGGUAACCUAAAGCUCGACGCCAUGGUACCUGGCCGGCAGGGUGUACCGGGAAACCGGUGUGCCUUCCAUUGCGAAAAGGAGAGCUGGAUUUGGGACC,31,22,35,31,119
1772,6,CP000482.1/935247-935365,AUGCCAUGUUAUCUCCGAGCCUUGCCACCUAAAAGGAAAACCUCAUGGUGCACGGCCAACGGGUUUCGCUGGAAACAGCGGAGCCUCCCUUCAGGAAAGGAGCUUGUCCUCGUUAGAGA,30,25,31,33,119
1773,6,AACY022724149.1/127-8,AACAGAUAAUUUCUCCGAUUCAUUCAUGCCUAAUGCGCCCGCAAAGGCAGGAUGAACGAAAGGGUCAGCAUGGAAACGUGCUGGCCUCCCGUUUUGGAAAGGAGACCUCCUAUGUUGGAC,33,27,31,29,120
1774,6,CP000148.1/2016583-2016702,AUUUAAAACCGUCUCCGAGCCGCGGCGCCUAAAGGGAACAUCCCCAUGGCGGUCCGGCCUAUGGGUAUCGCUGGAAACGGCGUUGCCUUCCUUAUGCAAAGGGGACCCAGCGACGCGGAG,26,21,37,36,120
1775,6,AE017180.1/2979275-2979393,AUAUUUUGUUAUCUCCGAGCCCAUCCGCCUACCAGGAACAUUCCCACGGCGGCCGGCCGACGGGUGUUGCUGGAAACGGCAGCGCCUCCCCUCUGGAAAGGAGAUUCCGGGCCACGUGC,22,23,34,40,119
1776,6,CP000142.2/2958797-2958678,UACAGAACACGUCUCCGAGUCUUAAGCCUAAAAGGAUGGACCUCAUGGCUGACGGGCCGGCAGGGUUUCGCUGGAAACGGCGGAGCCUCCCUUUCGGAAAGGAGAUAUUUGCAUUUUGAG,29,27,36,28,120
1777,6,CP000232.1/1884333-1884198,UUGAAUAGUCAUCUCCGAGCCGGUGCUCCUAAGGGCUGUCGCCUAUGGAACACCGGCCUGGGUUUCGUACCCAUGGGGUAGGUCGGGAAACGGGCCUGCCUCCCUUUGCUCGGAAAGGAGAUUCCCCAUGGCUUCU,23,33,41,39,136
1778,6,AAWL01000002.1/83580-83714,UAUGGAAUACGCCUUCGAGCCUGUCCGCCUAAAGGUAGCGUCCCAUGGCAGACUGGCCUGGGCCCGACGCCCACGGGGUAUAGUUGGAAACGGCUAUGCCUUCCCAGUUUGAAAAGGAGGUAGACAAAUGAUUAG,33,28,40,34,135
1779,6,CP000627.1/583753-583892,GCUUGGCCUUAACUCCGAGCUUACCGCGCUAAGUUUAAACCUUUAAAUAUGCGUUGUAAGCCAGUGACCGCUUGUCACAAGGGCAGAAUUGGAAAUGAUUUUGCCUCCCGUAUUUGGAAAGGUGUUCUGUGGCGCAACAA,35,40,34,31,140
1780,6,AAKJ02000036.1/5658-5797,GCUUGGCCUUAACUCCGAGCUUACCGCGCUAAGUUUAAACCUUUAAAUAUGCGUUGUAAGCCAGUGACCGCUUGUCACAAGGGCAGAAUUGGAAAUGAUUUUGCCUCCCGUAUUUGGAAAGGUGUUCUGUGGCGCAACAA,35,40,34,31,140
1781,6,AAKI02000041.1/24441-24302,GCUUGGCCUUAACUCCGAGCUUACCGCGCUAAGUUUAAACCUUUAAAUAUGCGUUGUAAGCCAGUGACCGCUUGUCACAAGGGCAGAAUUGGAAAUGAUUUUGCCUCCCGUAUUUGGAAAGGUGUUCUGUGGCGCAACAA,35,40,34,31,140
1782,6,AAUR01000042.1/26458-26319,GCUUGGCCUUAACUCCGAGCUUACCGCGCUAAGUUUAAACCUUUAAAUAUGCGUUGUAAGCCAGUGACCGCUUGUCACAAGGGCAGAAUUGGAAAUGAUUUUGCCUCCCGUAUUUGGAAAGGUGUUCUGUGGCGCAACAA,35,40,34,31,140
1783,6,AAWE01000035.1/31834-31695,GCUUGGCCUUAACUCCGAGCUUACCGCGCUAAGUUUAAACCUUUAAAUAUGCGUUGUAAGCCAGUGACCGCUUGUCACAAGGGCAGAAUUGGAAAUGAUUUUGCCUCCCGUAUUUGGAAAGGUGUUCUGUGGCGCAACAA,35,40,34,31,140
1784,6,AAWF01000006.1/90475-90336,GCUUGGCCUUAACUCCGAGCUUACCGCGCUAAGUUUAAACCUUUAAAUAUGCGUUGUAAGCCAGUGACCGCUUGUCACAAGGGCAGAAUUGGAAAUGAUUUUGCCUCCCGUAUUUGGAAAGGUGUUCUGUGGCGCAACAA,35,40,34,31,140
1785,6,AAUU01000009.1/30696-30557,GCUUGGCCUUAACUCCGAGCUUACCGCGCUAAGUUUAAACCUUUAAAUAUGCGUUGUAAGCCAGUGACCGCUUGUCACAAGGGCAGAAUUGGAAAUGAUUUUGCCUCCCGUAUUUGGAAAGGUGUUCUGUGGCGCAACAA,35,40,34,31,140
1786,6,AAWD01000062.1/12304-12165,GCUUGGCCUUAACUCCGAGCUUACCGCGCUAAGUUUAAACCUUUAAAUAUGCGUUGUAAGCCAGUGACCGCUUGUCACAAGGGCAGAAUUGGAAAUGAUUUUGCCUCCCGUAUUUGGAAAGGUGUUCUGUGGCGCAACAA,35,40,34,31,140
1787,6,AE003852.1/1093019-1093158,GCUUGGCCUUAACUCCGAGCUUACCGCGCUAAGUUUAAACCUUUAAAUAUGCGUUGUAAGCCAGUGACCGCUUGUCACAAGGGCAGAAUUGGAAAUGAUUUUGCCUCCCGUAUUUGGAAAGGUGUUCUGUGGCGCAACAA,35,40,34,31,140
1788,6,AAUT01000027.1/30681-30542,GCUUGGCCUUAACUCCGAGCUUACCGCGCUAAGUUUAAACCUUUAAAUAUGCGUUGUAAGCCAGUGACCGCUUGUCACAAGGGCAGAAUUGGAAAUGAUUUUGCCUCCCGUAUUUGGAAAGGUGUUCUGUGGCGCAACAA,35,40,34,31,140
1789,6,AAWG01000034.1/4112-3973,GCUUGGCCUUAACUCCGAGCUUACCGCGCUAAGUUUAAACCUUUAAAUAUGCGUUGUAAGCCAGUGACCGCUUGUCACAAGGGCAGAAUUGGAAAUGAUUUUGCCUCCCGUAUUUGGAAAGGUGUUCUGUGGCGCAACAA,35,40,34,31,140
1790,6,BA000031.2/2204413-2204280,UGGUUGCCAUAACUCCGAGCUCACUAUGCUAAGUCCGAGGAUAAGCAUUUUGAGCCAGUGACAUACUGUCACAAGGGCAUGAUUGGAAAUGGCCAUGCCUCCCGUGUUUGGAAAGGUGUUCCGUGGCGCAACAA,34,33,36,31,134
1791,6,AAWQ01000033.1/29657-29524,UGGUUGCCAUAACUCCGAGCUCACUAUGCUAAGUCUGAGGAUAAGCAUUUUGAGCCAGUGACAUACUGUCACAAGGGCAUGAUUGGAAAUGGCCAUGCCUCCCGUGUUUGGAAAGGUGUUCCGUGGCGCAACAA,34,34,36,30,134
1792,6,AAWP01000079.1/7183-7050,UGGUUGCCAUAACUCCGAGCUCACUAUGCUAAGUCCAAGGAUAGGCGUCUUGAGCCAGUGACAUACUGUCACAAGGGCACAAUUGGAAAUGAUUAUGCCUCCCGUGUUUGGAAAGGUGUUCCGUGGCGCAACAA,35,33,35,31,134
1793,6,ABCH01000027.1/16237-16374,UAACUGCCAUAACUCCGAGCUCUACGCGCUAAGUCGAACCAAAGAUAAGCUUCUAGAGCCAGUGACAAUUUGUCACAAGGGCAUAAUUGGAAAUGAUUGUGCCUCCCGUGUUUGGAAAGGUGUUCCGUGGCGCAACAA,40,33,33,32,138
1794,6,AATY01000030.1/31957-31818,GCUUGGCCUUAACUCCGAGCUUACCGCGCUAAGUUUAAACCUGUAAAUAUGCGUUGUAAGCCAGUGGCAGAAUGUCACAAGGGCAGGAUUGGAAAUGAUUUUGCCUCCCGUAUUUGGAAAGGUGUUCUGUGGCGCAACAA,36,38,37,29,140
1795,6,CP000444.1/4455501-4455368,CGAAUGACGGUUCUCCGAGCUUGCCUACCUAAGUCGACAGAUAUGGGGGUGUAGCCGUGGCAAUAAGGCCACUGGGGUGAGUAAAGAAAUGCACUCGCCUCCCACACUUGGAAAGGUGAUCAUGUCUCAAUUAC,35,30,37,32,134
1796,6,CP000446.1/294832-294965,CGAAUGACGGUUCUCCGAGCUUGCCUACCUAAGUCGACAGAUAUGGGGGUGUAGCCGUGGCAAUAAGGCCACUGGGGUGAGUAAAGAAAUGCACUCGCCUCCCACACUUGGAAAGGUGAUCAUGUCUCAAUUAC,35,30,37,32,134
1797,6,CP000720.1/3203744-3203598,ACUGAACAUAAACUCCUAGCCUUAGCGUCUACGUUGUCUUUUUUGUAUUGGCAAUAUGAUGUUCUGGCCGUGGCCUUAAGCCACCAGGGUGCAAGGUAGAAAUGCCUGCAUCUCCCGUAUUUGGAAAGGUGUUAUGGUACAACUCAC,35,45,34,33,147
1798,6,ABCQ01000014.1/60025-59878,AUAUUAAUCAAACUCCGAUCCUUAACGAUCUAAAUUUAUAAAAUUAAAUAUGAUCUUAAGGACUCAUAGCAUUUUAAAUUUGCUAUAAGGGUUUAAUCAGAAAUGAUUAGGCCUCCCGUAUUUGGAAAGGUGUUUAUGCAACUUCAAG,53,51,22,22,148
1799,6,AE014299.1/4641235-4641102,CAGCUGACGGUUCUCCGAGCUUGCCUACCUAAGUCAACAGAUAUGGGGGUGUAGCCGUGGCAAUAAGGCCACUGGGGUGAGUAAAGAAAUGCUCUCGCCUCCCACACUUGGAAAGGUGAUCAUGUCUCAAUUAC,34,31,36,33,134
1800,6,BA000037.2/1214618-1214768,GGGUUGCCAUAACUCCGAGCUUAACUUGCUAAGUUAUUUUAUUUCAAUGAUGGAAUGAUAAGCAGCUUAAGCCAGUGACAUGAUGUCACAAGGGCGUAAUUGGAAAUGACUACGCCUCCCGUGUUUGGAAAGGUGUUCCGUGGCGCAACAA,42,42,38,29,151
1801,6,BX936398.1/1419284-1419430,GCUGAACAUAAACUCCUAGCCUUAGCGUCUACGUUGUCUUUUUUGUAUUGGCAAUAUGAUGUUCUGGCCGUGGCCUUAAGCCACCAGGGUGCAAGGUAGAAAUGCCUGCAUCUCCCGUAUUUGGAAAGGUGUUAUGGUACAACUCAC,34,45,35,33,147
1802,6,CP000305.1/3199155-3199009,GCUGAACAUAAACUCCUAGCCUUAGCGUCUACGUUGUCUUUUUUGUAUUGGCAAUAUGAUGUUCUGGCCGUGGCCUUAAGCCACCAGGGUGCAAGGUAGAAAUGCCUGCAUCUCCCGUAUUUGGAAAGGUGUUAUGGUACAACUCAC,34,45,35,33,147
1803,6,ABAT01000001.1/487948-487802,GCUGAACAUAAACUCCUAGCCUUAGCGUCUACGUUGUCUUUUUUGUAUUGGCAAUAUGAUGUUCUGGCCGUGGCCUUAAGCCACCAGGGUGCAAGGUAGAAAUGCCUGCAUCUCCCGUAUUUGGAAAGGUGUUAUGGUACAACUCAC,34,45,35,33,147
1804,6,AAUB01000157.1/9443-9589,GCUGAACAUAAACUCCUAGCCUUAGCGUCUACGUUGUCUUUUUUGUAUUGGCAAUAUGAUGUUCUGGCCGUGGCCUUAAGCCACCAGGGUGCAAGGUAGAAAUGCCUGCAUCUCCCGUAUUUGGAAAGGUGUUAUGGUACAACUCAC,34,45,35,33,147
1805,6,CP000308.1/1219676-1219822,GCUGAACAUAAACUCCUAGCCUUAGCGUCUACGUUGUCUUUUUUGUAUUGGCAAUAUGAUGUUCUGGCCGUGGCCUUAAGCCACCAGGGUGCAAGGUAGAAAUGCCUGCAUCUCCCGUAUUUGGAAAGGUGUUAUGGUACAACUCAC,34,45,35,33,147
1806,6,AE009952.1/3330087-3329941,GCUGAACAUAAACUCCUAGCCUUAGCGUCUACGUUGUCUUUUUUGUAUUGGCAAUAUGAUGUUCUGGCCGUGGCCUUAAGCCACCAGGGUGCAAGGUAGAAAUGCCUGCAUCUCCCGUAUUUGGAAAGGUGUUAUGGUACAACUCAC,34,45,35,33,147
1807,6,AAYU01000002.1/139698-139844,GCUGAACAUAAACUCCUAGCCUUAGCGUCUACGUUGUCUUUUUUGUAUUGGCAAUAUGAUGUUCUGGCCGUGGCCUUAAGCCACCAGGGUGCAAGGUAGAAAUGCCUGCAUCUCCCGUAUUUGGAAAGGUGUUAUGGUACAACUCAC,34,45,35,33,147
1808,6,AAYV01000015.1/91236-91382,GCUGAACAUAAACUCCUAGCCUUAGCGUCUACGUUGUCUUUUUUGUAUUGGCAAUAUGAUGUUCUGGCCGUGGCCUUAAGCCACCAGGGUGCAAGGUAGAAAUGCCUGCAUCUCCCGUAUUUGGAAAGGUGUUAUGGUACAACUCAC,34,45,35,33,147
1809,6,CP000668.1/2886890-2886744,GCUGAACAUAAACUCCUAGCCUUAGCGUCUACGUUGUCUUUUUUGUAUUGGCAAUAUGAUGUUCUGGCCGUGGCCUUAAGCCACCAGGGUGCAAGGUAGAAAUGCCUGCAUCUCCCGUAUUUGGAAAGGUGUUAUGGUACAACUCAC,34,45,35,33,147
1810,6,AAYS01000002.1/351853-351707,GCUGAACAUAAACUCCUAGCCUUAGCGUCUACGUUGUCUUUUUUGUAUUGGCAAUAUGAUGUUCUGGCCGUGGCCUUAAGCCACCAGGGUGCAAGGUAGAAAUGCCUGCAUCUCCCGUAUUUGGAAAGGUGUUAUGGUACAACUCAC,34,45,35,33,147
1811,6,AL590842.1/1306720-1306866,GCUGAACAUAAACUCCUAGCCUUAGCGUCUACGUUGUCUUUUUUGUAUUGGCAAUAUGAUGUUCUGGCCGUGGCCUUAAGCCACCAGGGUGCAAGGUAGAAAUGCCUGCAUCUCCCGUAUUUGGAAAGGUGUUAUGGUACAACUCAC,34,45,35,33,147
1812,6,AAYT01000002.1/511253-511107,GCUGAACAUAAACUCCUAGCCUUAGCGUCUACGUUGUCUUUUUUGUAUUGGCAAUAUGAUGUUCUGGCCGUGGCCUUAAGCCACCAGGGUGCAAGGUAGAAAUGCCUGCAUCUCCCGUAUUUGGAAAGGUGUUAUGGUACAACUCAC,34,45,35,33,147
1813,6,ABCD01000002.1/667524-667378,GCUGAACAUAAACUCCUAGCCUUAGCGUCUACGUUGUCUUUUUUGUAUUGGCAAUAUGAUGUUCUGGCCGUGGCCUUAAGCCACCAGGGUGCAAGGUAGAAAUGCCUGCAUCUCCCGUAUUUGGAAAGGUGUUAUGGUACAACUCAC,34,45,35,33,147
1814,6,AAYR01000003.1/37187-37041,GCUGAACAUAAACUCCUAGCCUUAGCGUCUACGUUGUCUUUUUUGUAUUGGCAAUAUGAUGUUCUGGCCGUGGCCUUAAGCCACCAGGGUGCAAGGUAGAAAUGCCUGCAUCUCCCGUAUUUGGAAAGGUGUUAUGGUACAACUCAC,34,45,35,33,147
1815,6,AE017042.1/1078165-1078019,GCUGAACAUAAACUCCUAGCCUUAGCGUCUACGUUGUCUUUUUUGUAUUGGCAAUAUGAUGUUCUGGCCGUGGCCUUAAGCCACCAGGGUGCAAGGUAGAAAUGCCUGCAUCUCCCGUAUUUGGAAAGGUGUUAUGGUACAACUCAC,34,45,35,33,147
1816,6,CP000606.1/101467-101601,GAAACGACGGUUCUCCGAGCUUUCUCUCCUACGUCCACAGAUAGGGAGAUUAAGCCGUGGCAAUAGUGCCACCGGGGUGAGGAAAGAAAUUGACUCACCUCCCCUUACUUGGAAAGGUGAUCAUGUCUCAACUAC,36,31,33,35,135
1817,6,CP000462.1/1732669-1732808,AAACUAGAUGAACUCCGAGCGGUUUUGCCUAAGUCCUCAUGAUAGGGGGAAACCGCCGUCAGCCGAUGUUCGAGCUGUAAGGGUCAGGAAAGAAAUGCCCUGGCCUCCCGUAUUUGGAAAGGUGUUUAUGUCGCCACUGC,34,33,40,33,140
1818,6,CP000644.1/2971207-2971068,AAACUAGAUGAACUCCGAGCUGUUUUGCCUAAGUCCUUGGGAUAGGGGAAAGCCGCCGUCAGCCGAUGUUCGAGCUGUAAGGGUCAGGAAAGAAAUGCCCUGGCCUCCCGUAUUUGGAAAGGUGUUUAUGUUGCCACUGC,33,35,41,31,140
1819,6,AM286415.1/3151770-3151626,ACUGAGCACAAACUCCUAGCCUUAGUGUCUACGUUGUUGCGUUUAUGGACAAUAUGAUGCUCUGGCCGUGGCUUCAAGCCACCAGGGUGCGAGGUAGAAAUGCCUGCAUCUCCCGUAUUUGGAAAGGUGUUAUGGUACAACUUAC,34,41,37,33,145
1820,6,CP000563.1/321974-322107,CCGGUGACGGUUCUCCGAGCUUGCCUACCUAAGUCGAAAGAUAUGGAGGUGUAGCCGUGGUAAUAAUGCCACCGGGGUGGGAUAAGAAAUGCUCUCACCUCCCACACUUGGAAAGGUGAUCAUGUCUCAAUUAC,34,32,36,32,134
1821,6,CP000753.1/319215-319348,CCGGUGACGGUUCUCCGAGCUUGCCUACCUAAGUCGAAAGAUAUGGAGGUGUAGCCGUGGUAAUAAUGCCACCGGGGUGGGAUAAGAAAUGCUCUCACCUCCCACACUUGGAAAGGUGAUCAUGUCUCAAUUAC,34,32,36,32,134
1822,6,CP000507.1/4159189-4159323,UCAAUGACGGUUCUCCGAGCUCCUGCACCUAAGUCAAUGGAUAUGGUGUUUGAGCCGUGGCGCGGUGCCACCGGGGUGGGGUGCAGAAAUGGCUUCACCUCCCGAUACUUGGAAAGGUGAUCAUGUCUCAACUUC,27,34,40,34,135
1823,6,CP000469.1/309677-309810,CGAAUGACGGUUCUCCGAGCUUGCCUACCUAAGUCGACAGAUAUGGGGGUGUAGCCGUGGUAAUAAGGCCACUGGGGUGAGUAAAGAAAUGCACUCGCCUCCCACACUUGGAAAGGUGAUCAUGUCUCAAUUGC,34,31,38,31,134
1824,6,AASA01000098.1/11609-11765,AUUUAUUGAAGACUCCGAGCAUUAUUUCCUAACUCUAAAAAUUAAAGACAAAUUUUUGAUAUGGAAUUUAUGCCAGUAACAGCAUAAAGCUGUUCAAAGGAUAACUUAGAAAUGGGUUGUCCUCUCGUGUUUAGAAAGGUGUCAAAUGCAGUCUAUU,54,52,28,23,157
1825,6,AAPS01000028.1/5735-5869,UGGUUGCCAUAACUCCGAGCUCACUAUUGCUAAGUCCUUGGAUAAGCGUUUUGAGCCAGUGGCAUACUGUCACAAGGGCAUGAUUGGAAAUGGCCAUGCCUCCCGUGUUUGGAAAGGUGUUCCGUGGCGCAACAA,31,36,37,31,135
1826,6,CP000503.1/268441-268574,CCAGCGACGGUUCUCCGAGCUUGCCUACCUACGUCAAUAGAUAUGGAGGUGUAGCCGUGGUAAUAAUGCCACCGGGGUGAGUAAAGAAAUGCUCUCACCUCCCACACUUGGAAAGGUGAUCAUGUCUCAAUUAC,35,32,33,34,134
1827,6,CP000681.1/424831-424964,CCAGCGACGGUUCUCCGAGCUUGCCUACCUACGUCAAUAGAUAUGGAGGUGUAGCCGUGGUAAUAAUGCCACCGGGGUGAGUAAAGAAAUGCUCUCACCUCCCACACUUGGAAAGGUGAUCAUGUCUCAAUUAC,35,32,33,34,134
1828,6,AAKK02000029.1/45601-45467,UGGUUGCCAUAACUCCGAGCUCACUAUUGCUAAGUCCGAGGAUAAGCGUUUUGAGCCAGUGGCGUACUGUCACAAGGGCAUGAUUGGAAAUGGCCAUGCCUCCCGUGUUUGGAAAGGUGUUCCGUGGCGCAACAA,31,34,39,31,135
1829,6,CP000447.1/97810-97942,GAUCUGACGGUUCUCCGAGCUUUUUGCCCUACGUCAAUGAUAUGGGCAGUUAGCCGUGGUAAUUUUGCCACCGGGGUGAGUAAAGAAAUGCACUCACCUCCCACACUUGGAAAGGUUAACAUGUCCCAACUAC,33,35,31,34,133
1830,6,AAZG01000002.1/216987-216847,UUUAACGCAUAACUCCGAGCUUGUUUAGCCUAAGUUUCAUCGAAAUACGGCGACAAGCCAAUAACGCCGUGUGUUAUUCAGGGAUACGCUGGAAACGGUUUAUCCUCUCCAUAUUUAGAAAGGUGUAGAAUGCAAUCCAUU,41,41,29,30,141
1831,6,CP000653.1/1402015-1402149,GAUGAAAACAUACACUCUAGCCUUGACGCCUGUGUCACAUGAUAUGGCGCCCUGGCCGUGGCGGUUUCGCCACCAGGGUACAGAAAGAAAUGACUGUGCCUCCCGUAUCUGGAAAGGUGUACAUGGCUUCACAAC,34,30,35,36,135
1832,6,CP000302.1/114598-114731,GCAUUGACGGUUCUCCGAGCUUCUUAUCCUAAGUCUUUAGAUACGGGUCAUUAGCCGUGGUAAUAAUGCCACCGGGGUGAGUAAAGAAAUGCACUCACCUCCCGCACUUGGAAAGGUUAACAUGUCUCAACUAC,35,36,30,33,134
1833,6,CP000671.1/754622-754762,UUUAACGCAUAACUCCGAGCUUGUUUAGCCUAAGUUUCAUCGAAAUACGGCGACAAGCCAAUAACGCAGUUCGUUAUUCAGGGAUACGCUGGAAACGGUUUAUCCUCUCCGUAUUUAGAAAGGUGUAAAAUGCAAUCCAUU,42,41,28,30,141
1834,6,BX571864.1/57269-57413,CUAUGGAAUUAACUCCUAGCCUCUGCAUCUAAGUCACUUUUUACACAGCGAUAUGAUGUUUUGGCCGUGACCACUGAGUCACCAGGAUGUGAGGCAGAAAUGCCCACGUCUCCCAUGUUUGGAAAGGUGUUAUGGUGAAACAACU,38,41,33,33,145
1835,6,AAZD01000003.1/249903-250044,UUUAACGCAUAACUCCGAGCUUGUUUAGCCUAAGUUUCACAAAAAAUACGGUGGCAAGCCAAUAACGCGGUACGUUAUUCAGGGAUACGCUGGAAACGGUUUAUCCUCUCCAUAUUUAGAAAGGUGUAAAAUGCAAUCCAUU,45,40,28,29,142
1836,6,AAZE01000014.1/10673-10814,UUUAACGCAUAACUCCGAGCUUGUUUAGCCUAAGUUUCACAAAAAAUACGGUGGCAAGCCAAUAACGCGGUACGUUAUUCAGGGAUACGCUGGAAACGGUUUAUCCUCUCCAUAUUUAGAAAGGUGUAAAAUGCAAUCCAUU,45,40,28,29,142
1837,6,AAZI01000004.1/68933-69074,UUUAACGCAUAACUCCGAGCUUGUUUAGCCUAAGUUUCACAAAAAAUACGGUGGCAAGCCAAUAACGCGGUACGUUAUUCAGGGAUACGCUGGAAACGGUUUAUCCUCUCCAUAUUUAGAAAGGUGUAAAAUGCAAUCCAUU,45,40,28,29,142
1838,6,L42023.1/1745366-1745226,UUUAACGCAUAACUCCGAGCUUGUUUAGCCUAAGUUUCAUAGAAAUACGGUGGCAAGCCAAUAACGCGCUACGUUAUUCAGGGAUACGCUGGAAACGGUUUAUCCUCUCCGUAUUUAGAAAGGUGUAAAAUGCAAUCCAUU,42,41,29,29,141
1839,6,CP000312.1/1962720-1962561,AUUAGUAUAACUCUCCAAGCUUAAAGAUCUAAGGAGAAGGUUCUAUGAUUUUUAAGCCUGGAUUACUAAAUUAUUUAACAUUAAGUUGGUAAUCCACAGGGUAAGGUUUGAAAGAAUUUUGCCUCCACGUAUUUUGGGAAGGAGAAUAAGCAAAAGUAAA,58,50,32,20,160
1840,6,AAZF01000005.1/174554-174413,UUUAACGCAUAACUCCGAGCUUGUUUAGCCUAAGUUUCAGAAGAAAUACGGUGGCAAGCCAAUAACGCCGUGUGUUAUUCAGGGAUACGCUGGAAACGGUUUAUCCUCUCCAUAUUUAGAAAGGUGUAAAAUGCAAUCCAUU,43,41,30,28,142
1841,6,AP006840.1/3132643-3132508,GAUGUGAUCACGUCCCGAGUCAUGCGACCUGUACCCGAUGGGGUAUGGUCGCCUGACCGGUCCCGGUCGUACCGGGCCAGGGUUGUCGGGGAAACCUGGCGGCCUCCCGUUGGAAAGGGGCGGAACUGCGGGAGAU,22,25,52,37,136
1842,6,CP000612.1/2515252-2515370,AAAUUAAUAGUACUCCGAGCUUAGGCACCUAAGAUAGUAAUUAUGGUUCUUAAGCCGUUAGGGUUUGUCUGGAAACGGGCAGGCCUCCCAAUGCGGAAAGGAGAAACACAUUAUGCCAA,38,29,29,23,119
1843,6,AP008232.1/1475425-1475565,AGGUAUACAUAACUCCUAGCCUUUACGCCUAAGUGGCCCGUCAUGAGCCAUAGGGGGUUCUGGCCGUGGCGAAGCCACCAGGGUGCAGGGUAGAAAUGCCGGCAUCUCCCGUAUUUGGAAAGGUGUUACUGUGUCACAACU,32,33,41,35,141
1844,6,AE014613.1/2146005-2145861,AACCACAAUAAACACUCUAGCCUCUGCACCUGGGUCAUUUUUGAUAUGGUGCUUUGGCCGUGACAACGUUUAACGUUUGCCACCAGGGCGCAGGAAGAAAUGACUCCGCCUCCCGUAUUUGGAAAGGUGUACAUGGCUUCACAAC,37,37,33,38,145
1845,6,AL627268.1/76072-76216,AACCACAAUAAACACUCUAGCCUCUGCACCUGGGUCAUUUUUGAUAUGGUGCUUUGGCCGUGACAACGUUUAACGUUUGCCACCAGGGCGCAGGAAGAAAUGACUCCGCCUCCCGUAUUUGGAAAGGUGUACAUGGCUUCACAAC,37,37,33,38,145
1846,6,AAZH01000018.1/19134-18993,UUUAACGCAUAACUCCGAGCUUGUUUAGCCUAAGUUUCACAAGAAAUACGGUGGCAAGCCAAUAACGCGCUACGUUAUUCAGGGAUACGCUGGAAACGGUUUAUCCUCUCCGUAUUUAGAAAGGUGUAAAAUGCAAUCCAUU,43,40,29,30,142
1847,6,CP000672.1/374985-374845,UUUAACGCAUAACUCCGAGCUUGUUUAGCCUAAGUUUCAUAGAAAUACGGUGGCAAGCCAAUAACGCGCUACGUUAUUCAGGGAUACGCUGGAAACGGUUUGUCCUCUCCGUAUUUAGAAAGGUGUAAAAUGCAAUCCAUU,41,41,30,29,141
1848,6,AAZJ01000004.1/67324-67464,UUUAACGCAUAACUCCGAGCUUGUUUAGCCUAAGUUUCAUAGAAAUACGGUGGCAAGCCAAUAACGCGCUACGUUAUUCAGGGAUACGCUGGAAACGGUUUGUCCUCUCCGUAUUUAGAAAGGUGUAAAAUGCAAUCCAUU,41,41,30,29,141
1849,6,AAEW02000009.1/8135-8014,UACUAUCAAGAUCUCCGAGCCUGCCCCCCCUACGGAGGUUGCCUUUAAGGGGACAGGCCUCAGGGUUGCAUUGGAAACGGUGUGGCCUCCCAGUCUUGGAAAGGAGAUUCUUACCAUGCGCU,25,29,34,34,122
1850,6,ABEJ01000007.1/41426-41570,AACCACAGUAAACACUCUAGCCUCUGCACCUGGGUCAUUUUUGAUAUGGUGCUUUGGCCGUGACAACGUUUAACGUUUGCCACCAGGGCGCAGGAAGAAAUGACUCCGCCUCCCGUAUUUGGAAAGGUGUACAUGGCUUCACAAC,36,37,34,38,145
1851,6,ABAN01000005.1/160757-160613,AACCACAGUAAACACUCUAGCCUCUGCACCUGGGUCAUUUUUGAUAUGGUGCUUUGGCCGUGACAACGUUUAACGUUUGCCACCAGGGCGCAGGAAGAAAUGACUCCGCCUCCCGUAUUUGGAAAGGUGUACAUGGCUUCACAAC,36,37,34,38,145
1852,6,AE017220.1/899104-899248,AACCACAGUAAACACUCUAGCCUCUGCACCUGGGUCAUUUUUGAUAUGGUGCUUUGGCCGUGACAACGUUUAACGUUUGCCACCAGGGCGCAGGAAGAAAUGACUCCGCCUCCCGUAUUUGGAAAGGUGUACAUGGCUUCACAAC,36,37,34,38,145
1853,6,AAXB02000020.1/32320-32165,AAAUACAAGGUUCUCCGAAGCCUUCAUGCCUAAGAUCCAUAAAAAUUGUGAUGAUGGGAUGUUGGCCAGGAAUGACAGGUCUGUCAGUUCCUCAGGGUAGAUAGGGAAACGUAUCUGCCUCCCGCGUAUUUGGAAAGGAGAGCAGCACCUUUGCUU,43,40,41,32,156
1854,6,CP000647.1/905889-906027,AUAACCUGUUAACACUCUAGCCUCUUCGCCUGUGUCAAAAGAUAUGGCGAUUUGGCCGCGACGCCGCCGGUUGUCGCCAGGGCGUGGAAAGAAAUGACCGCGUCUCCCGUAUUUGGAAAGGUGUAUAUGGCCUCACAGC,31,33,38,37,139
1855,6,CP000724.1/1069180-1069304,AUGAUAUUAAUUCUCCGAGCUUAUGACUCCUAAUAGAUCAAUGGUCUGAUGGAGUGCAAGCCUGUAGGGUAUUGUUGGAAACAAUAAUGCCUCCCAUAGCGGAAAGGAGUGCGCAAAUCUAAUGC,38,34,30,23,125
1856,6,AJ312124.1/15932-16050,UAUACACAGAUUUUCCGAGUCGUCAUUUCUAAAGCCAAGGCCAUGAAAUGCUGACCAGUGGGCCUUUUGAGAAAUUGGGGGGCCUCCCAUAUUUGGAAAGGAGAAUCUUAAACCACUGG,34,31,29,25,119
1857,6,BA000007.2/939277-939421,UUAACCACUAAACACUCUAGCCUCUGCACCUGGGUCAACUGAUAUGGUGCUUUGGCCGUGACAAUGCUCGUAAAGAUUGCCACCAGGGCGAAGGAAGAAAUGACUUCGCCUCCCGUAUCUGGAAAGGUGUACAUGGCUUCACAAC,39,34,34,38,145
1858,6,ABEI01000004.1/118460-118604,AACCACAGUAAACACUCUAGCCUCUGCACCUGGGUCAUUUUUGAUACGGUGCUUUGGCCGUGACAACGUUUAACGUUUGCCACCAGGGCGCAGGAAGAAAUGACUCCGCCUCCCGUAUUUGGAAAGGUGUACAUGGCUUCACAAC,36,36,34,39,145
1859,6,ABAO01000011.1/6431-6575,AACCACAGUAAACACUCUAGCCUCUGCACCUGGGUCAUUUUUGAUACGGUGCUUUGGCCGUGACAACGUUUAACGUUUGCCACCAGGGCGCAGGAAGAAAUGACUCCGCCUCCCGUAUUUGGAAAGGUGUACAUGGCUUCACAAC,36,36,34,39,145
1860,6,ABEL01000001.1/615181-615325,AACCACAGUAAACACUCUAGCCUCUGCACCUGGGUCAUUUUUGAUACGGUGCUUUGGCCGUGACAACGUUUAACGUUUGCCACCAGGGCGCAGGAAGAAAUGACUCCGCCUCCCGUAUUUGGAAAGGUGUACAUGGCUUCACAAC,36,36,34,39,145
1861,6,AE016827.1/1003377-1003526,AGAAAUUUUAUAUACCGAGCUUGUACGCCUAAGUUUUUAAAUUUAUUUGAAAAUAAGGCGGCAAUGCCAGCAAUGAAUUUUAUUGCUCAGGGAUAAUGUGGGAAACGACUUAUCCUCUCAUCUUCAGAAAGGUAUCAAAUGCAAUCUAUU,50,49,27,24,150
1862,6,AAXG02000019.1/34077-33936,CAAUUCAAUAUUCUCCGAGCCCCUGCGCCUACGGCUUUGCUAUGGCGCCCGGGCCGUGGACGCCUCCACGGUGUCCUUUCAGGGUCUGUGCUGGAAACGGACAGGCCUUCCGUGUUUGAGAAGGAGAGGUUUUUUCAGGCUG,22,37,43,40,142
1863,6,U00096.2/816135-816279,AUAACCACUAAACACUCUAGCCUCUGCACCUGGGUCAACUGAUACGGUGCUUUGGCCGUGACAAUGCUCGUAAAGAUUGCCACCAGGGCGAAGGAAGAAAUGACUUCGCCUCCCGUAUCUGGAAAGGUGUACAUGGCUUCACAAC,40,32,34,39,145
1864,6,X70420.1/73-217,AUAACCACUAAACACUCUAGCCUCUGCACCUGGGUCAACUGAUACGGUGCUUUGGCCGUGACAAUGCUCGUAAAGAUUGCCACCAGGGCGAAGGAAGAAAUGACUUCGCCUCCCGUAUCUGGAAAGGUGUACAUGGCUUCACAAC,40,32,34,39,145
1865,6,AP009048.1/817334-817478,AUAACCACUAAACACUCUAGCCUCUGCACCUGGGUCAACUGAUACGGUGCUUUGGCCGUGACAAUGCUCGUAAAGAUUGCCACCAGGGCGAAGGAAGAAAUGACUUCGCCUCCCGUAUCUGGAAAGGUGUACAUGGCUUCACAAC,40,32,34,39,145
1866,6,CP000158.1/1582667-1582794,GUUGGAAAUUCGCUCCGAGCCGUUCCGCCUAAAGCGCCGUUUCCCGGUGUCAUGGCGGCCCGGCCGAGGGUGGCAGUUGGAAACCCUGCCGCCUCCCGUGCUUGGAAAGGAGCCAUGCGAUGACACAU,22,25,41,40,128
1867,6,AE014075.1/839533-839677,UUAACCACUAAACACUCUAGCCUCUGCACCUGGGUCAACUGAUACGGUGCUUUGGCCGUGACAAUGCUCGUAAAGAUUGCCACCAGGGCGAAGGAAGAAAUGACUUCGCCUCCCGUAUCUGGAAAGGUGUACAUGGCUUCACAAC,39,33,34,39,145
1868,6,CP000468.1/781456-781600,UUAACCACUAAACACUCUAGCCUCUGCACCUGGGUCAACUGAUACGGUGCUUUGGCCGUGACAAUGCUCGUAAAGAUUGCCACCAGGGCGAAGGAAGAAAUGACUUCGCCUCCCGUAUCUGGAAAGGUGUACAUGGCUUCACAAC,39,33,34,39,145
1869,6,CP000036.1/682934-683078,UUAACCACUAAACACUCUAGCCUCUGCACCUGGGUCAACUGAUACGGUGCUUUGGCCGUGACAAUGCUCGUAAAGAUUGCCACCAGGGCGAAGGAAGAAAUGACUUCGCCUCCCGUAUCUGGAAAGGUGUACAUGGCUUCACAAC,39,33,34,39,145
1870,6,AE014073.1/755896-756040,UUAACCACUAAACACUCUAGCCUCUGCACCUGGGUCAACUGAUACGGUGCUUUGGCCGUGACAAUGCUCGUAAAGAUUGCCACCAGGGCGAAGGAAGAAAUGACUUCGCCUCCCGUAUCUGGAAAGGUGUACAUGGCUUCACAAC,39,33,34,39,145
1871,6,CP000243.1/779855-779999,UUAACCACUAAACACUCUAGCCUCUGCACCUGGGUCAACUGAUACGGUGCUUUGGCCGUGACAAUGCUCGUAAAGAUUGCCACCAGGGCGAAGGAAGAAAUGACUUCGCCUCCCGUAUCUGGAAAGGUGUACAUGGCUUCACAAC,39,33,34,39,145
1872,6,CP000038.1/805998-806142,UUAACCACUAAACACUCUAGCCUCUGCACCUGGGUCAACUGAUACGGUGCUUUGGCCGUGACAAUGCUCGUAAAGAUUGCCACCAGGGCGAAGGAAGAAAUGACUUCGCCUCCCGUAUCUGGAAAGGUGUACAUGGCUUCACAAC,39,33,34,39,145
1873,6,CP000247.1/832790-832934,UUAACCACUAAACACUCUAGCCUCUGCACCUGGGUCAACUGAUACGGUGCUUUGGCCGUGACAAUGCUCGUAAAGAUUGCCACCAGGGCGAAGGAAGAAAUGACUUCGCCUCCCGUAUCUGGAAAGGUGUACAUGGCUUCACAAC,39,33,34,39,145
1874,6,AE005174.2/940930-941074,UUAACCACUAAACACUYUAGCCUCUGCACCUGGGUCAACUGAUAUGGUGCUUUGGCCGUGACAAUGCUCGUAAAGAUUGCCACCAGGGCGAAGGAAGAAAUGACUUCGCCUCCCGUAUCUGGAAAGGUGUACAUGGCUUCACAAC,39,34,34,37,145
1875,6,CP000698.1/4162311-4162191,GAAACUGACGCUCUCCGAGCUGUAGCGCCUAAAAGGUUUGUACCUGAUGGCGCACGGCCUAUGGGUUCUGCCGGAAACGGCAGCGCCUCCCUUUUGGAAAGGAGAAACCGCAGCGUUGCAA,28,24,36,33,121
1876,6,CP000026.1/2029594-2029450,AACCACAAUAAACACUCUAGCCUCUGCACUUGGGUCAUUUUUGAUAUGGUGCUUUGGCCGUGACAACGUUUAACGUUUGCCACCAGGGCGCAGGAAGAAAUGACUCCGCCUCCCGUAUUUGGAAAGGUGUACAUGGCUUCACAAC,37,38,33,37,145
1877,6,BX950851.1/3157560-3157412,AUGAGAAUCAAACUCCUAGCCUUGGUGCCUAAGUGAUGCGCUUAUUGCGCGUGAUACGGUGCCUUGGCCGUGGCCUUCGUGGUCACCAGGGUGCGAGGUAGAAAUGCCUGCAUCUCCCGUAUUUGGAAAGGUGUUUAUGGUGAGUCAAC,30,41,45,33,149
1878,6,CP000510.1/2652936-2652780,UUUUAAAACCAGCUCCGAGCUUAAUAAAACUAAGUUUCCUUUUUAAGGUAAAUAAGUCUGUUAAGCCGCUUGUCUGACAUUUUGGUCAGCGCAAGAAGGGUAAAGAGAGAAAUGUCUUUGCCUCCCGUAUUUGGAAAGGAACUUAACAUGAGCCAAC,50,46,32,29,157
1879,6,CP000679.1/1094763-1094897,UUUUGAAAAUCUUUCCGAGCCAUUGCAACCUAAAAAGAGGGGUUUUUCCCUCUUCAUGGUGCUUUGGCCGAUAGGGUGCAGGUUUGGGAAACCACUGCGCCUCCCGCUUUGGAAAGGAAAGAUUUAAAGGAUACU,34,39,34,28,135
1880,6,AAOE01000024.1/17701-17833,CAUUAAGCAAUACACCGAGUGACAGGGCGCUAAGUGGUCUCCAUAAGCCCUUGUCACCUCGCAGUAGCGACAGGGUAGCGAUUGGAAACGGCGUUGCCUCCCGUGUUUGGAAAGGUGAAUAAUGUUACAGGAU,35,30,38,30,133
1881,6,CP000746.1/1838749-1838596,UCAAUUUUCGUUUACCGAGCUUGUGUGCCUAAGUUCUUCCGGUUAUCCGGCGCGGAAUAAGGCAGCAACGCCAGCGAUGCGGUUUAUCGCUCAGGGAUCCGUUGGAAACAGUUGGUCCUACCGAUUUUUGUAAAGGUAUUCAAUGCAAUCUAUU,34,48,38,34,154
1882,6,CP000266.1/795717-795862,UUAACCACUAAACACUCUAGCCUCUGCACCUGGGUCAACUGAUACGGUGCUUUGGCCGUGACAAUGCUCGUAAAGAUUGCCACCAGGGCGAAGGAAAGAAAUGACUUCGCCUCCCGUAUCUGGAAAGGUGUACAUGGCUUCACAAC,40,33,34,39,146
1883,6,CP000388.1/2608745-2608595,CAGGUGGUUUAACUCCGAGCCUUCAUACCUAAAUCAGAAGACAAGGUAUGUUGGCCGCGAAGUGCGUUCGCAAGAAUGUGUCAUUCGCCAGGGUUGUGAGAGAAAUCAAACAGCCUCCCCGUAAGUGCCAAGGCGAUAAGGCCCGGCAACU,42,31,41,37,151
1884,6,CP000360.1/5126307-5126444,CUAGGAACGUGUUUCCGACGUUCGCUGCCUACGGAAUACUAAGGCAUCGGGCGCGGUAUCCAUCUUUGUAGAUGGAUCGAGGGUGACGAAGGAAACUUCGCCGCCUCCCGUUUGGAAAGGAAGCACCUCGGCGCAUGC,30,30,42,36,138
1885,6,CP000478.1/38745-38855,AGAACGGUCGCUCCCCGAGCCGCCGGGUCUAAGGCUUUUGCGGCGGCCGGCAGGGUGUGCCUGGAAACGGGCAUGCCUCCCGUUGCGGAAAGGGGAGCAGGUCAAACCGGG,19,16,44,32,111
1886,6,CR522870.1/3382961-3382835,UUAAGAAUAUAACUCCGAGCUAAAAGGCCUUCGGUUUCUGCAUGGAUCAUGGUCUGCAGCCGUUAGGGUUGUACUGGAAACGGUUCAGCCUUCCACCACUUGAAAAGGAGUCUGUAUGAAUGUCUCA,33,36,31,27,127
1887,6,AAMR01000039.1/24877-24725,CAGUUGCCAUAACUCCGAGCUCUCGCAUGCUAAGUCGCACAGUGGUAUUUGCUGUACCGAUACGCAUCAAGAGCCAGUGACAUGUUGUCACAAGGGCUUAAUUGGAAAUGAUUAUGCCUCCCGUGUUUGGAAAGGUGUUCCGUGGCGCAACAA,38,40,39,36,153
1888,6,AAPH01000008.1/168857-169008,UAGCUGCCAUAACUCCGAGCUUUGGUCACUACGUUUUCUGUUUUUCUUAAAUCAGAAUAUAUGUGUUCAGAGCCAGUGACAUACUGUCACCAGGGUCAAUUUAGAAAUGAAUCGGCCUCCCGUAUUUGGAAAGGUGUUCCAUGGCGCAACAA,40,47,32,33,152
1889,6,AAOJ01000002.1/672485-672316,UAACUGCCAUAACUCCGAGCAUUUUUCACUAAGUUACUAAGCGAUGUUGGACAUUAAUAUAUACGUUCAAAAGUUGAUAGGUGAUUAAUGCCAGUGACGAUUUGUCACCAGGGUUUAUUUAGAAAUGAAUUGACCUCCCGUAUUUGGAAAGGUGUUCCGUGGCGAAACAA,52,53,36,29,170
1890,6,AAOU01000009.1/42833-43004,UAACUGCCAUAACUCCGAGCAUUCUUCACUAAGUUACUAAGCGAUGUUGGACUUAUAUAUAUAUACGUUCAAAAGUUGAUAGGUGAUUAAUGCCAGUGACGAUUUGUCACCAGGGUUUAUUUAGAAAUGAAUUGACCUCCCGUAUUUGGAAAGGUGUUCCGUGGCGAAACAA,52,54,36,30,172
1891,6,ABDX01000019.1/7621-7434,AUUAGUAUAAAUCUCCAAGCUUAAAGAUCUAAGGAGAAGGUUCUAUGAUUUUUAAGCCUGGAUUACUAAAUUAUUUAACAUUAAGUUUAAUAAGAGCUUAAAUUGUUAAUUUGGGGGUAAUCCACAGGGUAAGGUUUGAAAGAAUUUUGCCUCCACGUAUUUUGGGAAGGAGAAUAAGCAAAAGUAAA,69,61,38,20,188
1892,6,AAND01000029.1/42323-42171,CAGUUGCCAUAACUCCGAGCUCUCGCAUGCUAAGUCGCACAGUGGUAUUUGCUGUACCGAUACGCAUCAAGAGCCAGUGACAUGUUGUCACAAGGGCUUAAUUGGAAAUGAUUAUGCCUCCCGUGUUUGGAAAGGUGUUCCGUGGCGCAACAA,38,40,39,36,153
1893,6,AC150248.3/31115-31259,AUAACCACUAAACACUCUAGCCUCUGCACCUGGGUCAACUGAUACGGUGCUUUGGCCGUGACAAUGCUCGUAAAGAUUGCCACCAGGGCGAAGGAAGAAAUGACUUCGCCUCCCGUAUCUGGAAAGGUGUACAUGGCUUCACAAC,40,32,34,39,145
1894,6,AAZW01000021.1/37268-37420,CGGUUGCCAUAACUCCGAGCUCUCGCAUGCUAAGUCGCACAGUGGUAUUUGCUGUACCGAUACGCAUCAAGAGCCAGUGACAUGUUGUCACAAGGGCUUAAUUGGAAAUGAUUAUGCCUCCCGUGUUUGGAAAGGUGUUCCGUGGCGCAACAA,37,40,40,36,153
1895,6,AB017192.1/8307-8501,AUUAGUAUAAAUCUCCAAGCUUAAAGAUCUAAGGAGAAGGUUCUAUGAUUUUUAAGCCUGGAUUACUAAAUUAUUUAACAUUAAGUUUAAUAAGAACUUAAAUUGUUAAUUGGUUUAAUUGGGGUAAUCCACAGGGUAAGGUUUGAAAGAAUUUUGCCUCCACGUAUUUUGGGAAGGAGAAUAAGCAAAAGUAAA,72,65,38,20,195
1896,6,BA000016.3/2073405-2073211,AUUAGUAUAACUCUCCAAGCUUAAAGAUCUAAGGAGAAGGUUCUAUGAUUUUUAAGCCUGGAUUACUAAAUUAUUUAACAUUAAGUUUAAUAAGAACUUAAAUUGUUAAUUGGUUUAAUUGGGGUAAUCCACAGGGUAAGGUUUGAAAGAAUUUUGCCUCCACGUAUUUUGGGAAGGAGAAUAAGCAAAAGUAAA,71,65,38,21,195
1897,6,AM933172.1/829612-829756,AACCACAGUAAACACUCUAGCCUCUGCACCUGGGUCAUUUUUGAUACGGUGCUUUGGCCGUGACAACGUUUAACGUUUGCCACCAGGGCGCAGGAAGAAAUGACUCCGCCUCCCGUAUUUGGAAAGGUGUACAUGGCUUCACAAC,36,36,34,39,145
1898,6,CP000924.1/904376-904493,UUAUUACUUAUUCUCCGAGUCUAUAAUCCUAAGGCAAGAGCUAUGGAUUAUAGGCCGAUAGGGUAGUGCUGGAAACGGUGCUGCCUCCCGCCUGGAAAGGAGAAUAGGAAGGCUGCUA,32,30,33,23,118
1899,6,CP000800.1/865089-865233,AUAACCACUAAACACUCUAGCCUCUGCACCUGGGUCAACUGAUACGGUGCUUUGGCCGUGACAAUGCUCGUAAAGAUUGCCACCAGGGCGAAGGAAGAAAUGACUUCGCCUCCCGUAUCUGGAAAGGUGUACAUGGCUUCACAAC,40,32,34,39,145
1900,6,AM933173.1/847519-847663,AACCACAGUAAACACUCUAGCCUCUGCACCUGGGUCAUUUUUGAUACGGUGCUUUGGCCGUGACAACGUUUAACGUUUGCCACCAGGGCGCAGGAAGAAAUGACUCCGCCUCCCGUAUUUGGAAAGGUGUACAUGGCUUCACAAC,36,36,34,39,145
1901,6,CU928145.2/876431-876575,AUAACCACUAAACACUCUAGCCUCUGCACCUGGGUCAACUGAUACGGUGCUUUGGCCGUGACAAUGCUCGUAAAGAUUGCCACCAGGGCGAAGGAAGAAAUGACUUCGCCUCCCGUAUCUGGAAAGGUGUACAUGGCUUCACAAC,40,32,34,39,145
1902,6,CP000826.1/1451002-1451144,CUGAAACCAAAACUCCUAGCCUCUGGGCCUACGUUGUUCUUGUGAACAAUAUGGCGCUUGGGCCGUGGCGAAGUCAGCCACCAGGGUGCAGAGCGGAAACGCUCGCAUCUCCCGACUUUGGAAGGUGUUAUGGUGCCGCAACU,31,32,41,39,143
1903,6,AE006468.1/870506-870650,AACCACAGUAAACACUCUAGCCUCUGCACCUGGGUCAUUUUUGAUACGGUGCUUUGGCCGUGACAACGUUUAACGUUUGCCACCAGGGCGCAGGAAGAAAUGACUCCGCCUCCCGUAUUUGGAAAGGUGUACAUGGCUUCACAAC,36,36,34,39,145
1904,6,CP000853.1/2630463-2630586,AUAACUAAAUAUCUCCGAGUUCAUCGAUCCUAAUACCUGUUUUCGUAAUGGUCUAUGAGCCUGUAGGGUAUUGUGGGAAACUUCAAUGCCUCCCAUUGUGGAAAGGAGUACUAUGCAGAUCCCU,33,39,26,26,124
1905,6,CP000057.2/1827000-1826859,UUUAACGCAUAACUCCGAGCUUGUUUAGCCUAAGUUUCAGAAGAAAUACGGUGGCAAGCCAAUAACGCCGUGUGUUAUUCAGGGAUACGCUGGAAACGGUUUAUCCUCUCCAUAUUUAGAAAGGUGUAAAAUGCAAUCCAUU,43,41,30,28,142
1906,6,CP000927.1/4176112-4176249,CGAUGAAACUCGCUCCGAGCGUCCCGGCCUAACGCGCAUCCGCGCCAAGGCCGGGCCGCCGCGCCGGUACGCCGGCAAGGGUGACGGGGGAAACGCCGUCGCCUCCCUUGCUUGGAAAGGAGCCCGCAUGGGACGUCU,23,17,48,50,138
1907,6,ABDU01000042.2/353622-353816,AUUAGUAUAAAUCUCCAAGCUUAAAGAUCUAAGGAGAAGGUUCUAUGAUUUUUAAGCCUGGAUUACUAAAUUAUUUAACAUUAAGUUUAAUAAGAACUUAAAUUGUUAAUUAGUUUAAUUGGGGUAAUCCACAGGGUAAGGUUUGAAAGAAUUUUGCCUCCACGUAUUUUGGGAAGGAGAAUAAGCAAAAGUAAA,73,65,37,20,195
1908,6,CU928160.2/865804-865948,AUAACCACUAAACACUCUAGCCUCUGCACCUGGGUCAACUGAUACGGUGCUUUGGCCGUGACAAUGCUCGUAAAGAUUGCCACCAGGGCGAAGGAAGAAAUGACUUCGCCUCCCGUAUCUGGAAAGGUGUACAUGGCUUCACAAC,40,32,34,39,145
1909,6,AE004439.1/728600-728451,AUUAUCGCAUAACUCCGAGCUUAUUUAACCUACGUUUCUACAAUAGAAAUAAGGUGGUAAUGCCAAUAGCAUAAAACUUGUGCUAUUCAGGGAUACGCUGGAAACGGUUUAUCCUCUCGUAUUUUAGAAAGGUGUGACAUGCAAACAAUU,49,46,28,27,150
1910,6,CP000851.1/5004542-5004406,AGGUUGACGGUUCUCCGAGCUUCUUACCCUACGUCGAGACAGAUAAGGGUUUUUAGCCGUGGCAAUAACGCCACCGGGGUGAGAAAAGAAAUGAUCUCACCUCCCCUUACUUGGAAAGGUGAUCAUGUCCCAACUAC,36,33,33,35,137
1911,6,CP000891.1/327352-327485,CCGGUGACGGUUCUCCGAGCUUGCCUACCUAAGUCGAAAGAUAUGGAGGUGUAGCCGUGGUAAUAAUGCCACCGGGGUGGGAUAAGAAAUGCUCUCACCUCCCACACUUGGAAAGGUGAUCAUGUCUCAAUUAC,34,32,36,32,134
1912,6,CP000923.1/1425277-1425394,UUAUUACUUAUUCUCCGAGUCUAUAAUCCUAAGGCAAGAGCUAUGGAUUAUAGGCCGAUAGGGUAGUGCUGGAAACGGUGCUGCCUCCCGCCUGGAAAGGAGAAUAGGAAGGCUGCUA,32,30,33,23,118
1913,6,CP000857.1/847673-847817,AACCACAGUAAACACUCUAGCCUCUGCACCUGGGUCAUUUUUGAUAUGGUGCUUUGGCCGUGACAACGUUUAACGUUUGCCACCAGGGCGCAGGAAGAAAUGACUCCGCCUCCCGUAUUUGGAAAGGUGUACAUGGCUUCACAAC,36,37,34,38,145
1914,6,AP009240.1/898974-899118,AUAACCACUAAACACUCUAGCCUCUGCACCUGGGUCAACUGAUACGGUGCUUUGGCCGUGACAAUGCUCGUAAAGAUUGCCACCAGGGCGAAGGAAGAAAUGACUUCGCCUCCCGUAUCUGGAAAGGUGUACAUGGCUUCACAAC,40,32,34,39,145
1915,6,CP000879.1/408780-408659,AUUUUAUAAUGUCUUCGAUCUAGGUUACCUACGGAAUUCAUUCUAUGGUGACUUAGACGAUAGGGUAUAGAAGGAAACUUCUAUGCCUCCCGCAUUAGGAAAGGAGACACAUUAUGAACCGG,37,36,27,22,122
1916,6,CP000020.2/1036399-1036547,UGGCUGCCAUAACUCCGAGCUCAAGCUACUAAGUUGUUUUUUAAGAAGCACUCAAUAUGUAGCGUGAGCCAGUGACAAUUCGGUCACAAGGGUUUGUUUGGAAAUGAACAAGCCUCCCGUGUUUGGAAAGGUGUUCCGUGGCGCAACAA,40,40,38,31,149
1917,6,AE016795.3/3156082-3155932,GGGUUGCCAUAACUCCGAGCUUAACUUGCUAAGUUAUUUUAUUUCAAUGAUGGAAUGAUAAGCAGCUUAAGCCAGUGACAUGAUGUCACAAGGGCGUAAUUGGAAAUGACUACGCCUCCCGUGUUUGGAAAGGUGUUCCGUGGCGCAACAA,42,42,38,29,151
1918,6,AALD02000070.1/3698-3534,ACUGAACAUAAACUCCUAGCCUUGGUGCCUACGUUGUCCCGAGCCGCGAAUAUGCGUUUCGUUUAUGGACAAUAGGGUGCUCUGGCCGUGGCUUUAAGCCACCAGGGUGCGAGGUAGAAAUGCCUGCAUCUCCCGUAUUUGGAAAGGUGUUAUGGUACAACUGAC,37,44,45,39,165
1919,6,AAKH03000004.1/5826-5965,GCUUGGCCUUAACUCCGAGCUUACCGCGCUAAGUUUAAACCUUUAAAUAUGCGUUGUAAGCCAGUGACCGCUUGUCACAAGGGCAGAAUUGGAAAUAAUUUUGCCUCCCGUAUUUGGAAAGGUGUUCUGUGGCGCAACAA,36,40,33,31,140
1920,6,AALC02000040.1/35583-35747,ACUGAACAUAAACUCCUAGCCUUGGUGUCUACGUUGUCCGGUGUCGCGAAUACGUUUUUCGUUUACCGGCAAUAUGAUGCUCUGGCCGUGGCUUUAAGCCACCAGGGUGCGAGGUAGAAAUGCCUGCAUCUCCCGUAUUUGGAAAGGUGUUAUGGUACAACUUAC,36,49,42,38,165
1921,6,ACSL01000009.1/10801-10941,UUUAACGCAUAACUCCGAGCUUGUUUAGCCUAAGUUUCAUCGAAAUACGGCGACAAGCCAAUAACGCCGUGUGUUAUUCAGGGAUACGCUGGAAACGGUUUAUCCUCUCCAUAUUUAGAAAGGUGUAAAAUGCAAUCCAUU,42,41,28,30,141
1922,6,AALF02000023.1/11913-12057,ACUGAACAUAAACUCCUAGCCUUGGCGUCUACGUUGUCUCGUUCGCGAACAAUAUGAUGCUCUGGCCGUGGCUUUAAGCCACCAGGGUGCGAGGUAGAAAUGCCUGCAUCUCCCGUAUUUGGAAAGGUGUUAUGGUACAACUCAC,34,39,36,36,145
1923,6,AALE02000011.1/37751-37896,ACUGAACAUAAACUCCUAGCCUUAGUGUCUACGUUGUUGUGUUUUUCUAACAAUAUGAUGCUCUGGCCGUGGCUUUAAGCCACCAGGGUGCGAGGUAGAAAUGCCUGCAUCUCCCGUAUUUGGAAAGGUGUUAUGGUACAACUGAC,35,45,35,31,146
1924,6,AP008230.1/4378234-4378102,AAUUGAAUAGUUUUCCGAGCUCCUUUGUCUAAAAGACUAUCUCAUGACGGAGGAGCCUGAGCAAACCGCUCACGGGGUCAGUCAGGAAACCAGCUGGCCUUCACUGAUGAAAAGGAAGCAGAAAAUACAGGAU,43,28,33,29,133
1925,6,CP000886.1/2253727-2253583,AACCACAGUAAACACUCUAGCCUCUGCACCUGGGUCAUUUUUGAUACGGUGCUUUGGCCGUGACAACGUUUAACGUUUGCCACCAGGGCGCAGGAAGAAAUGACUCCGCCUCCCGUAUUUGGAAAGGUGUACAUGGCUUCACAAC,36,36,34,39,145
1926,6,CP000821.1/5381607-5381473,GCCCUGACGGUUCUCCGAGCUUUUUGUCCUACGUCAACAGAUACGGACGCUAAGCCGUGGCAAUAACGCCACCGGGGUGUGAACAGAAAUGCUCUCACCUCCCCUUACUUGGAAAGGUGAUCAUGUCUCAACUAC,32,32,31,40,135
1927,6,CP000034.1/768837-768693,UUAACCACUAAACACUCUAGCCUCUGCACCUAGGUCAACUGAUACGGUGCUUUGGCCGUGACAAUGCUCGUAAAGAUUGCCACCAGGGCGAAGGAAGAAAUGACUUCGCCUCCCGUAUCUGGAAAGGUGUACAUGGCUUCACAAC,40,33,33,39,145
1928,6,CP000436.1/881170-881033,AAAAACUGACGACUCCGAGCUUGUUGACCUAAGUUGCAAAAUAAGGUUGCAAGCCUGUAACAUUGUCAAAUGUUGCACAUGGUACAACUAGAAAUGGUUGUGCCACUCCCUUUAGAAAGGUGUCGAAAAUAAAACUUU,47,37,28,26,138
1929,7,BX571871.1/238808-238637,GCAGUAUCUCGUUAGGCGAGGCUCCUAUACAAACACAGGUUGCUGAUCUGACGACGUCGAGAGACGCCCAAGAUUAGGACAGGAUAUAUCGAACCAAGGUAUAUCCCCAUGUAACUUUCUGAUAAUUCAGGAUACGUUGUAUAGUGCUAAAACCGAGACGUAGAGAUAGUCG,53,41,42,36,172
1930,7,AY129558.1/14501-14670,GCAACAUCUCGUUAGGCGAGGCUCCUGUAUAAACAAAGGCCACUGAUCUCACGACGUCGAGAGACGCCCAAGCUCAGGACAGUUUUCAUCGGAUUAAGGUGUAAACCCAAGUGGCUUCCGGCAUGCCGGAUACGUUAUACAGUGCUAAAGCUGGUACGUGGGGAUGAUGA,46,37,47,40,170
1931,7,BX842577.1/4252-4421,UAAGCACCUCGUUAGGUGAGGCGGCUACACGAACAUAGGCCACUGACCCCGAACGUCGAGAGACGCCCCGGGUCAGGACAGCUCUUCCCGGCUUAAGGGUUGAGCCCAGGUGGCUUCCGGCUUACCGGACACGUCGUGUGGUGCCGAAGCUCUGACGAGAGGGGUGCGGA,34,29,58,49,170
1932,7,X90691.1/1632-1461,GCAGUAUCUCGUUAGGCGAGGCUCCUAUACAAACAAAGGUUGCUGAUCUGACGACGUCGAGAGACGCCCAAGAUUAGGACAGGUUAUAUCGAACAGAAGGUAUAACCCGAAGUAACUUCCCGCAGUCUGCGGGAUACGUUGUAUAGUGCUAAACCGAGACGUGAGAUAGCCU,51,37,46,38,172
1933,7,AL596173.1/245334-245167,AGUUUUGCCUGUUAGGUGAGGCUCCUAUGCAAACACAGGCCACUGCCCAAAAAUGUCCAAAGACGCCAAUGGGUAGAACAGGGAUUGUCGGAUUAAGGCUUUCCAUAAUGUGGCUAAGAGUAAUUCUUUACGUUGUAUAGUGCCAAAACUUUAGCGAGGGGAGUCUGU,47,45,44,32,168
1934,7,AL035300.1/11215-11044,CAAGCACCUCGGUAGGUGAGGCUUCUGCAUGGAUAUAGGCCACCGAUCCCGGACGUCGAGAGAUGCAUCGGGUCAAGACAACUCCCAGGGUUGGGUCCAAGUCCAAGUGGUUUCUGGACGUUGGUCCAGAUAUGCUGUGCAGUGCCUAAGCUCCGGCGAUGAGGGGAUGCGU,36,37,57,42,172
1935,7,AL591984.1/47104-46938,AGUUUUGCCUGUUAGGUGAGGCUCCUAUGCAAACACAGGCCACUGCCCAAAAAUGUCCAAAGACGCCAAUGGGUAGAACAGGGAUUGUCGGAUUAAGGCUUUCCAUAAUGUGGCUAAGAGUAUUCUUUACGUUGCAUAGUGCCAAAACUUUAGCGAGGGGAGUCUGU,46,44,44,33,167
1936,7,AJ250603.1/195-363,UAAUAACCUUGUUAGGUGAGGCUCCUAUACAAACAUAGGCUAUUGCCCAGAAACGUCGAAAGUCGCCAAUGGGUAAAACAGAAACUGUCGGAUUAAGGCUUUUUCCAAUAGCUAAGAAUGUUUUCUUUACGUUGUAUAGUGCUAAAACUCGGACGAUGAGAUGAUGCUA,54,48,37,30,169
1937,7,AB089921.1/2048-2202,AUGGAAAAUCGGUAGGUGAGGCUUACCAUAAGGAUACGGAUGACUACCGCAAAGCAGUGGAGACACUACUCGUUGGUCAACAGUCCUGAUCGCCAAGGUCAAGACUAUGCUCAUUUCAUUGCCUUAUGGAGUUAAAGCUUGAACGGUAAAUACUU,47,39,38,31,155
1938,7,AL583922.1/170727-170556,CAAGUGCCUCGUUAGGUGAGGGUUCUGCACGGAUAUAGGCCACUGACGUCGAACGAUGCCCAGGAGCAGGACAGUUCCUCCCAGAUUAAGGAGUUUGAGCCUAAAUUGUUUCCGGCUCUCAUUGAGCUGUACAUGUCGUUUGGUGCCAAAGCUCUGACGAUAGGGAGGCCGU,38,43,51,40,172
1939,7,AF031552.1/1396-1226,ACAGCAUCUCGUUAGGCGAGGCUCCUGUACAAACAUAGGCCACUGAUCUCACGACAUCCAGAGAUGCCCAAGAUCAGGACAGUUUUCAUCGGAUUAAGGUGUUAACCCAAGUGGCUUUCGCGUGAGCGAAUACGUUGUGCAGUGCUGAAGCUGGGACUCGGGGAAUGAAGU,45,39,48,39,171
1940,7,AF117609.1/346-514,UAAUAACCUUGUUAGGUGAGGCUCCUAUACAAACAUAGGCUGUUGCCCAGAAACGUCGAAAGUCGCCAAUGGGUAAAACAGAAACUGUCGGAUUAAGGCUUUUUCCAAUAGCUAAGAAUGUUUUCUUUACGUUGUAUAGUGCUAAAACUCGGACGAUGAGAUGAUGCUA,53,48,38,30,169
1941,7,AAFX01011285.1/689-521,AAUAAAGCUUGUUAGGUGAGGUUACUGGUUGAACAGAGGCUGCUGCCCGGAAAUGUCGAAAGACACCAAUGGGUAGAGCAGGCGUAGUCGGAUUAAGGCUUCGCAUAAGGCAGCUUUCCGGAAUCCGGAAUAAGUCAACCUGAACUAAAACUCUACGAGGAGCUUCAUG,51,37,48,33,169
1942,7,AE017194.1/1660591-1660756,AUAAGUCUCUGUUAGGUGAGGCUCCUGUAUAGAGAAAUGCUACUGCCCAAAAAUGUCGAGAGACGCCAAUGGGUCAACAGGAAUGAUCGAAUUAAGGUUUUUCUUAACGUAGCUGGUAAUGUACCUAUGCUAUACAGUGCUAAAACUCGGCGAGGGAGAGGUCCGU,49,43,44,30,166
1943,7,CP000717.1/2055847-2056021,CAAGCACCUCGCUAGGUGAGGCGUCUGCGCGGAUAUAGGCCACUGACCUCGAACGUCGAAAGACGCCCAGGGUCAGGACAGCUCUUCCCGGCUUAAGGGUUGAGCCCAAGUGGCUUCCGGCUGGACCGGCCGGAUACGCCGUGUGGUGCCAAAGCUCUGACGAGAGGGGUGCCGA,35,29,60,51,175
1944,7,CP000412.1/281461-281624,CAAAUGAACUGUUAGGUGAGACUCCUACGUGAACACACGCUAUCGCCCAGAAACAUCCAGAGAUGCCAACGGGUUAAAUAGAAAUUGUCGAAAUAAGGCACUUUCCAGGUAGCUAGCAUGUGCUUACGUCACGUAGUGUUAAAGCUGAGCGAUUAGUCAAUAGC,53,38,38,35,164
1945,7,AE016822.1/2178766-2178596,AGAGCACUUCGUUAGGUGAGGCUCCUGCGUGAACACAGGCCACUGAUCUGACGACGUCGAGAGAUGCCCAAGAUCAGGACAGGUCUCCCCGGCCUAAGGGGUGACCCCAGGUGGCUUCCCGCCCGGCGGGACACGUCGCGCAGUGCCGAAACUCUUACGUGGAAGUGCCGA,36,28,55,52,171
1946,7,CP000416.1/2122885-2122722,AUAAAUUGCAAUUAGGUGAGGUUACUUUAAGAACAUAGGUUGUUGCCCAGAAAUGUCGAGAGACAGGAAUGAGUAAAGCAGAAACUGCCGAAUUAAGGCUUUUUCAAAACAACUAGACUAGUUCUUACGUCUUAAAGUGCUAAAACUCAAUGAAUGCGUCGAUA,60,44,35,25,164
1947,7,CP000728.1/236297-236462,UAAUAAUGUACGUUAGGUGAGGCUCCUAUAUAGAUAUACGCUACUGCCCGGAAACAUCGAGAGAUGCCAAUGGGUCACCAGGUAUUACCGAAGUAAGGUUUUACUUAAUGUAGCUGGCUGUGGUCCAAAGCUAUAUAGUGCUAAAACUCAACGAUUGAUGUUAAAG,52,46,39,29,166
1948,7,AASN01000027.1/80343-80511,UAAGCACCUCGUUAGGUGAGGCGGCUACACGAACAUAGGCCACUGACCCCGAACGUCGAGAGACGCCCCGGGUCAGGACAGCUCUUCCCGGCUUAAGGGUUGAGCCCAGGUGGCUUCCGGCUUACCGGACAGGUCGUGUGGUGCGAAAGCCUGACAGAAGGGGUCGGUU,35,30,57,47,169
1949,7,AE016830.1/3116366-3116533,AAAUAACCUUGUUAGGUGAGGCUCCUAUCCAAACAUAGGCUAUUGCGCAGAAAUGUCGAAAGACACCAAUGUGUAAAACAGGAAUGGUCGAAUUAAGGCUCUUCUAAAAAUAGCUAAGAGAAAUCUUUACGUUGGAUAGUGCUAAAGCUCAGACGAUGAGAACCGAUU,61,41,37,29,168
1950,7,CP000482.1/1208117-1207951,GUCGUUCCUCGUUAGAAUGAGGCGUUUGCACAAACACAGGCUGCUACCCAGAAACGUCGAAAGACGCCAAUGCGGUCAACAGGUUCUGCCGGAUUAAGGCUUAACCUAAUGCAGCUGGCCCCAGGCCUACGUUGUGCUCUGCCAAAAUCCAACCAGAGGGGAAUUGG,44,34,44,45,167
1951,7,ABDV01000005.1/84537-84695,AAUAUUAAUCGGUAGGUGAGGUUACCACCGGGAUACGGAUUGCUGCCGCAAAAUAGUGGAGACACUAUGAGAAGGUUAGCAGGCUAUGUCGAGAAACAAGGCAUAAUCUAAUGCAAUUUCAUUGCCCAGUGAAGCUAAAACUUGAACGAUAUUAUACUU,54,40,38,27,159
1952,7,AARF01000169.1/465-629,GCUAGUCUCCGUUAGGUGAGGCUCCUGUAUAGAGAAAUGCUACUGCCCAAAAAUGUCGAGAGACGCCAAUGGGUCAACAGGAAUGGUCGAAAAGAAGGCCCCUCUUAAUGUAGCUGGUUUUAAACCUAUGCUGUACAGUGCUAAAACUCAACGAAGGAGAGGUUA,51,38,43,33,165
1953,7,BA000004.3/3341002-3340838,AGUUGUCUUCGUUAGGUGAGGCUCCUGUGCUGGAGAUACGCUGCUGCCCAAAAACGUCCAAAGACGCCAAUGGGUCAACAGAAAUCAUCGACAUAAGGUGAUUUUUAAUGUAGCUGGAUGAUUCCUAUGCCGCACAGUGCUAAAGCUCUACGAAUGGGGGACAGU,45,41,44,35,165
1954,7,CP000673.1/3641499-3641330,UUUUUGUUAUGUUAGGUGAGGCUCCUAUAUAGAUAUAUGCUACUGCCCGGAAACAUCGAGAGAUGCCAAUGGGUCAACAGGUAUUACCGAAUUAAGGUUUUACUUAAUGUAGCUGGACAAAAUUUAGUCUAAAGCUAUAUAGUGCUAAAACUCAGACGAUUUAAAAGUUU,55,55,35,25,170
1955,7,AAAK03000021.1/12650-12476,AAUAAGAUUUGUUAGGUGAGGCUCCUAUACAAACAUAGGCUACUGCCCAAAAACGUCGAGAGACGCCAAUGGGUAGAACAGGAAUUGUCGAGAUAAGGCUUUUCAUAAGGUAGCUAAAAGCAGGUAUCUGCUUUUUACGUUGUACAGUGUCAAAACUCAACGAUGAGAUCUGAGA,59,44,42,30,175
1956,7,ABDQ01000001.1/467807-467647,UAAGUACCUCGGUAGGUGAGGUUACUACAAGGAUACGGGUUGCUACCGUGAAAGAGUGGAAACAUUCUAAACAGGUUAGCAGGUUUUGCCGAACAAAGAAGGCUUAAUCUAAUGCAACUACAUUGCCUUGCAGAGCCAAAACUUGAACGAGAAAGUAUAGA,56,37,40,28,161
1957,7,BA000004.3/2041941-2042105,AAUCAUCCUCGUUAGGUGAGGCUCCUGUGCUGGAGAUACGCUGCUGCCCAAAAACGUCCAAAGACGCCAAUGGGUCAACAGAAACCAUCGACAUAAGGUGGUUUUUAACGUAGCUGGCUUCGUCCUAUGCCGCACAGUGCUAAAGCUCUACGAAUGGAGGAGUUU,44,39,42,40,165
1958,7,AAWL01000016.1/43438-43265,GUACUUCCUCGUUAGGUGAGGCUCCUGUAUAAACAUAGGCCACUGCCCGGAAAUGUCGAGAGACGCCAAUGGGUAGAACAGGUAUUACCGGCAUAAGGUUUUACUUAAGGUGGCUGAGCAUUUUGUUUGACUCUACGUUAUACAGUGCCAAAGCUCAAACGAGUGGGGAGGUUA,46,46,48,34,174
1959,7,CP000480.1/5735476-5735649,ACCGCGCUUCGUUAGGUGAGGCUCCUACACGAACACAGGCCACUGAUCCGACGACGUCGAGAGACGCCCAGGGUUAGGACAGAUCUUCCCGGCCUAAGGGAUGAUCCGAAGUGGCUUCCCACCUCAAGGUGGGACACGUCGUGCAGUGCCAAAGCUCUGAUGAGGAAGUGCUCG,40,31,53,50,174
1960,7,AP009389.1/428061-428228,UAUGUUCUUCGUUAGGUGAGGCUUCUACACAGACAUAUGCCACUGCCCGGAAAUGUCGAGAGACGCCUACGGGUUAACAGGUACUGCCGGAUUAAGGUUUUACUUAAUGUGGCUGGGAUCUUUUCCCUAGCUGUGUAUGUGUCAAAGCUUUGACGAGUGGAGAAGGUU,38,51,47,32,168
1961,7,CP000679.1/1386114-1386270,GAAAUAUCUCGGUAGGCGAGGCUCCUACAGGGAUAUAGGCUGCUGCCGCGAAAGAUUGGAGACAAUCUGAGCUGGUAAACAGGUUUUGCCGAAUCCAAGGCAUAACCUAAUGCAGCUUUUUAUGCCGUGUAGUGCCAAAGCUUGUACGAGGUAGCUA,43,38,44,32,157
1962,7,AE016958.1/3916507-3916677,CAAGCACCUCGGUAGGUGAGGCGUCUGCAUGGAUACAGGCCACUGACCCCGAACGUCGAGAGACGCCCCGGGUCAGGACAGCUCUUCCCGGACCCAAGGGUUGAGCCCAAGUGGCUUCCGGAGCCCCGGAUACGCCGUGCAGUGCCGAAGCUCCGACGAGAGGGGUGCGAC,35,23,58,55,171
1963,7,CP000647.1/4212343-4212524,UAACGAUCUCGUUAUGGCGAGGCUCCUGCAUAAAUACAAGUUACCGCCCUGUUGGUAUCGAGAGAGACCACUCAGGGAAAUACAGGCUUCCAUCGAAUCAAGGUGUUGCCAAGGUAACUUCUGGCGGUCAUGACCGUUCAGAUACGUUAUGCAGUGCUAAAACCAGGACGUAGGGAUCUGCC,49,43,47,43,182
1964,7,CP000568.1/2645160-2644994,GAAUAUUUUUGUUAGGUGAGGCUCCUAUACAGAAAGACGCUGCUGCCCGGAAACGUCGAAAGACGCCAAUGGGUAAACAGGCACUACCGGAUUAAGGUUUUGCUUAAUGCAGCUGGUGUUGCAGCCUAAGCUGUAUAGUGCCAAAGCUCAACGAGGGAAAGAUAUAA,51,39,45,32,167
1965,7,AE017198.1/1073421-1073588,CAAAUAAACUGUUAGGUGAGACUCCUACGUAAAUAUAUGCUGAUGCCCAGGAACAUCCAGAGAUGCCAACGGGUCAAACAGGAACUGUCGAGUUAAGUCUUUUCCCAGUCAGCUAGUUGAAAAAACUUUACGUUACGUAGUGUUAAAACUGAACGACGAGUAUUAAAU,58,43,35,32,168
1966,7,CP000413.1/234944-235115,CAAAUAAACUGUUAGGUGAGACUCCUACGUGAACAUAUGCUGUCGCCCAGCAACAUCCAGAGAUGCCAACGGGUCAAACAGGGAUCGUCGAUAUAAGGCCCUCCCCAGCCAGCUAGUUAUUUUUAAUAACCUUACGUCACGUAGUGUUAAAACUGAACGACGAGUAUAAAAA,57,39,35,41,172
1967,7,AE016958.1/1663674-1663849,CAAGCACCUCGCUAGGUGAGGCGUCUGCACGGACACAGGCCACUGACCUCGAACGUCGAAAGACGCCCAGGGUCAGGACAGCUCCUCCCGGAUUAAGGGUUGAGCCCAAGUGGCUUCCGGCUUUUGACGGCCGGAUACGCCGUGUGGUGCCGAAGCUCUGACGAGAGGGGUGCCGC,35,29,59,53,176
1968,7,CP000325.1/5326076-5325906,CAAGCACCUCGGUAGGCGAGGCGUCUGCAUGGAUACAGGCCACUGACCCCGAACGUCGAGAGACGCCCCGGGUCAGGACAGCUCUUCCCGGCCUAAGGGUUGAGCCCAAGUGGCUUCCGGAUAGUCCGGAUACGCCGUGCAGUGCCGAAGCUCCCACGAGAGGGGUGCGUU,34,27,57,53,171
1969,7,AE016830.1/1024864-1024697,UUUGUAAUAAGUUAGGUGAGGCUCCUAUACAAACAUAGGCUAUUGCUCAGAAAUGUCGAGAGACACCAAUGAGUAGAACAAGACUGGUCGAGGAGAAGGCUUUUCUCAAAAUAGCUAAGAGUGAUCUUUACGUUGUAUAGUGCUAAAGCUCAACGUUCAUGUUGAUGU,54,48,40,26,168
1970,7,CP000724.1/3301490-3301319,AAAAUAACUUGUUAGGAGAGGCUCCUAAAUGAACACAGGCUAUUGCCCAAAAAUGUCGAGAGACGCCAAUGGGUAGAACAGGCAUGAUCGGAUUAAGGUCUGCUUAAGAUAGCUGAUUCAAUUACUUGAAUCUACGUCAUUUAGUGCUAAAACCAGUACGAGGAGUUAAUAG,60,43,40,29,172
1971,7,AP006627.1/810916-810751,UAUAUUCCUCGUUAGGUGAGGCUCCUGUGCAGGAGAUACGCUGCUACCCAAAAAUGUCCAAAGACGCCAAUGGGUCAACAGAAACCAUCGACAUAAGGUGGUUUUUAAUGUAGCUGGCAAUAGCCUAUGCCGCACAGUGCUAAAGCUCUACGAAUGGAGGCUAUUU,48,41,40,37,166
1972,7,CP000423.1/1285762-1285925,GGUGCUUUCCGUUAGGUGAGGCUCCUAUACGAACAAUGCUGCUGCUCAGAAACAUCGAGAGAUGCCAAUUGAGUCAACUGCGUCUGCCCAUUAAGGCUUACGCUAAUGCAGCUGAAGCUCGCUUCUAGGCGUAUAGUGCUAAAACUAAACGAUUGGGAUGCUUU,42,44,41,37,164
1973,7,CP000544.1/1425650-1425831,AGCGAGUCCCGUUAGGUGAGGCUCCUGUGCCGACAAGGUGUGCUGCCCAGAAAUGUCGAGAGACGCCAAUGGGUUGAACAGGCCCUGCCGAACGAAGGCUUGGUCUAAUGCACACCGCGGCCCGCGCCCUGCGCGCGGCCUUUGAGUCGCACAGUGCCGAAGCUCUACGAAGGGGACUUGGU,36,32,61,53,182
1974,7,CP000141.1/329676-329842,UAUUUUCUUCGUUAGGUGAGGCUACUUCCUGGAUAUAGGCUACUGCCCGGAAAUGUCGAGAGACACCAACGGGUAAACAGGUAUUACCGGCUUAAGGUUUUACCUAAUGUAGCUGAGGGUUUCCUCUAAGCCAGGUUGAGCUAAAGCUUUGACGAGUGGAGAAGGUU,42,48,46,31,167
1975,7,CP000413.1/962812-962978,CAAAUGAACUGUUAGGUGAGACUCCUACGUAAAUAUACGCUGAUGCCCAGCAACAUCUAGAGAUGCCAACGGGUUAAACAGGAAUUGUCAACUUAAGGCUUUUCCCAGUCAGCUAGUUAAAAAACUUCACGUUACGUAGUGUUAAAACUGAACGACGAGUAUAAAUC,58,42,33,34,167
1976,7,AE017198.1/231904-232076,CAAAUAAACUGUUAGGUGAGACUCCUACGUGAACACAUGCUGUCGCCCAGCAACAUCCAGAGAUGCCAACGGGUCAAACAGGGAUCGUCGAUAUAAGGCCCUCCCCAGCCAGCUAGUUAUAUUUUUAUAACCUUACGUCACGUAGUGUUAAAACUGAACGACGAGUAUAAAAA,57,39,35,42,173
1977,7,AAXV01000059.1/1758-1594,GACUCCCUUCGUUAGGUGAGGCUCCUAUGUGGAGAUACGCUACUACCCAAAAAUGUCGAGAGACGCCAAUGGGUCAACAGAAAUCAUCGAAAUAAGGUGUUUUUUAACGUAGCUGGAUAAUUUCCUAUGCCGCAUAGUGCUAAAACUCAACGUUUGAAGGUAACA,51,43,37,34,165
1978,7,CR936503.1/1082354-1082189,UCGCUUUUCCGUUAGGUGAGGCUCCUAUAUGAACAUACGCUGCUACUCAGAAACAUCGAGAGAUGCCAAUUGAGUCAACAAAAACUGCCAAUGAAGGCUUUUUCUAACGUAGCUGAACAUGGUUUCUACGUCAUAUAGUGCUAAAACUGAACGAUUGGGAACGCCA,51,44,35,36,166
1979,7,CP000232.1/409831-409996,GCAAACCUUCGUUAGGUGAGGCUUCUGCAUAGACAGACGCCACUGCCCGGAAACGUCGAAAGACGCCAAUGGGUCAACAGGUAUUACCGGCUUAAGGUUUUACCUAAUGUGGCUGAGAAAAUUCUCUAGCUAUGCACGUGCCAAAGCUCAACGAGUGGGGGUUAAU,46,38,44,38,166
1980,7,BA000004.3/3340549-3340386,CAACCACUUCGUUAGGUGAGGCUCCUGUAUGGAGAUAUGCUGCUGCCCAAAAACGUCCAAAGACGCCAAUGGGUCAACAGAAAUCAUCGACAUAAGGUGAUUUUUAAUGUAGCUGGCAAUGUCCUAUGCCAUACAGUGCUAAAGCUCUACGAAUGAAGGGAAUC,51,39,38,36,164
1981,7,AE001437.1/789407-789580,AAAAGUUUUAGUUAGGUGAGGCUCCUAUAUAGAUAUACGCUACUGCCCAGAAACAUCGAGAGAUGCCAAAUUGGGUCAGCAGAUAUUACCGAAUCAAGGUUCUAUCUAAUGUAGCUGGAUUUAUAGUUUUAAUCUAAGCUAUAUAGUGCUAAAGCUCUACUGUCUAAUUUCGUA,55,56,34,29,174
1982,7,CP000479.1/3338383-3338199,UAAGCACCUCGUUAGGUGAGGCGUCUACACGAAUACAGGCCACUGACCCCGAACGUCGAAAGACGCCCCGGGUCAGGACAGCUCCUCCCGGCUUAAGGGUUGAGCCCAGGUGGCUUCCGGCUCGGAUUGUCGUUCGGGCCAGGACACGUCGUGUGGUGUCAAAGCUCUGACGAGAGGGGUGCGGA,37,34,62,52,185
1983,7,AE001437.1/3501846-3501683,AUAAUGUAUUGUUAGGUGAGGCUCCUAUAUAGAUAUAUGCUACUGCCCAAAAAUAUCGAAAGAUGCCAAUGGGUUAACAGGUACUACCGAAUUAAGGUUUUACUUAAUGUAGCUGGGAUUACCCAAAGCUAUAUAGUGCUAAAGCUCAACGAAAGAUAGUGUAU,57,48,34,25,164
1984,7,AAJM01000138.1/1999-1823,UGCUGAACCUGUUAGGUGAGGCUCCUAUACAAACACAGGCUAUUGCCCAAAAAUGUCGAAAGACGCCAAUGGGUAGAACAGGAAUUGUCGGGUUAAGGCUCUUCUUAAGAUAGCUAAGUGAUGAAUUUUCAUUACUUUACGUUGUAUAGUGCCAAAGCUCUACUAGGGGGAAAAGCC,54,47,43,33,177
1985,7,AE016830.1/1027779-1027612,AUAGAAUCAUAUUAGGUGAGGUUACUCUGAAGAACACAGGUUAUCGCUCGGAAAUGUCGAGAGACAGUAACGAGUAAAGCAGGGAUUGUCGAAUUAAGGCUUUCCUAAGAUAACUAGAAUUUUUUUCUUACGUCUCAGAAAGCCAAAGCUCAAUUAUUGUGAUUACCC,56,48,36,28,168
1986,7,AE016830.1/1323290-1323457,CUGAAUAAUUGUUAGGUGAGGCUCCUAUUUGGACAAAUGCUGCUGCCGCGAAAGGAUCGAGAGACCCUUAGUUGGUUGAACAGGAAUAAUCGUGAAGGUUAUUCAUAAUGUAGCUGAUACAUGUUAUCUACGCCCUAUAGUGCUAAAGCUCAACGAUAGAGAAUCUUA,51,48,40,29,168
1987,7,CP000325.1/3411572-3411396,CAAGCACUUCGCUAGGUGAGGCGUCUGGACGGAUACAGGCCACUGACCUCGAACGUCGAAAGACGCCACCGGGUCAGGACAGCUCUUCCCGGCUUAAGGGUUGAGCCCAAGUGGCUUCCGGCUUGAAAGCGUCGGAUACGCCGUGUGGUGCCAAAGCUCUGACGAGAGGGGUGCCGC,37,31,59,50,177
1988,7,CP000721.1/3911114-3911286,UAAAAACUUUGUUAGGUGAGGCUCCUAUAUAGAUACAUGCUGCUGCCCGGAAACGUCGAGAGACGCCAAUGGGUCAACAGGUAUUGCCGGAUUAAGGUUCUACUUAAUGUAGCCGAAAACCAUAUGGUUUUCUAUGCUCUAUAGUGCUAAAACUCAACGAGUGAAGGUUAAUA,53,48,40,32,173
1989,7,AE017333.1/1420164-1420328,ACAGCUCUUCGUUAGGUGAGGCUCCUGUAUGGAGAUACGCUGCUGCCCAAAAAUGUCCAAAGACGCCAAUGGGUCAACAGAAAUCAUCGAUCUAAGGUGAUUUUUAAUGCAGCUGGCAUGCUGCCUAUGCCAUACAGUGCUAAAGCUCUACGAUGGAAGGCGUUA,46,41,41,37,165
1990,7,CP000698.1/2388949-2388777,GUAAUUCCUCGUUAGGAAGAGGCGUUUGCACAAACAAAAGCUACUGCCCAGAAACGUCGAAAGACGCCAAUGCGGUAGACCAGGUUUAGUCGGAUUAAGGCUUUAUCUAAUGUAGCUGGUUGUCAUUUUCGACCUACGUUGUGCACUGCUGAAACUCAAACCAGGGGAAAGUC,50,43,43,37,173
1991,7,CP000686.1/5712317-5712483,GUUGCUCCCUGGUAGGCGCGGCUUCACACAAACACAGGUUACUGCUCCGGCCCGUCGAAAGACGCUCAGGGGCGCACAGCAGGCUCGGCUUAAGGGCUUUGCCAAGGUAACUACGGUUCAACCGUUACGUUGUGUGAAAGCUUAAGAUCAACCGGAGGGGGAGCGUU,37,34,52,44,167
1992,7,CP000416.1/93409-93243,AAUAGAAGCUGUUAGGUGAGGCUCCUAUGCGGAAAAUGCUACUGCUCAGAAACGUCGAGAAACGCCAAUGAGUCAGCUGUUCAGGUCAAUCGAAGGCCUGAUCUAACGUAGCUGUUAAGUGAUUAACUACGCCGUAUAGUGCUAAAACUCAACGACUAGCUAGACAC,53,38,40,36,167
1993,7,CP000612.1/2523319-2523491,CAUUUUCUUCGUUAGGUGAGGCUUCUACAUAGACAGAUGCCACUGCCCGGAAAUGUCGAGAGACUCUAACGGGUUAACAGGUAUUACCGGAUUAAGGUUUUACCUAAUGUGGCUGGGACAUUCCCAAUGCCCUAGCUAUGUAUGUGCUAAAGCUUGUACGAGUGGGGAGGCCA,43,48,46,36,173
1994,7,CP000478.1/2034435-2034257,UCGAUCCUCAGGUAGGUGAGGCUCCCGUGUGACACACAGGCCGCUGCCCAGAAGUAUCCAAAGAUACGGCGCAACAGGGUAGAACAGGCACUCCCGGAUUAAGGGUUUGCCUAAGGCGGCUGAGGCGAUAAGCGUCUCUUACGGUGCACGGUGCUGAAGCUUGAACGAGUGGGGGAAUC,43,33,59,44,179
1995,7,CP000478.1/2956592-2956762,AAAAUUCCUCGUUAGCAUGAGGCGUUUGCACAAACACAGGCUGCUGCCCAGAAAUGUCGAAAGACGCCAAUGGGUAGACAAGGUAUGGUCGGCAUAAGGCUUUACCCGAGGUAGCUGGUUCUUCGAAAACCUACGUUGUGCACUGCCGAAAGUCUACGAGUGGGGAAAUGA,49,37,48,37,171
1996,7,AACY022501423.1/463-646,UACCGAUCUCGUUAUGGCGAGGCUCCUGUACAAAUACAAGUUACCGCCCUGCUGGUAUCGAGAGAGACCACUCAGGGAAAUACAGGCAUCCAUCGAAUCAAGGUGUUGCCAAGGUAACUUCUGACGAUUUCACCAUCGGACAGAUACGUUGUUCAGUGCUAAAACCAGGACGUAGGGAUCUGCC,51,42,45,46,184
1997,7,AP008232.1/1074084-1073916,GCAGUAUCUCGUUUGGCGAGGCUCCUAUACAAAUACAGGUUACUGAUCUGACGACGUCGAGAGACGCCCAAGGUUAGGACAGGCUUUAUCGGAUUAAGGUUUAGCCCAAAGUAACUUCUGUUGUACAGAUACGUUGUAUAGUGCCAAAACCGUGACGUGGAGAUAGGCU,46,44,45,34,169
1998,7,AB271060.1/1350-1503,AUGAAAAAUCGGUAGGUGAGGCUACCAUAGGGAUACGGAUGACUACCGCAAAGUAGUGGAGACACUAUGCGCUGGUUAGCAGUUGAGAUCGCUAAGGUUUUGACUAAUGUCAUUUCACUGCCCUACGGAGUUAAAGCUUGAACGGAACACAAGA,48,36,42,28,154
1999,7,AE016825.1/3525127-3525291,GCAGUGUCUCGUUCGGCGAGGCUCCUAUGCAAACACAGGUCACUGAUCUGACGACGUCGAGAGACGCCCAAGGUUAGGACAGGCUUUAUCGGAUUAAGGUUUAGCCCAAAGUGACUUCCAACGGAUACGUUGCAUAGUGCCAAAACCUAGACGCGGAGAUCGCUU,43,36,45,41,165
2000,7,AE016830.1/1268265-1268435,AAUAAGAUUUGUUAGGUGAGGCUCCUAUACAAACAUAGGCUACUGCCCAAAAAUGUCGAGAGACGCCAAUGGGUAGAACAGGAACUGUCGAAUGAAGGCUUUUCUUAAGGUAGCUAAAAGCAAUCGCUUUUUACGUUGUAUAGUGCUAAAGCUCAACGAUAAGAACGAUUA,59,44,39,29,171
2001,7,AAJM01000138.1/2313-2480,AAUAAUCUUUGUUAGGUGAGGCUCCUGUAUAGAGAAACGCUGCUGCCCAAAAAUGUCGAGAGACGCCAAUGGGUCAACAGGAACGGUCGGAUUAAGGCCCUUCUUAAUGUAGCUGGUUAUAAAAACCUAUGCUAUACAGUGCUAAAACUCAACGAGGGAGUGGUAUAC,53,41,42,32,168
2002,7,AARF01000550.1/280-107,AGAUAUCCUCGUUAGGUGAGGCUCCUAUACAAACAAAAGCCACUGCCCGGAAAUAUCGAGAGAUACCUACGGGUAGAACAGAAAUUGUCGGAUUAAGGCUUUUUCUAAGGUGGCUAAGAGAUGCUUCUACUCUUUACGUUGUAUAGUGCUAAAACCAGACCAGGGGGAACGGAC,54,42,43,35,174
2003,7,CP000804.1/127786-127952,GUUGCUCCCUGGUAGGCGCGGCUUCACGCAAACACAGGUUACUGCUCCGGCCCGUCGAAAGACGCUCAGGGGCGCACAGCAGGCUCGGCUUAAGGGCUUUGCCAAAGUAACUGCGGCGCUGCCGCUACGUUGUGUGACAGCUUAAGCUCAACCGGAGGGGGAGUGUU,32,33,55,47,167
2004,7,AE008691.1/2398115-2397950,UUAAUACCUCGUUAGGUGAGGCUCCUAUACAGAUACAGGCUGCUGCCCGGAAACAUCGAGAGAUGGUAACGGGUGAACAGGCAUUACCGAAUCAAGGUUUUGCCUAAUGCAGCUGGAGUUUUCUCCAAAGCUGUAUAGUGCCAAAGCUCAACGAAGGAAAUUGGAU,49,40,43,34,166
2005,7,AJ002571.1/47742-47907,UAGGAACUUCGUUAGGUGAGGCUCCUGUAUGGAGAUACGCUGCUGCCCAAAAAUGUCCAAAGACGCCAAUGGGUCAACAGAAAUCAUCGACAUAAGGUGAUUUUUAAUGCAGCUGGAUGCUUGUCCUAUGCCAUACAGUGCUAAAGCUCUACGAUUGAAGGCGCCC,47,41,41,37,166
2006,7,CP001175.1/2843327-2843491,AGUUUUGCCUGUUAGGUGAGGCUCCUAUGCAAACACAGGCCACUGCCCAAAAAUGUCCAAAGACGCCAAUGGGUAGAACAGGGAUUGUCGGAUUAAGGCUUUCCAUAAUGUGGCUAAGAGUAUUCUUUACGUUGCAUAGUGCCAAAACUUUAGCGAGGGGAGUCU,46,43,43,33,165
2007,7,CP001124.1/3732610-3732441,ACUGUUCCUCGUUAGCAUGAGGCGUUUGCACAAACAGAGGCUACUGCCCAAAAACGUCGAAAGACGCCAAUGGGUAGACCAGGGCUUGCCGGAUUAAGGCUUGACCUAAGGUAGCUGGUUCUUCCUGACCUACGUUGUGCACUGCUGAAAACCUACGAGUGGGGAACCAC,44,37,46,43,170
2008,7,AE005176.1/1288920-1288763,CAUAGCCGUCGGUAGGUGAGGCUACCGCAGGGAUACGGGUUGCUGCCGCAGAGUCGUGGAGACACGAUGAGAGGGCCAACAGUUCACGUCGAAAAACAAGGCGUGAAAUAGUGCAACAACAUCGCCCUGCGGAGCUAAAGCUUGAACGAUAGCUUGUA,45,27,50,36,158
2009,7,CP000962.1/3124853-3124692,AAUAAACCUCGGUAGGUGAGGUUACUACAAGGAUACGGGUUGUUGCCGUAAAAGAAUGGAAACAUUCUUAACUGGUUAGCAGGUUUUGCCGAACAAAGAAGGCAUAAUCUAAUACAGCUUCAUUGCCUUGCAGAGCCAAAACUUGAACGAGAAAGUGUUGUU,54,42,39,27,162
2010,7,CP001186.1/4113904-4114071,UAUGGUCUCUGUUAGGUGAGGCUCCUGUAUAGAGAAACGCUGCUGCCCAAAAAUGUCGAGAGACGCCAAUGGGUCAACAGGAAAGGUCGGAAUGAAGGCCUUUUUUAACGUAGCUGGUUUCAGUACCUAUGCUAUACAGUGCUAAAACUCAACGAGGGAGAGGUGCAU,48,41,47,32,168
2011,7,ACOM01000001.1/624108-624271,AAAUAAAUUUGUUAGGUGAGGCUCCUAUAAAGAUAUAUGCCGCUACCCAGAAAAAUCGAGAGAUUCCAACGGGUUAACAGAAAUUAUCGCAAAGGUAAUUUUUAAUGUGGCUGACUAGAAAGUCAAAGCUCUAUAGUGCUAAAGCUCUACAACUAAGUAAUUAU,62,45,31,26,164
2012,7,CP001390.1/3327040-3327209,GAAAUUCCUCGUUAGGAAGAGGCGUUAGCACAAACAGAAGCUACUGCCCAGAAACGUCGAAAGACGCCAAUGCGGUAGACCAGAUUCAGUCGGAUUAAGGCUUUAUCUAAGGUAGCUGGUGGUGGUUCACCUACGUUGUGCUCUGCUAAAACUCAAACCAGGGGAAAAUG,52,37,45,36,170
2013,7,AE005176.1/907250-907410,CUAACCAUCGGUAGGUGAGGCUACCACAGGGAUACGGGUUGCUGCCGCAGAGUCGUGGAGACACGAUGAGAGGGCCAACAGUUCACGUCGAAAAAAGAAGGCGUGAAAUAGUGCAACAACAUCGCCCUGCGGAGCUAAAGCUUGAACGAUACUGGGUACUU,48,28,49,36,161
2014,7,CP001124.1/511763-511594,CGGGUUCCUCGUUACGAUGAGGCGUUUGCUCAAACACAGGCUACUGCCCGGAAACGUCGAAAGACGCCAACGGGUAGACCAGGUCUUGCCGGCUUAAGGCUUGACCCAAGGUAGCUGGUCCCCCGGGACCUACGUUGCGCACUGCCGAAAACCUACGAGAGGGGAAUCCG,39,30,51,50,170
2015,7,CP001348.1/2365884-2365715,CUAAAUAUUCGUUAGGUGAGGUUCCUAUACAGAUAAAUGCUGCUGCCCGGAAACAUCGAGAGAUGCCAAUGGGUCAACAGGUAUUACCGAAAUAAGGUUUUACUUAAUGUAGCUGGAGAUAAAGUGGUCCAAAGCUGUAUAGUGCUAAAACUCAACGAGUGAAGGGUUUU,55,46,42,27,170
2016,7,CP000885.1/3684636-3684463,AUUAAACUUCGGUAGGUGAGGCUACCGCAGGGAUAUGGAUUGCUACCGCGAAAUAAUGGAGACACUAUUAGUUGGUUAGCAGGUUGUGUCGAAUCAAGGCAUAACCUAAUGCAAUUUCAAGGCGUCAAAUGUACGCCAUGCCCUGCGAUGCUAAAGCUUGAACGGUUAAUUGCU,50,46,45,33,174
2017,7,CP001176.1/2412253-2412418,AAUAAACUUUGUUAGGUGAGGCUCCUGUAUAGAGAAACGCUGCUGCCCAAAAAUGUCGAGAGACGCCAAUGGGUCAACAGGAACGGUCGGAUUAAGGCCCUUCUUAAUGUAGCUGGUUAUAAAAACCUAUGCUAUACAGUGCUAAAACUCAACGAGGGAGUGGUAU,53,40,42,31,166
2018,7,CP000924.1/241045-241209,UUAAUACAAUCGUUAGGUGAGGCUCCUAUACAGAUACACGCUGCUGCCCGGAAACAUCGAGAGAUGCUAACGGGUCAACAAGUAUUACCGAAUUAAGGUUUUACUUAAUGCAGCUGGAGGAUGCUCCAAAGCUGUAUAGUGCCAAAGCUCAACGAAUUGAAAUGU,53,41,38,33,165
2019,7,CP000033.3/206473-206636,UAUAAAAACUGUUAGGUGAGACUCCUACGUGAACACACGCUAUCGCCCAGAAACAUCCAGAGAUGCCAACGGGUUAAAUAGGUGUCGUCGACUUAAGGCGAGAUCCAGAUAGCUAGCAUGUGCUUACGUCACGUAGUGUUAAAACUGAACGACGAGUAUAACGG,53,36,40,35,164
2020,7,ACMS01000077.1/22055-22218,AUAAGUCUCUGUUAGGUGAGGCUCCUGUAUAGAGAAAUGCUACUGCCCAAAAAUGUCGAGAGACGCCAAUGGGUCAACAGGAAUGAUCGAAUUAAGGUUUUUCUUAACGUAGCUGGUAAUGAACCUAUGCUAUACAGUGCUAAAACUCGACGAGGGAGAGGUCU,51,42,42,29,164
2021,7,ACAO01000024.1/41200-41025,AUAUAACCUUGUUAGGUGAGGCUCCUAUACAAACACAAGCUAUUGCGCAGAAACGUCGAAAGACGCCAAUGUGUAAAACAGGAAUUGUCGGAUUAAGGCUUUUCAUAAAAUAGCUAAGAGAGCAAAUGACUUUCUUUACGUUGUAUAGUGCUAAAACUCGGACGAUGAGAUUGCUG,60,47,39,30,176
2022,7,ACLX01000114.1/2858-3034,UUUAUAACCUGUUAGGUGAGGCUCCUAUACAAACACAGGCUAUUGCCCAAAAAUAUCGAAAGAUGCCAAUGGGUAGAACAGGAAUUGUCGGAUUAAGGCUCUUCUUAAGAUAGCUAAGUGAUGAAUGAUUCAUCCUUUACGUUGUAUAGUGCCAAAACUCAACUAGGGGGGAAUGAG,58,48,41,30,177
2023,7,CP000813.1/1287638-1287801,AUGAGACUUCGUUAGGUGAGGCUCCUGUAUGGAGAUACGCUGCUGCCCAAAAAUGUCCAAAGACGCCAAUGGGUCAACAGAAAUCAUCGACAUAAGGUGAUUUUUAAUGCAGCUGGAUUUUUCCUAUGCCAUACAGUGCUAAAGCUCUACGAUUGAAGGAGCAA,50,42,39,33,164
2024,7,ABDP01000004.1/121407-121244,AAUAGUGUACGUUAGGUGAGGCUCCUAUAUAGAUAUAUGCUACUGCCCGGAAACAUCGAGAGAUGCCAAUGGGUCACCAGGUAUUACCGAAGUAAGGUUUUACUUAAUGUAGCUGGCUGUAGUCCAAAGCUAUAUAGUGCUAAAACUCAACGAUUGAUGUUAAA,52,46,38,28,164
2025,7,CP000560.1/1275022-1275187,UAAGAACUUCGUUAGGUGAGGCUCCUGUAUGGAGAUACGCUGCUGCCCAAAAAUGUCCAAAGACGCCAAUGGGUCAACAGGAAUCAUCGACAUAAGGUGAUUCUUAACGCAGCUGGAUGGCUGUCCUAUGCCAUACAGUGCUAAAGCUCUACGAUUGGAGGCCCCG,46,38,43,39,166
2026,7,ACMP01000214.1/1800-1624,UGCUAAACCUGUUAGGUGAGGCUCCUAUACAAACACAGGCUAUUGCCCAAAAAUGUCGAAAGACGCCAAUGGGUAGAACAGGAAUUGUCGGAUUAAGGCUCUUCUUAAGAUAGCUAAGUAAUCAAUUUCCAUUACUUUACGUUGUAUAGUGCCAAAGCUCUACUAGGGGGAGGAAAG,57,46,41,33,177
2027,7,ACAJ01000014.1/157903-157714,GGAUAACCUUGUUAGGUGAGGCUCCUAUACAAACAUAAGCUAUUGCGCAGAAACGUCGAAAGACGCCAAUGUGUAAAACAGGAAUUGUCGGAUUAAGGCUCUUCAUAAAAUAGCUAAGAAGAAAUAAAUACUACUAAUUUGCUUCUUCUUUACGUUGUAUAGUGCCAAAACUCGGACGAUGAGAUUGCUU,65,53,39,33,190
2028,7,ACND01000068.1/9860-9684,UGCUUAACCUGUUAGGUGAGGCUCCUAUGCAAACACAGGCUAUUGCCCAAAAAUGUCGAAAGACGCCAAUGGGUAGAACAGGAAUUGUCGGAUUAAGGCUCUUCUUAAGAUAGCUAAGUAAUGAAUUUUCAUUACUUUACGUUGUAUAGUGCCAAAGCUCUACUAGGGGGGAAAAGC,55,48,42,32,177
2029,7,ACMV01000122.1/63091-63256,AUAUGUCUCUGUUAGGUGAGGCUCCUGUAUAGAGAGACGCUACUGCCCAAAAAUGUCGAGAGACGCCAAUGGGUCAACAGGAAAGGUCGGAAUGAAGGUCUUUUUUAACGUAGCUGGUUUGAACCUAUGCUAUACAGUGCUAAAGCUCAACGAGGGAGAGGUACGA,49,40,47,30,166
2030,7,ACNO01000010.1/64597-64770,GCAGUACCUCGUUAGGUGAGGCUUCUGCACGAACACAGGCCACUGAUCUCACGACGUCGAGAGACGCCCAAGGUUAGGACAGAUCUCCCCGGCUUAAGGGGUGAUCCAAAGUGGCUUCCCGGUCUUGAUCGGGACACGUCGUGCAGUGCCAAAACUCGGACGUGGAGGUGUUUU,38,37,53,46,174
2031,7,ACBV01000002.1/67696-67865,UAAGCACCUCGUUAGGUGAGGCGGCUACACGAACACAGGCCACUGACCCCGAACGUCGAAAGACGCCCCGGGUCAGGACAGCUCCUCCCGGCUUAAGGGUUGAGCCCAGGUGGCUUCCGGAUUACCGGACACGUCGUGUGGUGCCAAAGCUCUGACGAGAGGGGUGCGGG,36,27,57,50,170
2032,7,CP001034.1/3063723-3063914,UUAUAAACUCGUUAGGUGAGGCUCCUGGGUGGAUAUAAGCUGCUGCCCAAAAACGUCGAGAGACGCCAAUGGGUAUAACAGACAGUGUCGGCUUAAGGCCUGUCUAAUGCAGCUGGUCCUCUUCUACCUUAUUAGAUAUUAAAUUUCGGAUCUACGUCACCCAGUGCCAAAGCUAAGACGAGGAGUGCGUAA,53,49,48,42,192
2033,7,ABJD02000101.1/1953821-1953650,GCAGUAUCUCGUUAGGCGAGGCUCCUAUACAAACACAGGUUACUGAUCUGACGACGUCGAGAGACGCCCAAGAUCAGGACAGGAUAUAUCGAACGAAGGUAUAUCCCCAUGUAACUUCCAAUGUAAGUUGGAUACGUUGUAUAGUGCUAAAACCGAGACGUAGAGAUAGCCA,55,38,42,37,172
2034,7,CP000826.1/2785644-2785471,GCAGUAUCUCGUUUGGCGAGGCUCCUAUACAAACACAGGUUACUGAUCUGACGACAUCGAGAGAUGCCCAAGGUUAAGACAGGCUUUAUCGGAUUAAGGUUCAGCCCAAGGUAACUUCUGAUGAAUACAUCAGAUACGUUGUAUAGUGCUAAAACCUGGACGCGGAGAUAGGCU,51,43,44,36,174
2035,7,CU458896.1/4831187-4831017,UCAGCACCUCGCUAGGCGAGGCUCCUGCACGAACACAGGCCACUGAUCCGACGACGUCGAGAGACGCCCAGGGUUAGGACAGAUCUCCCCGGCUUAAGGGGUGAUCCGAGGUGGCUUCCCGUCCAGGGAUUACGUCGUGCAGUGCCGAAGCUCUGACGAGAGAGGUGGUCG,35,29,57,50,171
2036,7,ACGH01000107.1/2043-1878,AAUAGAAGCUGUUAGGUGAGGCUCCUAUGUGAAAAAUGCUACUGCUCAGAAACGUCGAAAAACGCCAAUGAGUCAGCUGUUCUAGUCAAAGUAAGGCUUGAACUAACGUAGCUGUUAUUGAAUAACUACAUCACAUAGUGCUAAAGCUCAACGACUGGCUAAAGCU,57,41,36,32,166
2037,7,ABIN01000151.1/583-766,UAAGCACCUCGUUAGGUGAGGCGUCUACACGAAUACAGGCCACUGACCCCGAACGUCGAAAGACGCCCCGGGUCAGGACAGCUCCUCCCGGCUUAAGGGUUGAGCCCAGGUGGCUUCCGGUUUGGAUUUUUUCCAGGCCAGGACACGUCGUGUGGUGCCGAAGCUCUGACGAGAGGGGUGCGGA,37,36,60,51,184
2038,7,ACGU01000110.1/97211-97378,CAAAUAAACUGUUAGGUGAGACUCCUACGUAAAUAUACGCUGACGCCCAGCAACAUCCAGAGAUGCCAACGGGUUAAACGGGAACUGUCGAAUUAAGGCUUUUCCCAGUCAGCUAGUUAAACAGACUUCACGUUACGUAGUGUUAAAACUGAACGACGAGUAAAAUCG,57,38,36,37,168
2039,7,ABVP01000024.1/147149-146978,GCAGUAUCUCGUUAGGCGAGGCUCCUAUACAAACACAGGUUACUGAUCUGACGACGUCGAGAGACGCCCAAGAUUAGGACAGGAUAUAUCGACCGAAGGUAUAUCCCCAUGUAACUUCCAGUAUUCAUCGGAUACGUUGUAUAGUGCUAAAACCGAGACGUGUAGAUAGCUU,51,42,41,38,172
2040,7,ACLM01000103.1/132-299,CAAAUGAACUGUUAGGUGAGACUCCUACGUAAAUAUACGCUGACGCCCAGCAACAUCCAGAGAUGCCGAUGGGUUAAACAGGAACUGUCGAAUUAAGGCUUUGCCCAGUCAGCUAGUUGAACAGACUUCACGUUACGUAGUGUUAAAACUGAACGACGAGUAGAAAUC,55,38,39,36,168
2041,7,ACEC01000025.1/21421-21256,AAAGAACACCGUUAGGUGAGGUUACUUUACGGAUAUGGCUAUUGCCCGGAAAUGUCGAGAGACGCCAACGGGUCAGUUGACACUAUCGAAUCAAGGUUUUGUCUAAUAUAGCUGACAGUUCUGUCUAUGCCGUAGAGAGCCAAAGCUCGACGAACAGGGGUGUGGC,46,40,47,33,166
2042,7,BABE01005974.1/721-547,AAUAAGAUUUGUUAGGUGAGCUUCCUAUACAAACAUAGGCUACUGCCCAAAAACGUCGAGAGACGCCAUNNGGUAGACAGGGAAUNGUCGAGAUAAGGCUUUUCAUAAGGUAGCUAAAAGCAGGUAUCUGCUUUUUACGUUGUACAGUGUCAAAACUCAACGAUGAGAUCUGAGA,57,44,41,30,175
2043,7,ACLN01000004.1/169541-169717,AAUUUGAACUGUUAGGUGAGACUCCUACGUGAAAAUAUGCUGUUGCCCAGCAACAUCCAGAGAUGCCAACGGGUUAAACAGGGAUCGUCGAUUUAAGGCCCUCCCCAGACAGCUGGUUACUAACUUUGUAGUAACGUUACGUCACGUAGUGUUAAAACUGAACGACGAGUGAAUUAA,54,45,41,37,177
2044,7,CP000517.1/232404-232566,AAGUAAAACUGUUAGGUGAGACUCCUACGUGAACACACGCUAUCGCCCAGAAACAUCUAGAGAUGCCAACGGGUUAAAUAGGUGUCGUCGACUUAAGGCGAGAUCCAGAUAGCUAGCAUUGCUUACGUCACGUAGUGUUAAAACUGAACGACGAGUAUGACAA,54,36,39,34,163
2045,7,ACKR01000005.1/5717-5880,CAAAUAAACUGUUAGGUGAGGCUCCUACGUGAACACAAGCUAUCGCCCGGAAACAUCCAGAGAUGCCAACGAGUAAAAUAGUUCUUGUCGAGAUAAGGCGAGAUCCAGAUAGCUAGCCUGUGCUUACGUCACGUAGUGUCAAAACUGAACGACGAGGAAACAUC,55,33,39,37,164
2046,7,CP001364.1/587050-586882,UUCGCUCCUUGGUAGGCGCGGUCUGCAUACAAACACAGGUUGCUGCUCCGACCCGUCGAAAGACGCUUAGGGGUAUACAGUAUAGCUCGGCUUAAGGGUUAUGCUAAAGCAACUGUAGCGCUGCUACUACGUUGUAUGCGGGCUUAAGCUCAACCGAAGAGGGAGCAAA,42,39,48,40,169
2047,7,CP001393.1/739372-739528,AAGAUAUCUCGGUAGGCGAGGCUCCUACAGGGAUAUAGGCUGCUGCCGCGAAAGAUUGGAGACAAUCUGAGCUGGUGAACAGGUUUUGCCGAAACCAAGGCAUAACCUAAUGCAGCUUUUUAUGCCGUGUAGUGCCAAAGCUUGUACGAGGUAGCUU,42,38,45,32,157
2048,7,CP000910.1/746842-747026,GCAGCACCUCGUUAGGCGAGGCUCCUGCGCGAACACAGGCCACUGAUCUGACGACAUCGAGAGAUGCCCAAGAUCAGGACAGGCCGCCUCGGCUUAAGGGGCGGUCCCAAGUGGCUUCCGGUGCCAGUAAAUAUUGCCAGCCCAGAUACGUCGCGCAGCGCCGAAGCUCUACGUGGGGGUGACUC,40,30,58,57,185
2049,7,AB385841.1/13217-13047,CACGCACCUCGUUCGGUGAGGCGUCGUCACGGACACAGGCCACUGAUCCCACCCGUCGAGAGACGCUCCGGAUCAGGACAGGUCUCCCCGGCCCAAGGGGUGACUCCAAGUGGCUGCCCCACCCGGGGCUACGCCGUGACGUGCCAAAGCUCUGACGAGUGGGGGUGAGCC,31,24,56,60,171
2050,7,ACNB01000463.1/4534-4369,AUAUGUCUCUGUUAGGUGAGGCUCCUGUAUAGAGAAACGCUGCUACCCAAAAAUGUCGAGAUACGCCAAUCGGUCAACAGGAACGGUCCAAUUAAGGCCCUUCUUCUUAAUGUAGAUGGUUUUAAACCUAUACUGUACAGUGCUAAAACUCAAUGAGGGGGCUUUU,48,47,37,34,166
2051,7,ABQP01000004.1/146576-146420,UGAGAGCGUCGGUAGGCGAGGCUACCGCAGGGAUAUGGGUUGCUGCCGCUAACAGUGGAGACACUGCACGCAGGUCAGCAGUUCUUGUCGGAUUAAGGCAUGAACUAACGCAACUCCACCGCCCUGCGAUGCUGAAGCUUGAACGAUGACACGACCA,39,29,48,41,157
2052,7,CP001095.1/485733-485576,UGGGAGCGUCGGUAGGCGAGGCUACCGCAGGGAUAUGGGUUGCUGCCGCUAACAGUGGAGACACUGCACGCAGGUCAGCAGUUCUUGUCGGAUCAAGGCAUGAACUAACGCAAUUCCACCGCCCUGCGAUGCUGAAGCUUGAACGAUGGCCGAAUCGG,36,30,52,40,158
2053,7,CP001078.1/1435636-1435795,UAAUAUUCUCGGUAGGUGAGGUUACCAUAGGGAUACGGAUUGCUGCCGCAAAAUAAUGGAGACAUUAUUAGUUGGUUAGCAGGAUACGUCGAAAAAUAAGGCGUAUCUUAAUGCAAUUUCAUUGCCCUACGAAGCUGAAGCUUGAACGAGGAGAUAGUAA,52,43,41,24,160
2054,7,ACDH01000013.1/27326-27487,AAAUAGAUCCGGUAGGUAAGGCUACUACAGGGAUAUGGGUUGCUGCCGCAAAAUAGUGGAGACACUAUGCGUUGGUUUGAACAGGCGAUAUCGAAACCAAGGUAUCAUCUAAUGCAACUUCACCGCCCUGUAGAGUUAAAGCUCAAACGGUGGCGUAAAUCA,51,37,42,32,162
2055,7,ACDK01000064.1/73825-73664,UUAAUAUUUCGGUAGGUGAGGUUACCACAAGGAUAAGGGUUGCUGCCGCAAAAUAGUGGAGACACUAUGAGAAGGUUAGCAGUCUAUGUCGAAGCCAAGGCAUAGACUAAUGCAAUUUCAUCGCCUUGUGAAGCUGAAGCUUGUACGAUGAUGAAGCAGUUU,49,43,44,26,162
2056,7,CP001056.1/1473093-1473254,UAAUAUUCUCGGUAGGUGAGGUUACCAUAGGGAUACGGAUUGCUGCCGCAAAAUAAUGGAGACAUUAUUAGUUGGUUAGCAGGAUACGUCGAAAAAUAAGGCGUAUUUUAAUGCAAUUUCAUUGCCCUACGAAGCUGAAGCUUGAACGAGCAGAUAAUAAGA,54,44,40,24,162
2057,7,ABWO01000186.1/16693-16863,AAUAAGAUUCGGUAGGUGAGGCUACCACAGGGAUUUGGAUUUUCCUAAGAUUGCUGCCGCAACAACGUGGAGACACGAUUCGCUGGUUAGCAGGAUAUGUCGCAGAUAAGGCAUAUCUUAAUGCAAUUUAUAUGCCCUGUGAUGCUAAAGCUUGAACGAUGUUGUCACGGA,48,47,45,31,171
2058,7,ACIL02000005.1/103424-103269,GGUGCAAUUCGGUAGGUGAGACUACCAUAGGGAUACGGAUGACUACCGCAAAGAAGUGGAGACACUUCGCGUUGGUUAGCAGUUGCUGUCGAGAAGGCGGCGACUAACGUCAUUUCAUCGCCCUAUGAUGUUAAAGCUUGGACGAUGAAUGAGAAA,44,36,47,29,156
2059,7,ACKZ01000007.1/32791-32946,AUAGUAAAUCGGUAGGUGAGACUACCAUGGAGAUACGGAUGACUACCGCAAAAUAGUGGAGACACUAUUCGUUGGUCAGCAGCCUCUGUCGUGAAGGCAGAGACUAAUGUCAUUUCAUCGCUCCAUGAUGUUAAAGCUUGGACGAGAAUAUAAGAA,50,38,40,28,156
2060,7,ABFX02000002.1/189276-189122,UAAAAGAAUCGGUAGGUGAGACUACCAUAGGGAUACGGGUUGCUACCGCAAAGCAGUGGAGACACUGUGCGCUGGUCAACAGUUCUUGUCGUGAAGGCAAAAACUAAUGCAAUUACAUGGCCCUAUGAUGUUGAAGCUUGAACGAGAUAAAGUUA,50,36,42,27,155
2061,7,AAVL02000037.1/263157-262991,CUACUUUAUCGGUAGGUGAGGUUACCAUAGGGAUUCGGUUUAAUCCUAAGAUUGCUGCCGCGAGAUUGUGGAGACACAAUUAGUUGGUUAGCAGGAUGUGUCGUUAAGGCAUAACCUAAUGCAAUUAAUAUACGCCCUAUGAUGCUAAAGCUUGAACGGUGAUUUUA,46,52,42,27,167
2062,7,ABYT01000060.1/16817-16983,AAAGAUAUACGGUAGGUGAGGUUACCGCAGGGAUUUGGAUUUCCUAAGAUUACUGCCGCAAAGUUGUGGAGACACGACUCGUUGGUCAGCAGGCAAAGUCGCAAAGGCUUGGCUUAAUGUAAUUUAUAUGCCCUGUGAUACUAAAGCUUGAACGGUGAUACUAGAUU,48,46,45,28,167
2063,7,CP000764.1/1422391-1422554,UAAAGUCUCUGUUAGGUGAGGCUCCUGUAUAGAGAAAUGCUACUGCCCAAAAAUGUCGAGAGACGCCAAUGGGUCAACAGGAAUGAUCGAAUUAAGGUUUUUCUUAAUGUAGCUGGUAAUGUACCUAUGCUAUACAGUGCUAAAGCUCGGCGAGGGAGAGGUUC,48,44,44,28,164
2064,7,CP000822.1/4527413-4527596,UAUCGAUCUCGUUAUGGCGAGGCUCCUGCACAAAUAUAAGUUACCGCCCUGCUGGUAUCGAGAGAGACCACUCAGGGAAAUACAGGCAUCCAUCGAAUCAAGGUGUUGCCAAGGUAACUUCUGACGAUAUCACUAUCGGGCAGAUACGUUGUGCAGUGCUAAAACCAGGACGUAGGGAUCUGCC,51,42,47,44,184
2065,7,ABOU02000050.1/75054-74870,ACAUCAUUUCGGUAGGUGAGGUUACCACAGGGAUUGGAUGAUUCGGCUUAUGUCGUUAAAUCCGAAGAUUGCUACCGCGGAAUUGUGGAGACACGAUGAGCUGGUUAGCAGGCUGCGUCGCGAAGGCGCAACUUAAUGCAAUUUAUAUGCCCUGUGAUGCUAAAGCUUGAACGGUGCUAUUAUUU,46,53,52,34,185
2066,7,CP001727.1/2253817-2253654,UGCGUUCCUCGUUAGGCGAGGCUACUAUACGAACACAAGCCACUGCCCGGAAACGUGGAGACACGCCAAUGGGUAGAACAGGUAUGGCCGGCUUAAGGCUUUACCUAACGUGGCUGGGUUUUCCCUACGUCGUAUAGUGCCAAAGCUCAACCAGGGGGAUGUGC,39,35,48,42,164
2067,7,ACCI02000061.1/145679-145508,GCAGUAUCUCGUUAGGCGAGGCUCCUAUACAAACAUAGGUUACUGAUCUGACGACGUCGAGAGACGCCCAAGAUUAGGACAGGAUAUAUCGACCGAAGGUAUAUCCCCAUGUAACUUCCUGCUAAGUCAGGAUACGUUGUAUAGUGCUAAAACCGAGACGAAGAGAUAGCUU,53,40,42,37,172
2068,7,ABYU02000030.1/155655-155490,GAGAAAAAUCGGUAGGUGAGGUUACCACAGGGAUUUGGGAGACCUAAGAUUGCUGCCGCAGAUUUGUGGAGACACAAUGCGCUGGUUAGCAGGCUAUGUCGUGGAAGGCAUAACCUAAUGCAAUUUAUAUGCCCUGUGAUACUAAAGCUUGUACGUGGCACUCAGA,47,41,48,30,166
2069,7,CP001700.1/1972480-1972312,AGGACACCUCGUUCGGUGAGGCGUCUUCACGGACAAAGGCCACUGAUCCCAUCGGUCGAGAGACCCUCCGGAUCAGGACAGAUCUCCUCGGCUUAAGGGGUGAUCCCAAGUGGCUGCGCAGCUGACGCUACGCCGUGAAGUGCCGAAGCUCUGACGAGAGAGGUGGCCG,36,29,55,49,169
2070,7,CP002743.1/503463-503307,UGGGAGCGUCGGUAGGCGAGGCUACCGCAGGGAUAUGGGUUGCUGCCGCUAACAGUGGAGACACUGCAUGCUGGUCAACAGUUCUUGUCGGAUCAAGGCAUGAACUAAUGCAAUUCCACCGCCCUGCGAUGCUGAAGCUUGAACGAUGGCUCGAAUC,36,34,49,38,157
2071,7,ACDB02000044.1/535177-535016,UAAUAGUUCCGGUAAGUAAGGCUACUAUAGGGAUAUGGGUUACUGCCGCAAAAUAGUGGAGACACUAUGCGCUGGUUUGAACAGGCAACAUCGAAACCAAGGUGUUAUCUAAUGUAACUUCACCGCCCUACAGAGUUAAAGCUCAAACGGUGGUAAAAAAUA,55,39,38,30,162
2072,7,ABWM02000004.1/570492-570323,CAACGAUCUCGUUAUGGCGAGGCUCCUGUACAAAUACACGUUAUCGCUCUGGUGGGUUCGAGAGAACCGGCACAGGGUAAAACAGGCACUGUCGAAUCAAGGCUUUGUCAGUAUAACUUCCCUUGCGGGAUACGGUGUACAGUGCUGAACCCAGGACGUGGGGAUCUCUU,41,41,48,40,170
2073,7,CP001720.1/1833967-1834136,AUAAUUCCUCGUUAGGUGAGGCUUCUGCAUAGAACAUAUGCCACUGCCCGGAUAGGUCGAAAGACCGUAACGGGUUAACAGGUAUUACCGGAUUAAGGUUUUAUCUAAUGUGGCUGAGAUUUAUGUCUCUAGCUGUGCAUGUGCCAAAACUCGUACGAGUGGGGAAUGGG,44,48,47,31,170
2074,7,AL935263.2/1874649-1874486,AUCAGUUGCAAUUAGGUGAGGUUACUUUAAGAAUAUAGGUUAUCGCCCAGAAAUGUCGAGAGACAGGAAUGAGUAAAGCAGAAUUUGCCGAAUUAAGGCUCUUUCAAGAUAACUAGACUAGUUCUUACGUCUUAAAGUGCUAAAACUCAAUGAAUGCGUCGAUG,56,46,37,25,164
2075,7,CP001706.1/2088420-2088246,UAGGUGUCUCGUUAGGUGAGGCUCCAUCGCGAACAUAGGCCACUCAUCUGACGACAUCGAGAGAUGCCCAAGAUGAGGACAAAUCCUCCCGGCUUAAGGGUUGAUUCCAAGUGGCUUCCUACGUUUGGCGUAGGACACGUCGCGGUGUGUCAAAGCUCUUACGUGGACGCGCCAC,39,40,50,46,175
2076,7,ACCD01000002.1/42362-42531,GCAGUAUCUCGUUAGGCGAGGCUCCUAUACAAACACAGGUUACUGAUCUGACGACGUCCAGAGACGCCCAAGGUUAGGACAGGUUAUAUCGGAUUAAGGUAUAACCCAAAGUAACUUCUGAGAAAUCAGAUACGUUGUAUAGUGCUAAAACUUAGACACGGAGAUAGCCA,56,39,40,35,170
2077,7,CP001739.1/2726594-2726752,GAGAAAAAUCGGUAGGUGAGGCUAACAUAAGGAUAAGGAUUGCUGCCGCGAAAAGAUGGAGACAUUUUUAGCAGGUCUGAACAGUCUGGGUCGAAUAAGGCUCAGAAUAAUGCAAUUUCAUUGCCUUAUGAAGUUAAAACUUGAACGAUGAUUACAUUU,55,42,40,22,159
2078,7,ABXV02000030.1/100107-99935,GCAGUAACUCGUUAGGCGAGGCUCCUAUACAAACAUAGGUUACUGAUCUGACGACGUCUAGAGACGCCCAAGAUCAGGACAGGAUAUAUCGACCGAAGGUAUAUCCCCAUGUAACUUCCUGCUUUAUUCAGGAUACGUUGUAUAGUGCUAAAACCGAGACGAAGAGAUAGCGA,54,40,41,38,173
2079,7,CP001834.1/1924075-1923906,AACUAAUCAUAUUAGGUGAGGUUACUCUGAAGAACAUAGGUUAUCGCUCAAAACUGUCGAGAGACAAUAAUGGGUAAAGCAGGACUAGUCGAAUCAAGGCUUUUCCAAGAUAACUAGAAAUAUCAUUUCUUACGUCUCAGAAAGCCAAAACUCAAAUGUCGUGAUUAAAU,64,45,32,29,170
2080,7,ABWG02000004.1/102839-102676,CAAAUAAACUGUUAGGUGAGACUCCUACGUGAACACACGCUAUCGCCCAGGAACAUCCAGAGAUGCCAACGGGUUAAACAGGUAUUGUCGAGUUAAGGCACUAUCCAGAUAGCUAGCAUGUGCUUACGUCACGUAGUGUUAAAACUGAACGAUUGGUUAUAACG,52,39,38,35,164
2081,7,CP001966.1/2592315-2592145,UCAGUACCUCGCUAGGUGAGGCUCCUGCGCGAACACAGGCCACUGAUCCGACGACGUCGAGAGACGCCCAGGGUUAGGACAGAUCCUCCCGGAUUAAGGGUUGAUCCGAAGUGGCUUCCCGGACACGGGAUCACGUCGCGCAGUGCCGAAGCCCGACGAGAGGGGUGCGAG,37,26,58,50,171
2082,7,ACGO02000002.1/246026-245855,CAAAUAAACUGUUAGGUGAGACUCCUACGUGAACAUAUGCUGUCGCCCAGCAACAUCCAGAGAUGCCAACGGGUCAAACAGGGAUCGUCGAUAUAAGGCCCUCCCCAGCCAGCUAGUUAUGUUAAAUAACCUUACGUCACGUAGUGUUAAAACUGAACGACGAGUAUAAAAA,58,37,36,41,172
2083,7,CP001791.1/527842-527676,UGAAUCCCUCGUUAGGUGAGGCUCCUGCAGUGGAGACAUGCUGAUGCCCAACAACGUCCAAAGACGCCAAUGGGUUGAACAGGAACCAUCGACAUAAGGUGGUUUUUAACGCAGCUGAGCGCCGCUCUAUGCCCUGCAGUGCUAAAGCUCAACGAAUGGAGGAAAAA,48,33,45,41,167
2084,7,CP002104.1/1491224-1491064,GAGCACGGUCGGUAGGUAAGGCUACCACGGGGAUACGGGUUGCUGCCGCAACACAGUGGAGACACUGCAAGUUGGUCAACAGUCGUUGUCGAUUUCAAGGCUUCGACUAAUGCAACACCACCGCCCUGCGAAGCUGAAGCUUGAACGACAAGAUUAAGGUU,43,32,47,39,161
2085,7,ACFX02000041.1/21421-21266,AAGAACAUUCGGUAGGUGAGGCUACCACAGGGAUAAGGGUUACUGCCGGUUAAAGGUGGAGACACCUCUAAUCAGGUCAGCAGUCUGUGUCGCUGUAAGGCGCAGAAUAAUGUAAUUUCACGCCCUGUGAAGCUAAAGCUUGAACGGAUUGGAUAC,45,36,45,30,156
2086,8,CP000644.1/4016040-4015954,UAGAGUAAAGGGCAAACCGAUCGAAAGGUCGGGACGCAAAGCCACCGGUCUAAGGGUGUAGAUACCUAAGACAGCGGAGCUGCCAAC,29,11,27,20,87
2087,8,CP000141.1/90445-90359,UGUCGAUAAAGGCAAAACCGGCGAAAGCCGGUGACGCAAAGCUACAGGGGCUAAAGCGAAUUUUCGCCAUGCCAGCCAGCUGCCGAA,27,12,25,23,87
2088,8,AP009389.1/804550-804637,UUCCUAAAAGGGCAAACCAUUCGAAAGAAUGGGACGCAAAACCUUGGGUCUAAGGCAGCAAAGCUGCUAUGAUUGCCAGGUUGCAGGA,29,17,24,18,88
2089,8,CP000724.1/790814-790902,UGUUGAUAAAGGCAAACUUAUUGAAAAAUAAGGACGCAAAGCUAUGGAUCUAAGGGAAGUUGUAUUCCUAUGAUUGCCAGGUUGCCGAA,31,24,22,12,89
2090,8,CP000612.1/1107064-1107147,AAAAUUAAAAGGCAAACUUUCCGAAAGGAAAGGACGCAAAGCCACGGGCCUAAGGACAUUGUCUAUGGUAGCCGGGCCGCCUUA,29,14,22,19,84
2091,8,CP000232.1/1536251-1536164,AUCAACAAAGGGCAAACCUGUCGAAAGGCAGGGACGCAAAGCCAUGGGCCUAAAGCCCGACAAGGGCUAUGGUUGCCAGGUUGCCGGU,26,12,28,22,88
2092,8,AASZ01001000.1/4254-4168,AUAGCGAAAGGGCAAAGUCACCGAAAGAUGGCGACGCAAAACCGUGGAUCUAAAGCCAUUUAUGGCCAAGAUAGCCAGGUUACCGAA,32,13,23,19,87
2093,8,CP000679.1/1202000-1202089,AUAUCGAAAGGGCAAACCUGUCGAAAGGCAGGGGCGCAAAGCCAUGGGCCUGUCGGAAGUAAAACUUCCUAUGGUUGCCAGGCUGCCGAA,26,15,28,21,90
2094,8,ABCF01000005.1/23265-23355,UUAACGAAAAGGCAAACUUGCUGAAAGGCAAGGACGCAAAACCACAGAUCUAAAGAUUGCUAGAGCAAUCCAAGAUGGCUGGGUUACCGAA,36,15,22,18,91
2095,8,AAOX01000001.1/400824-400906,UAUUGAAAAAGGCAAACUUAUUGAAAAAUAAGGACGCAAAGCCGCGAGUCUAAGGCGUAAGCUAUGAUAGUCGGGCUGCCAGG,30,16,23,14,83
2096,8,CP000462.1/551681-551596,UAGAGUAAAGGGCAAACCGGUCGAAAGGUCGGGACGCAAAGCCACCGGUCUAAGGGUUCAUAACCUAAGACAGCGGAGCUGCCAUC,27,12,26,21,86
2097,8,CP000673.1/3897171-3897085,UCCGACAAAGGGCAAACUUGCCGAAAGGUAAGGACGCAAAGCCGAGGGUCUAAAGUGCGAGAGCAUUAUGACAGUCUGGCUGCCGUA,27,14,27,19,87
2098,8,AACY020365487.1/1679-1764,UAGAGUAAAGGGCAAACCGGUCGAAAGGUCGGGACGCAAAGCCACCGGUCUAAGGGUUCAUAACCUAAGACAGCGGAGCUGCCAUC,27,12,26,21,86
2099,8,CP000568.1/3637613-3637528,UUUUGAAAAGGGCAAAUCUAUCGAAAGAUAGAGACGCAAAGCCAACGAGUCUAAGGUGGAAACACUAUGACGGUCGGGUUGCCAAA,32,16,23,15,86
2100,8,AAOH01000011.1/15155-15071,GUUCGUAAAGGGCAAACUUAGUGAAAAUUAAGGACGCAAAGCUAUUGGUCUAAGGGUAUUUACCUAUGAUUGCAAAGCUGCCAAC,29,22,20,14,85
2101,8,AAWL01000017.1/11338-11251,ACAUAAGUUGGGCAAACCCGGCGAAAGCCGGGGACGCAAAGCCAUGGGUCUAAGGACAUUGGGUGUCUAUGAUCGCCAGGUUGCCAAU,24,16,28,20,88
2102,8,CR555306.1/718866-718950,CUCUGAAAAAGGCAAACCCGUCGAAAGGCGGGGACGCAAAAUCACCGGUCUACAGGGGUCGCCCCAUGACAGCGGGAUUGCCAGG,24,10,27,24,85
2103,8,CP000478.1/4546395-4546307,ACCUGUAAAGGGCAAACCAUCCGAAAGGGUGGGACGCAAAGCCGCUGGCCUAAGUCCCCCGCGUGGGAUAUGGCAGCAGGGUUGCCAGG,22,12,31,24,89
2104,8,CR378670.1/196774-196861,GUAUGUAAAGGGCAAACUAGUCGAAAGGCUAGGACGCAAAGCUACCGGUUUAAGGGUUAUUAAGACCUAUGACAGCGGAGCCGCCAUA,29,17,25,17,88
2105,8,CP000482.1/3118185-3118275,GCCUGAAAAAGGCAAACCAUUCGAAAGGAUGGGGCGCAAAACCACUGGUCUAAAUCCCGGAAAUUCGGGACAUGACAGCAGGGCUGCCGGG,29,12,28,22,91
2106,8,CP000469.1/3587317-3587229,UAGUGUAAAAGGCAAACCAAUCGAAAGAUUGGGACGCAAAGCCUCCGGUCUAAGGGUUCGUUUGUACCUAUGAUAGCGGGGAUACCACA,28,19,24,18,89
2107,8,AAPH01000029.1/24025-23938,GUAUGUAAAGGGCAAACUAGUCGAAAGGCUAGGACGCAAAGCUACCGGUUUAAGGGUUACACAGACCUAUGACAGCGGAGCCGCCAUA,29,15,25,19,88
2108,8,AAXG02000005.1/131709-131618,GCGGGAAAAGGGCAAACCGGCUGAAAGGCCGGGACGCAAAGCCAGGAGGCUAAAGCGGAGGGAAACGCCGCCAUGCCCGUCCGGUUGCCGCA,25,6,35,26,92
2109,8,AP008230.1/5220217-5220127,UAAAGUCAAGGGCAAACCUGCCUAAAGGCAGGGACGCAAAACCGUAGGAUCUAAGGUGCUUAAAAGGUGCUAUGAUAGCCUGGUUGCCAAU,30,18,25,18,91
2110,8,AAOJ01000002.1/319461-319551,GUCACGAACUGGCAAAUUAAUUGAAAGAUUAAGACGCAAAACCACCGGCCUAAAAAUUAUGUUAAUAAUUCAAGGUAGCGGGGUUACCGAA,36,20,19,16,91
2111,8,AAOU01000011.1/39728-39638,GUCACGAACUGGCAAAUUAAUUGAAAGAUUAAGACGCAAAACCACCGGCCUAAAAAUUAUGUUAAUAAUUCAAGGUAGCGGGGUUACCGAA,36,20,19,16,91
2112,8,AE014299.1/1112481-1112574,CACCGUAUUGGGCAAACUAAUUGAAAAAUUAGGACGCAAAGCCUCCGGUCUAAGGUUGUAAAGGGAUGUUAACUAAGAUAGCGGGGUUGCUUAA,31,23,25,15,94
2113,8,DQ124694.1/7633-7720,GCAUGAUAAAGGCAAACUGAACUGAAAAGUCAGGACGCAAAGCCUCCGGUCUAAUAGCUGCAAUGCUAAUGAUAGCGGGGUUACCAAG,31,16,23,18,88
2114,8,CP000083.1/4612611-4612693,GCUUGAUAAGGGCAAAUCUAAUGAAAGUUAGAGACGCAAAGUUACCGGUCUAAUGGGAAACCUAUGAUAGCGGGACUGCAAAU,30,18,22,13,83
2115,8,CP000753.1/3685694-3685606,GCGUGUAAAAGGCAAACCAGUUGAAAAACUGGGACGCAAAGCCUCCGGUCUAAGGGUUCGUCUGUACCUAUGAUAGCGGGGAUACCACA,27,17,25,20,89
2116,8,CP000563.1/3606440-3606352,GCGUGUAAAAGGCAAACCAGUUGAAAAACUGGGACGCAAAGCCUCCGGUCUAAGGGUUCGUCUGUACCUAUGAUAGCGGGGAUACCACA,27,17,25,20,89
2117,8,BA000028.3/2580327-2580243,CUCAGAAAAAGGCAAACCUAUUGAAAGAUGGGGACGCAAAGUCACAGAUCUAAGGUAUUUUUACUAAGAUGGCUGGACUAUCUGG,30,20,21,14,85
2118,8,CP000444.1/3427742-3427655,UAUUGUGAAAGGCAAACCAAUUGAAAGAUUGGGACGCAAAGCCUCCGGUCUAAGGGUCGUUUGUACCUAUGAUAGCGGGGAUACCGCA,26,20,25,17,88
2119,8,CP000446.1/3357377-3357290,UAUUGUGAAAGGCAAACCAAUUGAAAGAUUGGGACGCAAAGCCUCCGGUCUAAGGGUCGUUUGUACCUAUGAUAGCGGGGAUACCGCA,26,20,25,17,88
2120,8,CP000721.1/4634346-4634259,UAUUGAUAAUAGCACACUUGCCGAAAGGUAGGGCCGCAAAGCUAUGGGUCUAAAGAAAUUCAUUUUCAAUGAUUGCCAGGUUGCCAAA,29,23,20,16,88
2121,8,AAVO02000002.1/48259-48176,AUAGCAUAAAGGCAAACCUGCUGAAAGGCAGGGACGCAAAGCCACGGGUCUAAGGUCGUGAGACUAAGGCAGCCGGUUGCCGCA,26,11,27,20,84
2122,8,AM180355.1/3266964-3266879,AAAAUUAAAUGGCAAAAUUAGGGAAAUCUAAUGACGCAAAACUAUAGGGAUUAAAGCUUUUAAAGCCAUAUCAGCCAGUUGCUAAA,38,21,15,12,86
2123,8,AAML04000014.1/594909-594824,AAAAUUAAAUGGCAAAAUUAGGGAAAUCUAAUGACGCAAAACUAUAGGGAUUAAAGCUUUUAAAGCCAUAUCAGCCAGUUGCUAAA,38,21,15,12,86
2124,8,ABDW01000004.1/131179-131263,AUAAUAUAUUGGCAAAUCUAGAGAAAUUUAGAGACGCAAAGCUAAAGGGGCUAAGGUUAUAUAACUAUGCUAGCCAGUUGCCAAA,34,21,18,12,85
2125,8,AAND01000010.1/47376-47291,UCACGCACAGGGCAAACCACUUGAAAAAGUGGGACGCAAAGCUUCCGGCCUAAACCACUCGUUGGUAUGGUAGCGGGGUUACCGAU,24,16,24,22,86
2126,8,Y10550.1/784-870,AGCAGAUAAAGGCAAACCUGCGGAAACGCAGGGACGCAAAGCCAUGGCCUAAGGUACUGACGGUGCUACGGUUGACAGGUUGCCGAA,27,12,28,20,87
2127,8,AAJM01000107.1/5655-5567,AAAAUAAAUAGGCACACUGUUCGAAAGGAUAGGUCGCAAAGCUAAGAGUCUAAGGUAAUGAAAAUUACUAUGAUAGUCUGGUUGCAGUU,34,23,21,11,89
2128,8,CP000246.1/1695696-1695613,UAAAAAAAUGGGCAAAAUUAGAGAAAUCUAAUGACGCAAAGCUAUAGGGACUAAGGUUUAUAACUAUGUCAGCCAGUUGCCAAA,36,19,17,12,84
2129,8,ABDY01000007.1/25749-25832,UAAAAAAAUGGGCAAAAUUAGAGAAAUCUAAUGACGCAAAGCUAUAGGGACUAAGGUUUAUAACUAUGUCAGCCAGUUGCCAAA,36,19,17,12,84
2130,8,ABDV01000006.1/21251-21334,UAAAAAAAUGGGCAAAAUUAGAGAAAUCUAAUGACGCAAAGCUAUAGGGACUAAGGUUUAUAACUAUGUCAGCCAGUUGCCAAA,36,19,17,12,84
2131,8,ABDX01000004.1/24814-24897,UAAAAAAAUGGGCAAAAUUAGAGAAAUCUAAUGACGCAAAGCUAUAGGGACUAAGGUUUAUAACUAUGUCAGCCAGUUGCCAAA,36,19,17,12,84
2132,8,BA000016.3/1510292-1510209,UAAAAAAAUGGGCAAAAUUAGAGAAAUCUAAUGACGCAAAGCUAUAGGGACUAAGGUUUAUAACUAUGUCAGCCAGUUGCCAAA,36,19,17,12,84
2133,8,CP000485.1/435376-435460,CAGCGAGAAAGGCAAACUGAUGGAAACAUUAGGACGCAAAACUACAGGAGCUAAGGCCGAAAGGCUAUGCUAGCCAGUUACCGGA,32,11,24,18,85
2134,8,AAEW02000001.1/146764-146686,CUCCGAUAAAGGCAAAACCGGAGUAAUCCGGUGACGCAAAGCCACGGGUCCUGUUUGACAGGAUCGCCGGGUUCCCGAA,21,13,23,22,79
2135,8,AATC01005788.1/229-145,UUUUGUAAAAGGCAAAAUAAAUGAAAAUUUAUGACGCAAAGCCAAGGUCUAAGAGCUAUAUGCUUAUGAUAGCUAGGUUGCACAA,34,23,17,11,85
2136,8,ABCH01000059.1/9246-9159,UCACGCACAGGGCAAACCACUUGAAAGGGUGGGACGCAAAGCCACCGGCCUAAACCAAAUUUAUUUGAUAGGUAGCGGGGUUACCGAU,27,16,24,21,88
2137,8,CP000002.3/378607-378693,AGCAGAUAAAGGCAAACCUGCGGAAACGCAGGGACGCAAAGCCAUGGCCUAAGGUGCUGACGGUGCUACGGUUGACAGGUUGCCGAA,26,12,29,20,87
2138,8,CP000382.1/1871611-1871526,CAACGAUAAAGGCAAAUUUAGUGAAAACUAGAGACGCAAAGCUAAAGGGCCUUCCUUAGUUAUUAAGAUGGCAGCCAGUUACCGAA,33,18,19,16,86
2139,8,AAWD01000198.1/2303-2217,UCACGCACAGGGCAAACCAUUCGAAAGAGUGGGACGCAAAGCCUCCGGCCUAAACCAGAAGACAUGGUAGGUAGCGGGGUUACCGAU,27,12,26,22,87
2140,8,AAWE01000118.1/3454-3368,UCACGCACAGGGCAAACCAUUCGAAAGAGUGGGACGCAAAGCCUCCGGCCUAAACCAGAAGACAUGGUAGGUAGCGGGGUUACCGAU,27,12,26,22,87
2141,8,AE003852.1/1860690-1860776,UCACGCACAGGGCAAACCAUUCGAAAGAGUGGGACGCAAAGCCUCCGGCCUAAACCAGAAGACAUGGUAGGUAGCGGGGUUACCGAU,27,12,26,22,87
2142,8,AAUT01000003.1/5810-5896,UCACGCACAGGGCAAACCAUUCGAAAGAGUGGGACGCAAAGCCUCCGGCCUAAACCAGAAGACAUGGUAGGUAGCGGGGUUACCGAU,27,12,26,22,87
2143,8,CP000142.2/1987037-1987116,UCCCGAUAAAACCAAACCUGUCGCAAGACAGGGACGGAAAGCAACGGAUCUUCGAACCAGAAGAUGGCCGAGCUGCCGAA,28,9,21,22,80
2144,8,AAKJ02000030.1/26337-26423,UCACGCACAGGGCAAACCAUUCGAAAGAGUGGGACGCAAAGCCUCCGGCCUAAACCAGAAGACGUGGUAGGUAGCGGGGUUACCGAU,26,12,27,22,87
2145,8,AAKI02000072.1/12068-12154,UCACGCACAGGGCAAACCAUUCGAAAGAGUGGGACGCAAAGCCUCCGGCCUAAACCAGAAGACGUGGUAGGUAGCGGGGUUACCGAU,26,12,27,22,87
2146,8,AATY01000002.1/114977-114891,UCACGCACAGGGCAAACCAUUCGAAAGAGUGGGACGCAAAGCCUCCGGCCUAAACCAGAAGACGUGGUAGGUAGCGGGGUUACCGAU,26,12,27,22,87
2147,8,AAUU01000047.1/27433-27347,UCACGCACAGGGCAAACCAUUCGAAAGAGUGGGACGCAAAGCCUCCGGCCUAAACCAGAAGACGUGGUAGGUAGCGGGGUUACCGAU,26,12,27,22,87
2148,8,AAUR01000002.1/72158-72244,UCACGCACAGGGCAAACCAUUCGAAAGAGUGGGACGCAAAGCCUCCGGCCUAAACCAGAAGACGUGGUAGGUAGCGGGGUUACCGAU,26,12,27,22,87
2149,8,AAWF01000029.1/2517-2603,UCACGCACAGGGCAAACCAUUCGAAAGAGUGGGACGCAAAGCCUCCGGCCUAAACCAGAAGACGUGGUAGGUAGCGGGGUUACCGAU,26,12,27,22,87
2150,8,CP000627.1/1413802-1413888,UCACGCACAGGGCAAACCAUUCGAAAGAGUGGGACGCAAAGCCUCCGGCCUAAACCAGAAGACGUGGUAGGUAGCGGGGUUACCGAU,26,12,27,22,87
2151,8,AAWG01000002.1/25205-25291,UCACGCACAGGGCAAACCAUUCGAAAGAGUGGGACGCAAAGCCUCCGGCCUAAACCAGAAGACGUGGUAGGUAGCGGGGUUACCGAU,26,12,27,22,87
2152,8,AAEN01000023.1/138415-138499,CAGCGAGAAAGGCAAACUGAUGGAAACAUUAGGACGCAAAACUACAGGAGCUAAGGCCGAAAGGCUACGCUAGCCAGUUACCGGA,32,10,24,19,85
2153,8,AE017355.1/421273-421357,CAGCGAGAAAGGCAAACUGAUGGAAACAUUAGGACGCAAAACUACAGGAGCUAAGGCCGAAAGGCUACGCUAGCCAGUUACCGGA,32,10,24,19,85
2154,8,AAAC01000001.1/914180-914264,CAGCGAGAAAGGCAAACUGAUGGAAACAUUAGGACGCAAAACUACAGGAGCUAAGGCCGAAAGGCUACGCUAGCCAGUUACCGGA,32,10,24,19,85
2155,8,AE017225.1/397305-397389,CAGCGAGAAAGGCAAACUGAUGGAAACAUUAGGACGCAAAACUACAGGAGCUAAGGCCGAAAGGCUACGCUAGCCAGUUACCGGA,32,10,24,19,85
2156,8,AAER01000042.1/136402-136318,CAGCGAGAAAGGCAAACUGAUGGAAACAUUAGGACGCAAAACUACAGGAGCUAAGGCCGAAAGGCUACGCUAGCCAGUUACCGGA,32,10,24,19,85
2157,8,AE017334.2/397292-397376,CAGCGAGAAAGGCAAACUGAUGGAAACAUUAGGACGCAAAACUACAGGAGCUAAGGCCGAAAGGCUACGCUAGCCAGUUACCGGA,32,10,24,19,85
2158,8,AAES01000043.1/103414-103498,CAGCGAGAAAGGCAAACUGAUGGAAACAUUAGGACGCAAAACUACAGGAGCUAAGGCCGAAAGGCUACGCUAGCCAGUUACCGGA,32,10,24,19,85
2159,8,AE016879.1/397292-397376,CAGCGAGAAAGGCAAACUGAUGGAAACAUUAGGACGCAAAACUACAGGAGCUAAGGCCGAAAGGCUACGCUAGCCAGUUACCGGA,32,10,24,19,85
2160,8,AAEQ01000043.1/90673-90589,CAGCGAGAAAGGCAAACUGAUGGAAACAUUAGGACGCAAAACUACAGGAGCUAAGGCCGAAAGGCUACGCUAGCCAGUUACCGGA,32,10,24,19,85
2161,8,CP000001.1/414665-414749,CAGCGAGAAAGGCAAACUGAUGGAAACAUUAGGACGCAAAACUACAGGAGCUAAGGCCGAAAGGCUACGCUAGCCAGUUACCGGA,32,10,24,19,85
2162,8,AAEO01000030.1/151854-151938,CAGCGAGAAAGGCAAACUGAUGGAAACAUUAGGACGCAAAACUACAGGAGCUAAGGCCGAAAGGCUACGCUAGCCAGUUACCGGA,32,10,24,19,85
2163,8,AAEP01000046.1/103744-103828,CAGCGAGAAAGGCAAACUGAUGGAAACAUUAGGACGCAAAACUACAGGAGCUAAGGCCGAAAGGCUACGCUAGCCAGUUACCGGA,32,10,24,19,85
2164,8,AAMR01000021.1/11847-11762,UCACGCACAGGGCAAAUCACUUGAAAGAGUGAGACGCAAAGCUUCCGGCCUAAACCACUCGUUGGUAUGGUAGCGGGGUUACCGAU,24,17,24,21,86
2165,8,AAZW01000020.1/21384-21469,UCACGCACAGGGCAAAUCACUUGAAAAGGUGAGACGCAAAGCUUCCGGCCUAAACCACUCGUUGGUAUGGUAGCGGGGUUACCGAU,24,17,24,21,86
2166,8,AAEK01000003.1/195166-195078,GAAAUAAAUCGGCACACUAUUCGAAAGGAUAGGUCGCAAAGCUAAGAGUCUAAGGUAAUACAUAUUACUAUGAUAGUCUGGUUGCAAUU,33,24,19,13,89
2167,8,AAPS01000039.1/21459-21548,UCACGCACAGGGCAAACCAUUCGAAAGAGUGGGACGCAAAGCCUCCGGCCUGAACCAUAUUACGAUAUGGAAGGUAGCGGGGUUACCGAU,27,15,26,22,90
2168,8,AAWQ01000045.1/17416-17505,UCACGCACAGGGCAAACCAUCCGAAAGGGUGGGACGCAAAGCCUCCGGCCUGAACCAUAGUAGUAUAUGGAAGGUAGCGGGGUUACCGAU,26,14,28,22,90
2169,8,BA000031.2/1078742-1078653,UCACGCACAGGGCAAACCAUCCGAAAGGGUGGGACGCAAAGCCUCCGGCCUGAACCAUAGUAGUAUAUGGAAGGUAGCGGGGUUACCGAU,26,14,28,22,90
2170,8,CP000103.1/2175552-2175465,AUCUGUAAAAGGCAAAUCUCGCGAAAGCGGGGGACGCAAAGUCAUCGGUCUACCGGGCUCAAGGCCCCAGGACGGCAGGACUGCCAGA,25,11,28,24,88
2171,8,CP000312.1/1445209-1445126,UUUAAAAUUCGGCAAAAUUAGAGAAAUCUAAUGACGCAAAGCUAUAGGGACUAAGGUUUAUAACUAUGUCAGCCAGUUGCCAAA,33,22,16,13,84
2172,8,CP000698.1/247508-247587,CCGACGAAAAGGCAAAGCACGGGCAACCGUGUGACGCAAAGCUACCUGUCCAGUUGCAACUGGAUAGAGGGGCUGCCGAA,24,10,25,21,80
2173,8,AAKK02000061.1/16343-16432,UCACGCACAGGGCAAACCAUUCGAAAGGGUGGGACGCAAAGCCUCCGGCCUGAACCAUAAUACUAUAUGGAAGGUAGCGGGGUUACCGAU,27,15,26,22,90
2174,8,CP000510.1/1867279-1867369,GCUGGAAAAAAGCAAAUUAAGGGAAACCUUAAUACGCAAAACCACCGGCCUGUUGAUUGACUAUUUAGUCUAUGGCAGCGGAGUUACCAAG,32,20,21,18,91
2175,8,AE017194.1/504284-504368,CAGCGAGAAAGGCAAACUGGUGGAAACAUUAGGACGCAAAACUACAGGAGCUAAGGCCGAAAGGCUACGCUAGCCAGUUACCGGA,31,10,25,19,85
2176,8,CP000606.1/1879203-1879288,CUCUCGAAACGGCAAGCAUUAAGUAAUUAAUGUACGCAAAGCCACAGGCCCUAAUUGCAUAGCAAAAGGGUGGCUGGGUUACCGAA,29,17,21,19,86
2177,8,AAWP01000006.1/124156-124245,UCACGCACAGGGCAAACCAUUCGAAAGGGUGGGACGCAAAGCCUCCGGCCUGAACCAUCGAAUUAGAUGGAAGGUAGCGGGGUUACCGAU,26,14,28,22,90
2178,8,BA000037.2/2327906-2327994,UCACGCACAGGGCAAACCAUUUGAAAAAGUGGGACGCAAAGCCUCCGGCCUAAACCAGACGUUUUUUGGUAGGUAGCGGGGUUACCGAU,25,18,25,21,89
2179,8,AY855346.1/29246-29151,AAACUAAAUCGGCAAAACUAGAGAAAUUUAGUGACGCAAAGCUAUAGGGACUAAGAUUUAUAAAAUUCUUAUAAAUUAUGCCAGCCAGUUGCCAAA,41,24,16,15,96
2180,8,CP000116.1/532900-532975,AUCCCGAAAGGGCAAACCCGCCGCGAGGCGGGGGCGCAAAGCGACCGGUCUCGAAAGAGAUAGCGGCGCUGCCGUG,18,6,29,23,76
2181,8,CP000148.1/824437-824354,UUUCCGAAAGGGCAAACUUCGGGUAACCGGGGGACGCAAAGCCACGGGUCCUGACUCCAUGGUCAGGAUAGCCGGGUUGUCGAA,20,15,28,21,84
2182,8,AE016877.1/408156-408240,CAGCGAGAAAGGCAAACUGAUGGAAACAUGAGGACGCAAAACUACAGGAGCUAAGGUCGAAAGGCUACGCUAGCCAGUUACCGGA,32,10,25,18,85
2183,8,CP000109.2/325943-326021,AGAAAAUUUUGCCAAACUUGUUGUGAAGCAAGGACGGAAAGCCAUGGGUCUCAAUGGUUGAGAUCGCCAGGUUGCCAAA,25,18,22,14,79
2184,8,AE017180.1/1100143-1100060,UUUUCGAAGAGGUAAACCCCGGGUAACCGGGGGGCACAAAGCUGCGGGUCCCGCCUGAAACAGCGGGACAGCCGGGUUGGCGAA,20,11,31,22,84
2185,8,AANZ01000050.1/14174-14099,CCUCGAAAAAGGCAAACCGAUCGUGAGGUCGGGACGCAAAGCCAAGGGCCACGUAAGUGGACGCCAGGCUGCCGAA,23,7,25,21,76
2186,8,CP000450.1/861386-861306,AACCGACAAAGGCCAACCUGUCGUGAGGCAGGGGCGCAAAGUUUCCGAUCCUGAUUGCAUCAGGAAAGCGGGACUGCCGAA,23,12,25,21,81
2187,8,AAOW01000010.1/54987-54913,CUCUCGAAAAGGCAAAACCCGAGUAAUCGGGUGACGCAAAGUCACGGGUCCCAAUGGGACAGCCGGACCGCCACA,23,8,21,23,75
2188,8,AP009179.1/1220413-1220339,UCUAAUAUAUGCCAAACCUGUUGCGAAACAGGGACGGAAAGCCACGGGUCUCAUGAAGAUAGCCGGGUUGCCAGA,23,14,21,17,75
2189,8,AL954747.1/1707540-1707622,AACCGACAAAGGCUAAUCUGUCGUAAGGCAGGGGCGCAAAGUUUCCGGUCCUGAUCCAUGAUCAGGAAAGCGGGACUGCCGAA,24,14,25,20,83
2190,8,AAMX01000014.1/21204-21112,UUGUUUAACUGCCAAACUCAUCGCGAGAUGAGGACGGAAAGCCACGGGUCUCAGAGUGUGUUGAGAUGUAUCUCAGAUAGCCGGGUUGCGGAA,24,22,29,18,93
2191,8,CP000302.1/2534228-2534317,UGCUGUGGAAGGCAAACCAGUUUUAAAGACUGGGACGCAAAGCCUCCGAUCUAAAGGUUUGCUUGUACCUAUGAUAGCGGGGAUCCCACA,25,21,24,20,90
2192,8,CP000503.1/3966333-3966251,CUGACGAACAGGUACACCCGUUGUGAGACGGGGUCGCAAAGCUUCGGGUCUUGAUUUUUUAUUAAGAUAGCCGGGUUGCCGAA,19,22,25,17,83
2193,8,CP000284.1/503076-502984,AAAUGUUAAGGGCAACCUUGGUUGAAAAACCAAGGACGCAAAGUCACCGGUCUAAGGUAAGCAGCUUGCUACUAUGACAGCGGAACCGCCAUA,32,17,23,21,93
2194,8,AE015927.1/477013-477088,CCACGAUAAAGGCAAAACUAUUGAAAGAUAGUGACGCAAAGCUAUAGGGUCUGUAAAAUGACAGCCAGUUAUCGAA,31,15,17,13,76
2195,8,AP006840.1/3227495-3227385,CAGCGAUAAAGGCACACCCGCCGAAAGACGGGGCCGCAAAGCCACGGGGCUACAGGAAGCGGGCGCCGCCCUGCCGGGUCUCCCGCCUCCCAUGCUAGCCGGGCUGCCGCU,21,10,37,43,111
2196,8,AAXV01000001.1/231054-230969,GGGAAAGAUAGGCAAAUUUACUAAAAAGUAAAGAUGCAAAGCUACAGGUCUAAGGGAAUAAGUACUUAGAUGGCUAGGUUGCAAAA,37,18,22,9,86
2197,8,CP000282.1/989437-989348,CAACGAUAAAGGCAAACCCGCGGUAACGUGGGGACGCAAAGCCAGUGCCCAACUACUUGUAAUUUAAGAUUGGGUCGAACGGUUACCGAA,29,16,24,21,90
2198,8,BX842649.1/31567-31484,UUUGCCUCAAGGCAAACCGUCGGAAACGGCGGGACGCAAAGCUAAAGGGGUGUCGGUGCAAAGCCACGCCAGCCAGCUGCCAAA,24,10,26,24,84
2199,8,CP000267.1/4400341-4400428,CAAGUUCAAAAGCACACCCGAUCGAAAGACGGGGUCGCAAAGCUUCCGGCCUGACGCAUUCGUGCGAAGUGGUAGCGGGGUUGCCCAA,23,14,27,24,88
2200,8,AAXY01000014.1/263-343,CUAACCAGCAGCCAAACCAUUUGUGAGGAUGGGACGGAAAGCCAAGGAUCUCUGGGGAAAAGAGACAGCCUGGUUGCCUAG,25,13,25,18,81
2201,8,BA000004.3/597582-597667,CCUUGAAAAAGGCGAGUGUUUGAAAUGGAAAGACGCAAAGCUGCGAGUCUGAAAUCCUUCUGAAUAGGGAUAGUCGAGUUGUCAAA,29,20,24,13,86
2202,8,BX294141.1/222899-223010,CCCUGACAAAGGCAAACCGUUCGAGAGGACGGCACGCAAAACCACGGGUCCGUGAGUCGGUCGAUCGCAUUGUUUGCGUUCGGCUUGGCUUCAGGAAAGCCGAGUUGCCGUG,24,22,36,30,112
2203,8,CP000112.1/841128-841197,CGAGAAUCAAGCCAACCCGCCUCAGGCGGGACGGAAAGCCACGGGUCUUUCAGACAGCCGGGUUGCCUCG,16,9,22,23,70
2204,8,CP000764.1/420958-421045,GGGCGAGAAAGGCAAACUCGUGGAAACAUAAGGCUGCAAAACUGUAGGGCUUAAGGUCAAGAGAAGGCGAAGCUAGUCAGUUACCGAA,32,13,28,15,88
2205,8,CP000251.1/2466924-2466841,CACGCUUCAGGGCAAUUCACCCGUACCCAGGGUGAAGCGCAAAGCCGCGGGUCCGGUGAACGCCGGACGGCCGUGGCCGCCGUG,15,10,30,29,84
2206,8,CT573072.1/491002-491095,GAUUGAAAAAGGCAAACCAACCGCAAGUUUGGGACGCAAAGCCAUGGGUCUUAAGCGUGAGUUCUUUAUACGUAAAGAUUGCCAGGUUGCCGAA,30,21,25,18,94
2207,8,DQ898548.1/1361-1448,CCCGUUUCAGGGCAAACUCACCGAAAGGUGGGGACGCAAAGCCUCCGGUCUACGGGACGCAUGUGCCUAUGACAGCGGGGUUGCCGGU,18,15,30,25,88
2208,8,CP001186.1/4695548-4695460,AAAAUAAAUGGGCACACUGUUCGAAAGAAUAGGUCGCAAAGCUAAGAGUCUAAGGUAAUAAAAAUUACUAUGAUAGUCUGGUUGCAGUU,35,23,20,11,89
2209,8,ABDT01000056.2/21523-21607,AAGUAUUAAUGGCAAAAUUAGAGAAAUCUAAUGACGCAAAGCUAUAGGAGCUAAAGUUAAAAAACUAUGCUAGCCAGUUGCUAAC,37,20,16,12,85
2210,8,CP000853.1/1736753-1736673,ACAAUAAAUGGGCAAACCUAGGGACGCAAAGCUUGAGUCUACGGUUAUCUCAAAGAUAAUUACGAUCGUUCAGCUGCAUAG,28,19,18,16,81
2211,8,CP000821.1/3858383-3858465,CUACGAUAAAGGCAAAACCGGGGUAACCCGGCGACGCAAAACCAGUGCCCAGGCAGAGAUGCGGGGGUCGAACGGUUACCGAA,26,8,27,22,83
2212,8,CP000891.1/3806662-3806574,GCGUGUAAAAGGCAAACCAGUUGAAAAACUGGGACGCAAAGCCUCCGGUCUAAGGGUUCGUCUGUACCUAUGAUAGCGGGGAUACCACA,27,17,25,20,89
2213,8,CP001336.1/1127881-1127794,AUUCGACAAUAGCAAACCUGGCGAAAGCCAGGGACGCAAAGCUAUGGGUCUUCCUGGAUACACUCCUGAUGAUCGCCAAGCUACCGAA,27,16,21,24,88
2214,8,CP000923.1/2190645-2190558,UGUUGAAAAAGGCAAACUCGUCGAAAGGCGGGGACGCAAAGCCACGGGUCUAAAGCGAUAGUUUUGCUAUGAUAGCCGGGCUGCCAAC,26,16,27,19,88
2215,8,CP000885.1/1430070-1430158,UUAUAAAUUUAGCAAACUAAUUGAAAGAUUAGGACGCAAAGCUAUGGGUCUAAGGAUAUCAUAAUAUCAACGAUUGCCAGGUUACAGAA,36,24,17,12,89
2216,8,CP001176.1/4733001-4732913,AAAAUAAAUGGGCAUACUAUUCGAAAGGAUAGGUCGCAAAGCUAAGAGUCUAAGGUAAUGAAAAUUACUAUGAUAGUCUGGUUGCAGUU,34,24,21,10,89
2217,8,CP001215.1/397645-397729,CAGCGAGAAAGGCAAACUGAUGGAAACAUUAGGACGCAAAACUACAGGAGCUAAGGCCGAAAGGCUACGCUAGCCAGUUACCGGA,32,10,24,19,85
2218,8,ABCC02000002.1/64098-64013,AAAAAUAAUUAGCAAAACUGGUGAAAGCUAGUGACGCAAAGCUACAGGGAUUUCUCUCUAAAAAGAGGUGUCAGCCAGCUGCAUGA,33,18,20,15,86
2219,8,ABED02000012.1/2557-2651,GCAAUUUUUUGGCAAACUUGUCGAAAGGCAAGGACGCAAAGCCAUAGGGGCUAAGGUUCGGGGCAUUUCCCGGAUGAUGCCAGCCGGUUGCUUCC,22,22,29,22,95
2220,8,CP001052.1/1667937-1667858,GCGCAGUUUGGGCAAACCCGGAGCGAUCCGGCGACGCAAAGCUACAGGGACUCCCUUGCGGGAGUUUGCCAGUUGCCCGC,15,13,27,25,80
2221,8,CP000859.1/2080979-2081056,UCAUGCUAAAGCCAAACUCCGGGCGACCGGAGGACGGAAAGCAACGGGUCUUAAUAUAAAGACAGCCGGGCUGCCAUG,24,11,23,20,78
2222,8,AE008691.1/706140-706227,CUUCGAUAAGGGCAAACCCGUCGAAAGGCGGGGGCGCAAAGCCACGGGCCUAAAUCCCUGAUUGGGACAUGGUAGCCGGGCUGCCGAA,22,12,30,24,88
2223,8,CP001177.1/464065-464149,CAGCGAGAAAGGCAAACUGGUGGAAACAUUAGGACGCAAAACUACAGGAGCUAAGGCCGAAAGGCUACGCUAGCCAGUUACCGGA,31,10,25,19,85
2224,8,CP000961.1/1418939-1419059,AAUGUACAAAGGCAAACCAAUCGAAAGGUUGGGACGCAAAGCUUCCGGUCUAAGGGGAUAGUGUUUGAGAGGGUCGCACUCUUAACGUUAUUUUGGUACCUAUGAUAGCGGGGAUGUUACA,35,31,35,20,121
2225,8,ABAX03000005.1/232139-232052,AAUUUUCAUCGGUAAAGCUGCCGAAAGGCAGUGACACAAAGCCAAGGGUCUAAAGUCUUACAUAAGACUAUGACAGCCGGUUGCCACA,30,18,20,20,88
2226,8,CP001089.1/2534834-2534760,UCACCGAAAAGGCAAAAUCCAGGGGACUGGAUGACGCAAAGCCACCUACCCGGACCGGGAAGAGGGGUUACCGAA,25,7,23,20,75
2227,8,CP000903.1/416914-416998,CAGCGAGAAAGGCAAACUUAUGGAAACAUGAGGACGCAAAACUACAGGAGCUAAGGUCGAAGGGCUAAGCUAGCCAGUUACCGGA,32,11,25,17,85
2228,8,CP001233.1/1807824-1807910,UCACGCACAGGGCAAACCAUUCGAAAGAGUGGGACGCAAAGCCUCCGGCCUAAACCAGAAGACAUGGUAGGUAGCGGGGUUACCGAU,27,12,26,22,87
2229,8,CP000924.1/1541170-1541083,UGUUGAAAAAGGCAAACUCGUCGAAAGGCGGGGACGCAAAGCCACGGGUCUAAAGCGAUAGUUUUGCUAUGAUAGCCGGGCUGCCAAC,26,16,27,19,88
2230,8,CP000884.1/4023666-4023571,UUUGCGCACCAGCACACCCGUACGAAAGGCGGGGUCGCAAAGCCUCCGGUCUACCCCCGCCCUUUGACGGGCGGGCAUGACAGCGGGGUUGCCAGG,17,14,32,33,96
2231,8,CP001098.1/769828-769735,CUCCGGAAAUGGUAAACCCAUCGAAAGGUGGGGACACAAAGUCACGGGCCUGUAGCCGGUUAUUUUUAACCGGUAUGGCAGCCGGACUGCCGAA,25,18,28,23,94
2232,8,CP001139.1/1780753-1780835,UCACGAACAUGGCAAACUACAUGAAAAUGUAGGACGCAAAGCUUCCGGCCUAAGUAUUUAUAUAAGGUAGCGGGGUUGCCGAC,27,18,21,17,83
2233,8,CP001124.1/2736237-2736160,CACACGAAAAGGCAAACCCAGGGUAACCUGGGGACGCAAAGCCACCUGUCCAGCAUUCUGGAAAGAGGGGUUGUCGAA,25,10,23,20,78
2234,8,CP000851.1/4449140-4449058,UGAUGAAAAAGGCAAAACCUGUGAAAGCAGGUGACGCAAAGCAUCCAGCCUAAGGGGACACCUAUGGCAGUGGCGCUACCGCA,28,11,24,20,83
2235,8,CP001390.1/3356677-3356601,UAACGAUAAUACUAAACCAUUCGCGAGAAUGGGGCGGAAAGCCUAUAGGGUCUCAAGCAGACAGCCGGGUUGCCGAA,25,13,22,17,77
2236,8,CP001598.1/397192-397276,CAGCGAGAAAGGCAAACUGAUGGAAACAUUAGGACGCAAAACUACAGGAGCUAAGGCCGAAAGGCUACGCUAGCCAGUUACCGGA,32,10,24,19,85
2237,8,CP003056.1/2189771-2189855,AAUUGAAAAAGGCAAAUUCAUCGAAAGGUGGAGACGCAAAGCUAAAGGGACUAAAGUCAGAUGACCAUGUCAGCCAGUUACCGAU,34,15,21,15,85
2238,8,CP002457.1/712651-712733,CUGACGAACAGGUACACCCGUUGUGAGACGGGGUCGCAAAGCUUCGGGUCUUGAUUUUUUAUUAAGAUAGCCGGGUUGCCGAA,19,22,25,17,83
2239,8,CP002469.1/1123237-1123149,UCACGCACAGGGCAAACCAUUUGAAAAAGUGGGACGCAAAGCCUCCGGCCUAAACCAGACGUUUUUUGGUAGGUAGCGGGGUUACCGAU,25,18,25,21,89
2240,8,AAKH03000018.1/618060-617954,GUCACACUUUGGCAAACCCUUUGAAAAAAUGGGACGCAAAGCCUCCGGUCUGUCGGUCAAGAAAGCUCAUAAAGCCCUCUUACACCUAGGAUAGCGGGGUUACCAAU,32,23,24,28,107
2241,9,U27202.1/210-335,AAUAAUCUUCAGGGCAGGGUGAAAUUCCCGAUCGGCGGUAAAGUCCGCGAGCCGAACGAAAAAGGUUUGGCAGGAACCGGUGAGAUUCCGGUACCGACAGUAUAGUCUGGAUGGAAGAAGAUGAAA,40,23,40,23,126
2242,9,M64472.1/901-1048,GCUUAUUCUCAGGGCGGGGCGAAAUUCCCCACCGGCGGUAAAUCAACUCAGUUGAAAGCCGCGAGCGCUUUGGGUGCGAACUCAAAGGACAGCAGAUCCGGUGUAAUUCCGGGGCCGACGGUUAGAGUCCGGAUGGGAGAGAGUAACG,36,27,50,35,148
2243,9,AJ009832.1/4549-4670,GAUCGCUCUCGGGGCAGGGUGGAAUUCCCGACCGGCGGUGAAAGCCCGCGAGCCCCCUUCUGGGGGUUGACCCGGUGGAAUUCCGGGGCCGACGGUGAAAGUCCGGAUGGGAGAGAGCGAAG,22,18,50,32,122
2244,9,AL939108.1/337004-336876,CAGCGCACUCCGGGGUCGGUGAAAGUCCGAACCGGCGGUUACAGUCCGCGACCCGGUCGCCUCCAGCGACCGGUUGACCAGGUGAAAUUCCUGGACCGACGGUUAAAGUCCGGAUGGGAGGCAGUGCGC,25,20,45,39,129
2245,9,L09228.1/7992-8136,UUGUAUCUUCGGGGCAGGGUGGAAAUCCCGACCGGCGGUAGUAAAGCACAUUUGCUUUAGAGCCCGUGACCCGUGUGCAUAAGCACGCGGUGGAUUCAGUUUAAGCUGAAGCCGACAGUGAAAGUCUGGAUGGGAGAAGGAUGAU,36,33,48,28,145
2246,9,X51510.1/938-1082,UGUAUCCUUCGGGGCAGGGUGGAAAUCCCGACCGGCGGUAGUAAAGCACAUUUGCUUUAGAGCCCGUGACCCGUGUGCAUAAGCACGCGGUGGAUUCAGUUUAAGCUGAAGCCGACAGUGAAAGUCUGGAUGGGAGAAGGAUGAU,36,32,48,29,145
2247,9,X95955.1/376-523,UGUAUCCUUCGGGGCUGGGUGAAAAUCCCGACCGGCGGUAAUAAGGCGCUCCUGCGCUUUACAGCCCGUGACCCGUAUGCAUCUGUAUACGGUGGAUUCAGUGAAAAGCUGAAGCCGACAGUGAAAGUCUGGAUGGGAGAAGGAUGAG,36,32,48,32,148
2248,9,AJ010128.1/362-218,CAGCAUCUUCGGGGUCGGGUGAAAUUCCCAACCGGCGGUGAUGAAGUGCAAACUUCUAAGUCCGUGACCCGUUUUCAACUCGAAAACGGUGGAUCUAGUGAAACUCUAGGGCCGACAGUAUAGUCUGGAUGGGAGAAGGAUAUGU,38,34,43,30,145
2249,9,AF269345.1/3001-2863,UAUUUCUUUCGGGGCAGGGUGAAAUUCCCAACCGGCAGUAAAUUGAGCCUGCGACCCACUAAUAUUGUUUUUGAUGUUAGUGGCUGAUCUAGUGUGAAUCUAGAGCCGACAGUUAGAGUCUGGAUGGGAGAAAGAAGUU,36,41,39,23,139
2250,9,AL591981.1/267609-267487,GUUCAUCUUCGGGGCAGGGUGCAAUUCCCGACCGGUGGUUAAAGUCCACGAUCUGCUUUUUUAGCAGUUGACUCUGGUGUAAUUCCAGGACCGACAGUAUAGUCUGGAUGGGAGAAGAUGUUG,26,36,37,24,123
2251,9,AL596170.1/284996-284874,GUUCAUCUUCGGGGCAGGGUGCAAUUCCCGACCGGUGGUUAAAGUCCACGAUCUGCUUUCUUAGCAGUUGACUCUGGUGUAAUUCCAGGACCGACAGUAUAGUCUGGAUGGGAGAAGAUGUUG,26,35,37,25,123
2252,9,AL766851.1/11027-10882,AGGUGUCUUCAGGGCAGGGUGUAAUUCCCGACCGGCGGUAAUCGCUUCCAACUUAUUUGUCAGUUGUGAAGCAUCAGUCCGCGAGCGAAAGCUGAUGUGGUGAGAUUCCACAACCGACAGUAAAGUCUGGAUGGGAGAAGACAAAG,39,33,44,30,146
2253,9,AL766847.1/1-103,CUUCGGGGUCAGGUGAAAAUCCUAACCGGCGGUAUAGUCCGCGAGCUUUCGAGCAUGAACUGGUGUGAUUCCAGUACCGACAGUAAAGUCUGGAUGAGAGAAG,27,23,32,21,103
2254,9,AF269712.1/1300-1435,AUUCAUCUUCGGGGUAGGGUGUAAUUCCCAACCGGCAGUAAUCUAAGCCUGCGACGACAACGUAUUAAUUUUUGCUUUGUCUUGAUUCAGUGAGAGUCUGAAGCCGACAGUAUAGUCUGGAUGGGAGAAGAUGGAG,35,39,38,24,136
2255,9,AP008934.1/1304561-1304696,AUUCAUCUUCGGGGUAGGGUGCAAUUCCCAACCGGCAGUAAAUAAAGCCUGCGACCCAUUUUAUUAUAUAUAAUAAAAUGGCUGAUCUAGUGAAAAUCUAGAGCCGACAGUAAAGUCUGGAUGGGAGAAGAUGGAG,45,34,34,23,136
2256,9,CP000705.1/931807-931947,AAUUUUCUUCGGGGCAGGGUGAAAUUCCCAACCGACGGUAACAAGUACGCUUGGAGUCCGUGACCCGUUAGCAUUUAUGUUAACGGUUGAACCAGUGAAAAUCUGGUACCGACAGUAUAGUCUGGAUGGGAGAAGAAAACU,41,35,38,27,141
2257,9,CP000046.1/1565491-1565357,AUUCAUCUUCGGGGUCGGGUGUAAUUCCCAACCGGCAGUAAAUAAAGCCUGCGACCUGCUAGUAUGUAUCAUAUUAGUGGCUGAUCUAGUGAGAUUCUAGAGCCGACAGUAUAGUCUGGAUGGGAGAAGAUGGAG,36,36,39,24,135
2258,9,CP000703.1/1951702-1951567,UAAUUCUUUCGGGGCAGGGUGAAAUUCCCAACCGGCAGUAAAUAAAGCCUGCGACCUGCUAAUAUGUUUCAUAUUAGUGGCUGAUCUAGUGAGAUUCUAGAGCCGACAGUUAAAGUCUGGAUGGGAGAAAGAAUGU,40,37,36,23,136
2259,9,ABCH01000022.1/43466-43613,UUUUAUUCUCAGGGCGGGGCGAAAUUCCCCACCGGCGGUAAAUCAAUGUUUGAUAAGCCCGCGAGCGCUUAACUUUAUGGAGUUAAGGUCAGCAGAUCUGGUGAGAAUCCAGAGCCGACGGUUAAAGUCCGGAUGGGAGAGGAUAAUG,39,35,45,29,148
2260,9,ABDQ01000002.1/179883-180005,UAGUAUCUUCAGGGCAGGGUGUAAUUCCCGACCGGCGGUUAAAGUCCGCGAGCUUUAUUUUUAUAUGGCUGAUUUGGUGAAACUCCAAAACCGACAGUAAAGUCUGGAUGAGAGAAGGUAUAG,34,34,34,21,123
2261,9,ABCF01000046.1/1602-1738,AUUCGUCUUCGGGGCAGGGUGUAAUUCCCGACCGGCGGUAAUGAAUGAUUUCAUUCUAAGCCCGCGAGCCUGUUGUUUGGGCAGGAUUUGGUGAGAUUCCAAAGCCGACAGUAUAGUCUGGAUGGGAGGAGAUGAAG,31,36,45,25,137
2262,9,AAEK01000025.1/41573-41430,AGCAUCCUUCGGGGUCGGGUGAAAUUCCCAACCGGCGGUGAUGAAGUGCAAACUUCUAAGUCCGUGACCCGUUUUCAAAUCGAAAACGGUGGAUCUAGUGAAAUUCUAGGGCCGACAGUAUAGUCUGGAUGGGAGAAGGAUAUG,39,34,43,28,144
2263,9,AAOX01000016.1/69993-70130,GUCUAUCUUCGGGGCAGGGUGAAAUUCCCGACCGGCGGUGAUGAGGCAAGUUGCUCUAAGCCCGCGAGCCUGUUUUAUUGGGCAGGAUUUGGUGAGAUUCCAAAGCCGACAGUACAGUCUGGAUGGGAGAAGAUGGAG,31,32,48,27,138
2264,9,CP000771.1/1532327-1532468,GGGUACUCUCGGGGCAGGGUGAAAUUCCCGACCGGCGGUGAAAGCCCGCGAGCCUUCCGAAAGUUUUUAAGUUUUUUGUAGGAAGGUUGAUCCGGUGGAAUUCCGGAGCCGACGGUGAAAGUCCGGAUGGGAGAGAGUACCA,32,31,50,29,142
2265,9,CP000382.1/2191386-2191265,UAGUAUCUUCAGGGCAGGGUGUAAUUCCCGACCGGCGGUUAAAGUCCGCGAGCUAUACUUGGUAUGGCUGAUUUGGUGAGAUUCCAAAACCGACAGUAAAGUCUGGAUGAGAGAAGGUAUAG,33,31,37,21,122
2266,9,CP000557.1/2349127-2348995,UACAUCCUUCGGGGCAGGGUGAAAUUCCCGACCGGCGGUGAUGAGGCCGAAGCCUCUCAGCCCGCGAGCCGUAUAGGCACGAUCCGGUGCGAUUCCGGAGCCGACAGUAUAGUCUGGAUGGGAGAAGGAUGAA,30,23,46,34,133
2267,9,AE017333.1/2382202-2382069,AUCAAUCUUCGGGGCAGGGUGAAAUUCCCUACCGGCGGUGAUGAGCAAGCGCUCUAAGCCCGCGAGCCUUUUUAUGGGCAGGAUUCGGUGCGAUUCCGAAGCCGACAGUAUAGUCUGGAUGGGAGAAGAUGGAG,31,29,45,29,134
2268,9,ABAH01000018.1/164932-164783,AAUAAUCUUCAGGGCAGGGCGAAAUUCCCUACCGGCGGUAACUGCUUAUAGCAGAAGCCCGCGAGCGCUUUCUAAUAAAAAUAGAAAGGUCAAGCAGAUUUGGUGUAAUUCCAAAGCCGACAGUUAAAGUCUGGAUGAAAGAAGAUUGAG,51,33,38,28,150
2269,9,AAOJ01000002.1/922614-922474,AUUAAUUCUCAGGGCGGGGCGAAAUUCCCCACCGGCGGUAUACUUUUCAAGUGAGCCCGCGAGCGCUCGAUAUUUUCGAGGUCAGCAGAUCUGGUUAGAAGCCAGAGCCGACGGUUAUAGUCCGGAUGAGAGAGAAUUGAG,35,32,43,31,141
2270,9,AE000512.1/1804292-1804171,AAACGCUCUCGGGGCAGGGUGGAAUUCCCGACCGGCGGUGAAAGCCCGCGAGCCCUCUCAGGAGGGUUGACCCGGUGGAAUUCCGGGGCCGACGGUGAAAGUCCGGAUGGGAGAGAGCGUGA,25,17,49,31,122
2271,9,CP000716.1/48959-48841,UAGAGUCCUCGGGGCAGGGUGAAAGUCCCGACCGGCGGUGAAAGCCCGCGAGCCCGUUAAGGGUUGAUCCGGUGAAAUUCCGGAGCCGACGGUUAAAGUCCGGAUGGGAGAGGACAAUG,28,19,45,27,119
2272,9,AAKK02000001.1/258130-258269,AAUUGUUCUCAGGGCGGGGCGAAAUUCCCCACCGGCGGUAUACUUUUCAAGUGAGCCCGCGAGCGCUCGAUUCGUCGAGGUCAGCAGAUCUGGUGAGAUGCCAGAGCCGACGGUUAUAGUCCGGAUGAAAGAGAAUAAGA,35,29,44,32,140
2273,9,BA000043.1/1793427-1793295,AUUCAUCUUCGGGGCAGGGUGAAAUUCCCGACCGGCGGUGAUGAGGCGCUUGGCCUCUCAGCCCGCGAGCCGCAAGGCAGGAUCCGGUGCGAGUCCGGAGCCGACAGUAUAGUCUGGAUGGGAGAAGAUGAAG,28,23,49,33,133
2274,9,AAML04000003.1/43960-44077,GAAGAUCUUCGGGGCAGGGUGAAAUUCCCUACCGGCGGUAUAGCCCGCGAACUACUUAGGUGGUUGAUUUGGUGAGAUUCCAAAGCCGACAGUAAAGUCUGGAUGAGAGAAGAUAUUU,32,29,36,21,118
2275,9,AACY022395047.1/599-750,GCUUAUUCUCAGGGCGGGGCGAAAUUCCCCACCGGCGGUAAAUCAACCAUAGCGUUGAAAGCCCGCGAGCGCUUUCUGUGAAAGCAGAAAGGUCAGCAGAUCCGGUGUAAUUCCGGGGCCGACGGUUAAAGUCCGGAUGGGAGAGAGUAACG,39,28,49,36,152
2276,9,BA000016.3/704095-704210,AAAAUUCUUCAGGGCAGGGUGAAAUUCCCUACCGGCGGUAAAGCCCGCGAGCUAGUUUAGCAUGAUUCGGUGAAAUUCCGAGGCCGACAGUAAAGUCUGGAUGAAAGAAGAAUAUC,36,25,32,23,116
2277,9,AP006716.1/1452644-1452770,AUUCAUCUUCGGGGUAGGGUGCAAUUCCCAACCGGCAGUAAAUUAAGCCUGCGACCCGCUUCUUUGAAGUGGCUGAUUCAGUGGAAAUCUGAAGCCGACAGUAUAGUCUGGAUGGAAGAAGAUGGAG,34,31,37,25,127
2278,9,CP000673.1/3663447-3663329,UAUAAUCUUCAGGGCGGGGUGAAAUUCCCCACCGGCGGUAUAGCCCGCGAGCUGCGUGUUCAGCAUGAUUCAGUGAAAUUCUGAAGCCGACAGUAAAGUCUGGAUGGGAGAAGAUAGAA,33,26,36,24,119
2279,9,CP000653.1/3761427-3761277,GCUUAUUCUCAGGGCGGGGCGAAAUUCCCCACCGGCGGUAAAUCAGCCUUGCGCUGAAAGCCCGCGAGCGCUUUGGGUGAAAACCUAAAGGUCAGCAGAUCCGGUGUAAUUCCGGAGCCGACGGUUAGAGUCCGGAUGGGAGAGAGUAACG,36,28,50,37,151
2280,9,AAER01000019.1/1243-1104,GUCUAUCUUCGGGGCAGGGUGAAAAUCCCGACCGGCGGUGAUGAACUAUUUAUGAUUUUGUUCUAAGCCCGCGAGCCGUUAAGGCAGGAUUUGGUGUGAUUCCAAAGCCGACAGUAUAGUCUGGAUGGGAGAAGAUGGAG,34,36,45,25,140
2281,9,AE001437.1/2971922-2971806,AAUGAUCUUCAGGGCAGGGUGAAAUUCCCUACCGGCGGUAUAGCCCGCGAGCCUUUUUAGGUAUGAUCCGGUUUGAUUCCGGAGCCGACAGUAAAGUCUGGAUGAAAGAAGAUAUAU,31,30,33,23,117
2282,9,CP000647.1/3779064-3778913,GCUUAUUCUCAGGGCGGGGCGAAAUUCCCCACCGGCGGUAAAUCAACCAUGGCGUUGAAAGCCCGCGAGCGCUUCCCGUGACUACGGGAAGGUCAGCAGAUCCGGUGUAAUUCCGGGGCCGACGGUUAAAGUCCGGAUGGGAGAGAGUAACG,35,27,51,39,152
2283,9,AAEW02000005.1/32930-33076,CCCUAUUCUCAGGGCGGGGUGAAAUUCCCCACCGGCGGUGACUCCUUGUGAGAAGCCCGCGAGCGCCUUUAUUAUUGGGAUAAAGGGUCAGCAGAUCUGGUGAGAUUCCAGAGCCGACGGUUAUAGUCCGGAUGAAAGAGGAUAUUC,34,34,45,34,147
2284,9,CP000141.1/1316951-1316827,UACUACCUUCGGGGUCAGGUGGAAUUCCUAACCGGCGGUAAAGCCCGCGAGUCCGUAAAAAUUUACGGAUAGAUCCGGUGAAAUUCCGGAGCCGACAGUUAAAGUCUGGAUGGGAGAAGGUAUUA,35,28,37,25,125
2285,9,AM236080.1/2884220-2884370,AAAUGUUCUCGGGGCGGGGUGUAAUUCCCCACCGGCGGUAUCAGGAGCAAUCCUGGAGCCCGCGAGCGCUUCCGGCACCUCCUGUCGGAAGGUCAGCAGAUCCGGUGAGAUGCCGGAGCCGACGGUAUAGUCCGGAUGGAAGAGGACAACA,33,25,52,41,151
2286,9,CP000764.1/1319447-1319591,GUCUAUCUUCGGGGCAGGGUGAAAAUCCCGACCGGCGGUAAUGAAUGAGUAUAUGAAUAUGUGAGUUCUAAGCCCGCGAGCCGUUAAGGCAGGAUUUGGUGCGAUUCCAAAGCCGACAGUACAGUCUGGAUGGGAGAAGAUGGAG,39,32,48,26,145
2287,9,AE015927.1/318413-318527,AAAUAUCUUCAGGGCGGGGUGUAAUUCCCCACCGGCGGUAUAGCCCGCGAGCCGCAAGGCAUGAUUCGGUGUAACUCCGAAGCCGACAGUAAAGUCUGGAUGAAAGAAGGUAUAA,33,22,34,26,115
2288,9,ABCR01000011.1/7978-7832,GAGCGUUCUCAGGGCGGGGUGGAACUCCCCACCGGCGGUAAGCAUCUGUAUUGUGCAAGCCCGCGAGCGCCUCUCUUAUGAGGGGGUCAAGCAGAUCAGGUGAAAUUCCUGAGCCGACGGUUAAAGUCCGGAUGGAAGAGAACGUGC,33,28,50,36,147
2289,9,AAVO02000007.1/6177-6291,AGAUAUCUUCAGGGCAGGGUGAGAUUCCCUACCGGCGGUAAAGCCCGCGAGCCGAGAGGCAUGAUCCGGUGAGAUUCCGGGGCCGACAGUACAGUCUGGAUGGAAGAAGAUGAUA,30,20,40,25,115
2290,9,CP000721.1/562620-562737,AUAUAUCUUCAGGGCAGGGUGUAAAUCCCUACCGGCGGUAUAGCCCGCGAGCUUUUAAGAAAGCAGAUUCGGUGUAACUCCGAGGCCGACAGUAUAGUCUGGAUGAAAGAAGGUAACC,34,26,33,25,118
2291,9,AANE01000019.1/87182-87037,UUUCGUUCUCGGGGCGGGGUGAAAUUCCCCACCGGCGGUAAGAACUUAGGUUUAAGCCCGCGAGCGUCUAAUCGUAUAGAUUAGAGUCAGCAGAUCUGGUGUGAUUCCAGAGCCGACGGUCAUAGUCCGGAUGAUAGAGAGCGUGU,33,36,46,31,146
2292,9,CP000411.1/1598055-1598186,UAAAUUCUUCGGGGCAGGGUGUGAUUCCCAACCGACGGUAACAACAUUUUGUUGAAGUCCGUGACCCGCGCAAGCGGUUGACCCAGUGAAACUCUGGGACCGACAGUAUAGUCUGGAUGGGAGAAGAAAUAG,36,29,39,28,132
2293,9,AAOU01000004.1/94074-94215,AUUAAUUCUCAGGGCGGGGUGGAAUUCCCCACCGGCGGUGUACUUUUUUAAGUGAGCCCGCGAGCGCUCGAUAUUUUUGAGGUCAGCAGAUCUGGUUAGAAGCCAGAGCCGACGGUUAUAGUCCGGAUGAGAGAGAAUUUAA,34,37,43,28,142
2294,9,AM180355.1/1973352-1973231,CUUAAUCUUCGGGGUAGGGUGAAAUUCCCAAUCGGCGGUAUAGCCCGCGAGCCAAGGUAAAACUUGGUUGAUUUGGUUAAAUUCCAAAGCCGACAGUAAAGUCUGGAUGGAAGAAGAUAUUU,36,32,33,21,122
2295,9,CP000416.1/1625123-1624989,UGAUUUCUUCGGGGCAGGGUGAAAUUCCCGACCGACGGUGACAACUUAAAGUUGAAGUCCGUGACCCACGUUUAACGUGGUUGACCCAGUGUGAGUCUGGGACCGACAGUAUAGUCUGGAUGGGAGAAGAAACGA,35,31,42,27,135
2296,9,CP000724.1/1065003-1065119,UAUAAUCUUCAGGGCAGGGUGUAAUUCCCGACCGGCGGUAAAGUCCGCGAGCCACAAUGUGGUUGACUUGGUGAAACUCCAAGACCGACAGUAAAGUCUGGAUGGAAGAAGAACAGU,35,24,34,24,117
2297,9,DQ645592.1/49-179,CGAUUUCUUCGGGGCAGGGUGCAAUUCCCGACCGACGGUAACAACGUAAGUUGAAGUCCGUGACCCGCGUGAGCGGUGGACCCAGUGCAAGUCUGGGACCGACAGUAUAGUCUGGAUGGGAGAAGAAAAUU,33,26,43,29,131
2298,9,CP000262.1/317676-317799,AAGUGUCUUCAGGGCAGGGUGUGAUUCCCGACCGGCGGUGACUAGUAACUAGAAGUCCGCGAGCGCAAGCUGAUGUGGUGUAACUCCACAACCGACAGUAUAGUCUGGAUGAGAGAAGACCGGG,32,24,41,27,124
2299,9,AAQL01001388.1/1132-1015,UAACGUCUUCAGGGCAGGGUGCAAGUCCCUACCGGCGGUUAUAGCCCGCGAGCCUUAUAUGGCAUGACUUGGUGAGAUUCCAAGGCCGACAGUACAGUCUGGAUGGAAGAAGAUUUAA,30,27,35,26,118
2300,9,CP000422.1/1801122-1800990,AGAUUUCUUCGGGGCAGGGUGUAAUUCCCGACCGACGGUAACAACCAAGGGUUGAAGUCCGUGACCCGCGAGUAGCGGUGGACCUAGUGAGAGUCUAGGACCGACAGUAUAGUCUGGAUGGGAGAAGAAACGU,35,26,45,27,133
2301,9,BA000012.4/6017355-6017207,UAAAGUUCUCAGGGCGGGGUGAAAGUCCCCACCGGCGGUAAGGGCCUCAAACCCAAGCCCGCGAGCGCUUUCCAAGACAAUUGGAAAGGUCAGCAGAUCCGGUGUGAUUCCGGAGCCGACGGUUAGAGUCCGGAUGAAAGAGGACGAAA,41,23,48,37,149
2302,9,AP008232.1/481423-481583,GCUUAUUCUCAGGGCGGGGUGCAAUUCCCCACCGGCGGUAAACCUGGCUAAAGUAUUGCACAGGAAGCCCGCGAGCGCUCAGGUUGCAUUGCAGUCUGAGGUCAGCAGAUCCGGUGUAAUUCCGGGGCCGACGGUAAUAGUCCGGAUGGGAGAGAGUAACG,36,32,54,39,161
2303,9,CP000759.1/1217787-1217947,GCUUGUUCUCGGGGCGGGGUGAAACUCCCCACCGGCGGUAUGAAGCGAAAGUUUCGAGCCCGCGAGCGCCUGAAAAGAUGCCGAUUCGGCUUUGUUCAGGGUCAGCAGAUCCGGUGAGAUGCCGGAGCCGACGGUUAAAGUCCGGAUGGAAGAGAGCGAAU,36,30,57,38,161
2304,9,CP000023.1/268469-268591,AAGGGUCUUCGGGGCAGGGUGAAACUCCCGACCGGCGGUGAUUCUUUGGAUAAGUCCGCGAGCGCAAGCUGAUGAGGUGUAAUUCCUCAACCGACAGUAUAGUCUGGAUGGAAGAAGACCAGU,31,26,40,26,123
2305,9,CP000376.1/319904-319773,UUCCAUUCUCAGGGCGGGGUGAAAUUCCCCACCGGCGGUUAUAGCCCGCGAGCGCCACCUCUACGGGGUGGGUCAGCAGAUCCGGUGGAAUUCCGGGGCCGACGGUCAUAGUCCGGAUGGGAGAGAAUGUAC,25,25,46,36,132
2306,9,AATE01006899.1/660-546,AAAUAUUUUCAGGGCGGGGUGAAAUUCCCCACCGGUGGUAAAGCCCACGAGCCGUAAGGCAUGAUUUGGUGAAAUUCCAAAGCCGACAGUAUAGUCUGGAUGAAAGAAAAUUCUU,36,27,30,22,115
2307,9,CP000414.1/807573-807710,UUUAAUCUUCGGGGCAGGGUGUAAUUCCCGACCGACGGUGAUGGUGAAUAACCUCAGUCCGUGACCCGCGAUAUUUUCGCGGUUGACACAGUGAAAUUCUGUGACCGACAGUUAAAGUCUGGAUGGGAGAAGAUUUGA,34,37,40,27,138
2308,9,AAYC01000017.1/60436-60586,CGCCGUUCUCAGGGCGGGGUGAAAUUCCCCACCGGCGGUAAGCAGGCCUAGUCCCGUAAGCCCGCGAGCGGCUUCCGGUCAUCUGGAAGUGUCAGCAGAUCUGGUGCAAUUCCAGAGCCGACGGUUACAGUCCGGAUGGAAGAGAAGGUAC,32,27,50,42,151
2309,9,AAXV01000008.1/126859-126734,GAUGUUCUUCGGGGUAGGGUGAAAUUCCCAAUCGGCGGUGAUGAAGCAAUUCAAAGUCCGUGAGCGCAAGCUGAUUUGGUGCAAAUCCAAAACCGACAGUGAUAGUCUGGAUGGGAGAAGAACAAA,39,27,38,22,126
2310,9,AE017263.1/670666-670782,UAACAUUUUCGGGGCAAGGCGAAAUUCCUUACCGAUGGUAAUAGUCCAUGAACCUUAAUUGGUUGAUUCAGUGAAAUUCUGAAACCGACGGUAUAGUCCGGAUGGUAGAAAAUGUCA,36,33,28,20,117
2311,9,CP000749.1/1531976-1531815,CUUCGUUCUCGGGGCGGGGUGUAAUUCCCCACCGGCGGUAAAGACUUUACAUAAGUUAAAUUCUAAGCCCGCGAGCGCCUUCAAGAAACUUUUCUUUUAGGGUCAGCAGAUCUGGUGUAAUUCCAGAGCCGACGGUUAUAGUCCGGAUGAUAGAGAGCGCGU,38,43,44,37,162
2312,9,AAMR01000023.1/75758-75608,UUUUAUUCUCAGGGCGGGGCGAAAUUCCCCACCGGCGGUAUGUCCUUAGCAAAAUCUAAAGAUAAGCCCGCGAGCGCUCGAUUCGUCGAGGUCAGCAGAUCUGGUGAGAUGCCAGAGCCGACGGUUAUAGUCCGGAUGAGAGAGAAUGAAA,40,32,45,34,151
2313,9,CP000261.1/324694-324818,AAGUGUCUUCAGGGCAGGGUGUGAUUCCCGACCGGCGGUGACUAAGUAACUAGAAGUCCGCGAGCGCAAGCUGAUGUGGUGUAACUCCACAACCGACAGUAUAGUCUGGAUGAGAGAAGACCGGG,33,24,41,27,125
2314,9,CP000155.1/1396507-1396361,ACUUAUUCUCAGGGCAGGGUGAAAUUCCCUACCGGCGGUAUGUCCCCCGUGGACGAGCCCGCGAGCGCCUGCUGCAGUACAGCAGGGUCAGCAGAUCCGGUGAGAGGCCGGAGCCGACGGUGACAGUCCGGAUGGGAGAGAAUAAGG,32,23,53,39,147
2315,9,AAPG01000027.1/38942-39095,CACUAUUCUCAGGGCGGGGUGAGAUUCCCCACCGGUGGUAAUUUGUAAAACGUUACAACAGCCCACGAGCGCUUUAUAUUGAAAAAUAUAAAGGUCAGCAGAUCCAGUGAAAACCUGGAGCCGACGGUUAAAGUCCGGAUAAAAGAGAAUGAAU,52,33,38,31,154
2316,9,ABDX01000009.1/107577-107694,AAAAGUCUUCAGGGCGGGGUGUAAGUCCCCACCGGCGGUAAAGCCCGCGAGCUAGUUUUUAGCAUGAUUCGGUGAAAUUCCGAGGCCGACAGUAUAGUCUGGAUGAAAGAAGAUGAGU,32,26,37,23,118
2317,9,CP000232.1/950178-950293,AACGUCCUUCGGGGUUAGGUGUAAUUCCUUACCGGCGGUAAAGCCCGCGAGCCGUUAUGGCAGACCCGGUGAAAUUCCGGGGCCGACAGUAAAAGUCUGGAAGGGAGAAGGAGGUU,28,23,40,25,116
2318,9,CP000521.1/970595-970445,CAUCGCUUCAGGGCGGGGUGUAAUUCCCCACCGGUGGUAAAGUUAAUUUUUAUUGUUAAAUUAACAAGCCCACGAGCUUAAAUUAUGUAAUUUGAGCAGAUUUGGUGAAACUCCAAAGCCGACGGUAUAGUCCGGAUGAAAGAAGACGACG,46,40,37,28,151
2319,9,AAWP01000010.1/3949-3809,CAAUGUUCUCAGGGCGGGGCGAAAUUCCCCACCGGCGGUAUACUCUUUUGAGUGAGCCCGCGAGCGCUCGAUUCGUCGAGGUCAGCAGAUCUGGUGAGAUGCCAGAGCCGACGGUUAUAGUCCGGAUGAAAGAGAAUAAGA,34,29,45,33,141
2320,9,AASA01000089.1/10476-10358,UUUAAUCUUCAGGGCAGGGUGAAAUUCCCGAUCGGCGGUAAAGUCCGCGAGCCGAGCAAUCGGCAGGAUUUGGUGAAAUUCCAAAACCGACAGUAUAGUCUGGAUGAAAGAAGAGUCAA,37,25,34,23,119
2321,9,BA000028.3/3348439-3348301,UGUAUUCUUCGGGGCAGGGUGUAAUUCCCGACCGGCGGUGACAAGUCAUCAGAACUUGAAGUCCGUGACCCGCUUUUAUGCGGUGGAUCUAGUGAGAAUCUAGAGCCGACAGUAAUAGUCUGGAUGGGAGAAGAAUAGC,35,34,43,27,139
2322,9,AM263198.1/2000161-2000041,GUUCAUCUUCGGGGCAGGGUGCAAUUCCCGACCGGUGGUUAAAGUCCACGAUCUGCUUUUAGCAGUUGACUCUGGUGUAAUUCCAGGACCGACAGUAUAGUCUGGAUGGGAGAAGAUGUUG,26,34,37,24,121
2323,9,ABCB02000018.1/8466-8595,AGCUGUCUUCGGGGCGGGGUGAAAGUCCCCACCGGCGGUAACCCUUUCAAACAUGGGAAGCCCGCGAGCUGCUUGCUGAUCUGGUGAGAUUCCAGAGCCGACGGUAUAGUCCGGAUGGAAGAAGAAAAGA,32,24,43,31,130
2324,9,BA000004.3/1634615-1634762,UUUAUCCUUCGGGGCUGGGUGGAAAUCCCGACCGGCGGUGAUGAAGCGAAUGCUUCUUAGUCCGUGACCCGGUUGCUGAUAUCAGUAAGCGGUGGACCUGGUGAAAAUCCGGGACCGACAGUGAAAGUCUGGAUGGGAGAAGGAAACG,35,32,51,30,148
2325,9,CP000230.1/2551172-2551329,GCUUGUUCUCAGGGCAGGGUGAAACUCCCGACCGGCGGUAAUCCUUCCCUUUCACGGGGGGGACAGCCCGCGAGCGCCCUUUGCCGGUGGUGAAGGGGUCCAGCAGAUCCGGUGCGAAGCCGGAGCCGACGGUAUAGUCCGGAUGGAAGAGAACGAGG,30,26,59,43,158
2326,9,AASE01000003.1/858-707,ACCUGUUCUCAGGGCGGGGUGAAAAUCCCCACCGGCGGUAUACCGGCUGUUAAUCCGGAAAGCCCGCGAGCGCUUUCGAUUAUUUCGAAAGGUCAGCAGAUUUGGUGAAACUCCAAAGCCGACGGUUAUAGUCCGGAUGAAAGAGGAUAGCG,39,32,45,36,152
2327,9,AAZD01000001.1/551093-550916,UCGCAUUCUCAGGGCAGGGUGAAAUUCCCUACCGGUGGUAAAGCCCACGAGCGUUUAAAAGUGCGGUCAAUUUUUGGCAAAUUUUUCUUGCUAAAUUGUCCUGAUUUUCACUUUUAAAGUCAGCAGAUUUGGUGAAAUUCCAAAGCCGACAGUAAAGUCUGGAUGAAAGAGAAUAAAA,54,52,40,32,178
2328,9,AE016827.1/145278-145429,GGGCAUUCUCAGGGCAGGGUGAAAUUCCCUACUGGUGGUAUAUGUUUACAUAAGCCCACGAGCGCCUAUUUUUAUGUGAUGUAGAAUUAGGGUCAGCAGAUUUGGUGAGAUUCCAAAGCCAACAGUUAAAGUCUGGAUGAAAGAGAAUAAAA,47,41,40,24,152
2329,9,CP000491.1/171669-171797,GCGUGUUCUCGGGGCGGGGUGCAAUUCCCCACCGGCGGUUACAGCCCGCGAGCGCCUGCAAUCCGCAGGGUCAGCAGAUCCGGUGAAACUCCGGGGCCGACGGUAUAGUCCGGAUGAAAGAGAAUGGAC,26,20,46,37,129
2330,9,CP000114.1/817263-817377,GAAUUUCUUCGGGGUCAGGUGAAAAUCCUAACCGGCGGUAUAGUCCGCGAGCUUUCGAGCAUGAACUGGUGUGAUUCCAGUACCGACAGUAAAGUCUGGAUGAGAGAAGAAUUCA,32,28,33,22,115
2331,9,AP006627.1/1930361-1930511,ACUCAACUUCGGGGCAGGGUGUAAAUCCCGACCGGCGGUGAUAAGGCAAUCGCCUUUUAGUCCGUGACCCGCAUAAGCAUUACUCGUGCGUGCGGUGGAUCUGGUGCAAAUCCAGAGCCGACAGUAAUAGUCUGGAUGGGAGAAGUUCGAG,36,33,47,35,151
2332,9,CP000133.1/2799767-2799909,CGCCGUUCUCAGGGCGGGGUGAAAGUCCCUACCGGCGGUAUGCAGUUUCGAUUGCGAGCCCGCGAGCGCCUUCCUCGGAAGGGUCAGCAGAUCAGGUGAGAUGCCUGAGCCGACGGUCAUAGUCCGGAUGAAAGAGAACGUGC,29,26,50,38,143
2333,9,CP000746.1/533105-533234,CCGCAUUCUCAGGGCAGGGUGAAAUUCCCUACUGGCGGUCAAGCCCGCGAGCGUUUGUUAUAAGGCAAAGUCAGCAGAUUUGGUGAAAUUCCAAAGCCAACAGUUACAGUCUGGAUGAAAGAGAGUAAAC,39,28,35,28,130
2334,9,CP000152.1/1720041-1720197,GAACGUUCUCGGGGCGGGGUGAAAUUCCCCACCGGCGGUAAUCGCGCGAUUGCGCGUAGCCCGCGAGCGCUUGCCGGCACGCAUGUGCCCGGCAAGGUCAGCAGACCCGGUUGGAUUCCGGGGCCGACGGUCAAAGUCCGGAUGAGAGAGAGCGGGG,28,23,61,45,157
2335,9,AP008230.1/4208512-4208661,ACGAACCUUCGAGGCAGGGUGAAAUUCCCGACCGGCGGUAAUAAUUGCCCGUGCAAUUCAGCCCGCAACUCAGUGCAGCUCCAGUGCUGCACCGACUGACUUGGUGAGACUCCAAGGCCGACGGUAUAGUCCGGAUGGGAGAAGGUACAA,38,27,44,41,150
2336,9,CP000387.1/1760462-1760315,UGAUGUCUUCAGGGCAGGGUGAGAUUCCCGACCGGCGGUAAUUUUUGGAUUGGAAUUUUUUUCUCCAUGUCAAAUCAAGUCCGCGAGCGCAAGCUGAUGUGGUGAGAUUCCACAACCGACAGUAUAGUCUGGAUGGGAGAAGACGAGA,37,39,44,28,148
2337,9,AAXB02000021.1/33038-32924,CGAAAUCUUCAGGGCAGGGUGCGAUUCCCUACCGGCGGUAAAGCCCGCGGGCCGAGAGGCAUGAUCCGGUGUGAUUCCGGAGCCGACAGUAUAGUCUGGAUGAAAGAAGAUGAUG,28,21,40,26,115
2338,9,AE017143.1/943036-943169,UUUAAUCUUCAGGGCAGGGUGAAAUUCCCGAUCGGUGGUAAAGUCCGCGAGCCGAACUUCGAUUAACAUCAAGUUUAGCAGGAACUAGUGAAAUUCUAGUACCGACAGUAUAGUCUGGAUGGAAGAAGAGCAGA,42,32,36,24,134
2339,9,CP000679.1/895035-894907,UCCAUCCUUCGGGGCGGGGUGAAAUUCCCCACUGGCGGUAAAAGCCCGCGAGCAAAAGCCUUUCUGGCUUUUGCAGAACCGGUGGAAUUCCGGUGCCAACGGUUACAGUCCGGAUGGGAGAAGGAAUGG,29,26,42,32,129
2340,9,AE017221.1/684544-684423,CACCUCCUUCGGGGCGGGGUGGAAGUCCCCACCGGCGGUGAAAGCCCGCGAAGCCCCUAAAGGGGCCCGACCCGGUGGAAUUCCGGGGCCGACGGUGAAAGUCCGGAUGGGAGAAGGAGGGC,24,13,49,36,122
2341,9,CP000423.1/1361659-1361777,GUUCGUCUUCAGGGCAGGGUGCAAUUCCCGACCGGCGGUAUAGUCCGCGACCCGCUUAUGCGGUGGAACCGGUGUGACUCCGGUACCGAUAGUGAUAGUCUAGAUGGAAGAAGAUGGGG,24,26,42,27,119
2342,9,AAZF01000001.1/50869-51046,GCGCAUUCUCAGGGCAGGGCGAAAUUCCCUACCGGUGGUAAAGCCCACGAGCGUUUAAAAGUGCGGUCAAUUUCAGGCAAGUUUUUUCUGCGAAAUUGCCCUGACAUUCAUUUUUAAAGUCAGCAGAUUUGGUGAAAUUCCAAAGCCGACAGUAAAGUCUGGAUGAAAGAGAAUAAAA,55,45,43,35,178
2343,9,BX640436.1/209532-209685,GUACGUCUUCAGGGCGGGGUGCAAUUCCCCACCGGCGGUAUGCCACGCAAUGUGGCGAGCCCGCGAGCGCCCUGCGUUGGCAACAGCGCAGGGGUCAGCAGACCUGGUGAGAUGCCAGGGCCGACGGUCAUAGUCCGGAUGAGAGAAGAUGUGC,30,24,57,43,154
2344,9,AE009951.2/10346-10461,UAAAGUCUUCAGGGCAGGGUGAAAUUCCCGACCGGUGGUACAGUCCACGAAAGCAUUUGCUUUGAUUUGGUGAAAUUCCAAAACCGACAGUAGAGUCUGGAUGGGAGAAGAAUUAG,35,28,33,20,116
2345,9,CT573326.1/621066-620925,AAGGGUCUUCAGGGCGGGGUGAAAGUCCCCACCGGCGGUAAAUCGAAAGAUGAGCCCGCGAGCGCCCCGGCCAUGCCGGGGGUCAGCAGAUCUGGUGAGAUUCCAGGGCCGACGGUCAUAGUCCGGAUGAAAGAAGGCGUUU,32,22,52,36,142
2346,9,CP000612.1/832798-832653,ACUUGUUCUCAGGGCGGGGUGAAAGUCCCUACUGGCGGUAUCCAGUUCACACUGGGAGCCCGCGAGCGCUCCUUAUUAUAUAGGAGGACAGCAGAUCUGGUGAAAAGCCAGGGCCAACGGUAUAGUCCGGAUGAAAGAGGAUAAGG,38,29,47,32,146
2347,9,CP000009.1/1075963-1076120,AGACGUUCUCAGGGCGGGGUGAAAUUCUCCACCGGCGGUAUUGGCGGAUUUCUCCGCCUCAGCCCGCGAGCGCCUUCCGGAUUUCGGUUCGGAAGGGACAAGCAGAUCCGGUGAGACUCCGGAGCCGACGGUUAGAGUCCGGAUGGAAGAGAACGCAG,32,29,55,42,158
2348,9,AE016825.1/4551002-4551150,UUACGUCUUCGGGGCGGGGUGCAACUCCCCACCGGCGGUAUGGCGCGCAAGCGCCGAGCCCGCGAGCGCCUUUGCCUGACGGCAAAGGGUCAGCAGAUCUGGUGAAACGCCAGAGCCGACGGUAAUAGUCCGGAUGAGAGAAGACGACG,32,21,53,43,149
2349,9,CP000362.1/544510-544358,GCGUAUUCUCAGGGCGGGGUGAAAUUCCCCACCGGCGGUAUGUGGGGCGUGACCUUACGAGCCCGCGAGCGGCCUUUCCCGAACUGAAGGGUUUCAGCAGAUCUGGUGAGAUGCCAGAGCCGACGGUCAUAGUCCGGAUGAAAGAGAAUGCGA,33,29,53,38,153
2350,9,CP000728.1/3149843-3149956,AGUAUCCUUCAGGGUUGGGUGAAAUUCCCUAUCGGCGGUAUAGCCCGCAAGCCAUAAGGCAGAUUCGGUUAAAUUCCGAAGCCGACAGUAUAGUCUGGAUGAAAGAAGGUAAAU,34,27,31,22,114
2351,9,AY246427.1/2402-2556,UUCUGUUCUCAGGGCGGGGUGAAACUCCCCACCGGCGGUAAGAGUUUCGGCUCGAGCCCGCGAGCGCCUUCCCUCGUGUCCAAGCGGGGGAAGGGUCAACAGAUCCGGUGCGAUUCCGGAGCCGACGGUUAAAGUCCGGAUGGAAGAGAAUGAGU,31,29,54,41,155
2352,9,CP000626.1/213449-213587,CAAUAUUCUCAGGGCGGGGCGAAAUUCCCCACCGGUGGUAUGCCGCAAGGCGAGCCCACGAGCGCUCGAUUCGUCGAGGUCAGCAGAUCUGGUGAGAAGCCAGAGCCGACGGUUACAGUCCGGAUGAGAGAGAAUGACA,35,22,46,36,139
2353,9,BX950851.1/1001970-1002170,GCUUAUUCUCAGGGCGGGGUGUAAUUCCCCACCGGCGGUAAACCAGUGAACGUAUGAACGAAUAAGGUUCUGCGCACUGGAAGCCCGCGAGCGCUCAGGCUGUGUUUUCCGAUAUCAAUUGUCGGUUUUCGCAACAUGAGGUCAGCAGACCCGGUGUAAUUCCGGGGCCGACGGUUAAAGUCCGGAUGGGAGAGAGUAACG,46,45,63,47,201
2354,9,L47648.1/1826-1960,AUCAAUCUUCGGGGCAGGGUGAAAUUCCCUACCGGCGGUGAUGAGCCAAUGGCUCUAAGCCCGCGAGCUGUCUUUACAGCAGGAUUCGGUGAGAUUCCGGAGCCGACAGUACAGUCUGGAUGGGAGAAGAUGGAG,32,28,45,30,135
2355,9,ABED02000028.1/57463-57577,AGAAAUCUUCAGGGCAGGGUGCGAUUCCCUACCGGUGGUACAGCCCACGAGCCGUAAGGCAUGAUUCGGUGAAACUCCGAAGCCGACAGUACAGUCUGGAUGAAAGAAGAUACCA,34,20,33,28,115
2356,9,ABCC02000026.1/45214-45328,UAAUAUCUUCAGGGCAGGGUGCAAUUCCCUACCGGUGGUACAGCCCACGAGCCGCAAGGCAUGAUUCGGUGAAACUCCGAAGCCGACAGUACAGUCUGGAUGAAAGAAGAUGGAA,34,21,33,27,115
2357,9,AE005176.1/1307881-1307745,AAAUAUCUUCAGGGCACCGUGUAAUUCGGGACCGGCGGUAAAUAGGGCUUUGACCUUAUGACUCCGCGAUUCGCUACGGCGAUUGAAGCAGUGAGAAUCUGCUAGCGACAGUAAAGUCUGGAUGGAAGAAGAUGAAC,39,31,40,27,137
2358,9,CP000826.1/4751561-4751400,GCUUAUUCUCAGGGCGGGGUGCAAGUCCCCACCGGCGGUAAAUCACCUUCUACGGUGAAAGCCCGCGAGCGCUCAGCCAGUCUCUUGCAGUUUGGUUAGAGGUCAGCAGAUCCGGUGUAAUUCCGGGGCCGACGGUUAUAGUCCGGAUGGGAGAGAGUAACG,33,35,53,41,162
2359,9,CP001581.1/209561-209677,UUAUAUCUUCAGGGCGGGGUGUAAUUCCCCACCGGCGGUAAAGCCCGCGAGCUAUUUUUAGCAUGAUUCGGUUAAAUUCCGAAGCCGACAGUAAAGUCUGGAUGGAAGAAGAUUAUA,32,31,31,23,117
2360,9,CP001348.1/3959917-3960045,UAAUAUCUUCAGGGCAGGGUGCGAUUCCCUACCGGCGGUAAUGUACUAUUUAGUAUUAGCCCGCGAGCGUUUUGCAGACAUGGUGUGAUUCCAUGGCCGACAGUACAGUCUGGAUGAAAGAAGAAACAG,34,33,36,26,129
2361,9,ACOM01000004.1/361838-361724,AUAUAUCUUCAGGGCAGGGUGAAAAUCCCUACUGGCGGUACAGCCCGCGAGCUAUUUUAGCAGAUUCGGUGUAAUUCCGAAGCCAACAGUAUAGUCUGGAUGAAAGAAGGUAACC,34,27,30,24,115
2362,9,CP000923.1/23974-24088,UAAAACCUUCAGGGAUCGGUGAAAUUCCGUACCGGCGGUAUAGCCCGCGAGCCUUUUGGCAGACUCGGUGAAAUUCCGAGGCCGACAGUUAAAGUCUGGAUGGGAGAAGGAGAAA,32,23,36,24,115
2363,9,CP001022.1/2287514-2287654,UUCCAUCUUCAGGGCAGGGUGAAAUUCCCGACCGGCGGUAAACAGGCGAUUCGCCUGAAGCCCGCGAGCGAAUAGGGCGCUAUUUGCUGAUUCUGUGUAACUCAGGAGCCGACAGUAUAGUCUGGAUGGGAGAAGAUGGCG,33,30,46,32,141
2364,9,AE007869.2/1872198-1872348,GGUUGUUCUCAGGGCGGGGUGCAAUUCCCCACCGGCGGUAUCGGGAUUUGUCCCGGAGCCCGCGAGCGCUUCCGGUCUCCAAAGCCGGAAGGUCAGCAGAUCCGGUGAGAGGCCGGAGCCGACGGUAUAGUCCGGAUGGAAGAGGACAAGG,29,25,57,40,151
2365,9,CP001111.1/691560-691705,AAACGUCUUCAGGGCGGGGUGCGAUUCCCCACCGGCGGUAGGUGCGCAAGCACGAGCCCGCGAGCGCUCCGGCCUUACCGCCGGGGGUCAGCAGAUCCGGUCCAAUGCCGGAGCCGACGGUAUAGUCCGGAUGAAAGAAGACGGUG,29,20,53,44,146
2366,9,AE016828.2/594013-594149,AAGCGCCUUCAGGGCGGGGUGGAAGUCCCCACCGGCGGUAAGUUUCUUUGAAAUAAGCCCGCGAGUCUCUAUUUUAAGAGACAGAUCUGGUUAAAUUCCAGAGCCGACGGUCAGAGUCCGGAUGAGAGAAGGUAUGC,35,30,42,30,137
2367,9,AE008922.1/837066-837234,GAACGUCUUCAGGGCGGGGUGCGAUUCCCCACCGGCGGUAUGCAUGCGCAAGCGUGUGAGCCCGCGAGCGCUUCGCUGCCGAUCUCUCGCUGAGAGCACGGCGGUGAAGGUCAGCAGAUCCGGUGCGAUGCCGGGGCCGACGGUAUAGUCCGGAUGAAAGAAGACGGCC,31,27,63,48,169
2368,9,CP001098.1/1089819-1089940,AAAUGCUAACGGGAUACGGUGAGAUUCCGAACCGGUGGUGAAAGUCCACAAGCCAUAUUUAUUAUGGUUGAUUUGGUGAAAUUCCAAAACCGACAGUAUAGUCUGGAAGGGAGUUAGCAUUG,38,32,33,19,122
2369,9,CP000919.1/179511-179397,AACUAUCUUCAGGGCAGGGUGCAAUUCCCUACCGGUGGUAUAGCCCACGAGCCGAAAGGCAUGAUUUGGUGAAAUUCCAAAGCCGACAGUAUAGUCUGGAUGAAAGAAGAUAAAA,38,24,30,23,115
2370,9,CP000903.1/3971775-3971918,AACAUCCUUCGGGGUCGGGUGAAAUUCCCAACCGGCGGUGAUGAAGCGAUAGCUUCUAAGUCCGUGACCCGUUUUCAACGCGAAAACGGUGGAUCUAGUGAAACUCUAGGGCCGACAGUAUAGUCUGGAUGGGAGAAGGAUAUG,38,32,44,30,144
2371,9,ABAX03000010.1/110704-110590,UAGGAUCUUCAGGGCAGGGUGAAAUUCCCUACCGGUGGUACAGCCCACGAGCCGCAAGGCAUGAUUCGGUGAAACUCCGAAGCCGACAGUACAGUCUGGAUGAAAGAAGAUAGUG,33,21,35,26,115
2372,9,AE008691.1/541539-541640,CGGGGCAGGGUGGAAUUCCCGACCGGCAGUGAAAGCCUGCGAGCCGCAUAUGCGGUUGACUCGGUGAAAUUCCGAGGCCGACGGUAAAAGUCCGGAUGGGAG,23,16,39,24,102
2373,9,AL591688.1/2398173-2398337,AAGCGUUCUCAGGGCGGGGUGAAAUUCCCCACCGGCGGUAGCGAACACAGGAUCGGGAAUGGUCGGUGGUCGGAGCCCGCGAGCGCUUCGCAUUUCGUGCGAAGGUCAGCAGAUCCGGUCGAAUUCCGGAGCCGACGGUUAUAGUCCGGAUGGAAGAGAGCAAGC,36,28,60,41,165
2374,9,AE005176.1/1021729-1021845,AUAAAUCUUCAGGGCAGGGUGUAAUUCCCUACCGGCGGUAUAGCCCGCGAGCUGCUUGCAGCAUGAUUCGGUGAAACUCCGAGGCCGACAGUAUAGUCUGGAUGAAAGAAGAUAAUA,33,26,33,25,117
2375,9,AE004439.1/1582210-1582055,GCGCAUUCUCAGGGCAGGGUGAAAUUCCCUACCGGUGGUAAAUGUAUAACAUAAGCCCACGAGCGUUUACUAUUUCAUGUCACAAGAGAUAGUAAAGUCAGCAGAUUUGGUGAGAAUCCAAAGCCGACAGUAUAGUCUGGAUGAAAGAGAAUAAGC,52,36,39,29,156
2376,9,CP000873.1/673354-673517,GCUUGUUCUCGGGGCGGGGUGAAACUCCCCACCGGCGGUAUGAAAAGCAAUUUUCAAGCCCGCGAGCGCCUGAAAUGGAAGCCGAUUCGCAUGCCAUUUCAGGGUCAGCAGAUCCGGUGAGAUGCCGGAGCCGACGGUUAAAGUCCGGAUGGAAGAGAGCGAAU,40,30,54,40,164
2377,9,ABCA03000041.1/6063-5943,AAUCUGUUUCAGGGCGGAGUGAAAUUCUCCACCGGUGGUAAAGUCCACGAGCGCAAAGUAUUUGUGCCGAUUCGGUGAAAUUCCGAAACCGACGGUAUAGUCCGGAUGAAAGAAUCAGAAA,37,27,33,24,121
2378,9,CP000909.1/2997673-2997805,GAAGACCUUCGGGGCAAGGUGAAAUUCCUGAUCGGCGGUAAUGGUGGCGUGCCCACACAAGCCCGCGAGCCGUAAGGCAGGACCCGGUGUGAUUCCGGGGCCGACGGUAUAGUCCGGAUGGGAGAAGGUCGGC,28,21,51,33,133
2379,9,CP001336.1/3015833-3015947,GAAUACCUCUGGGGAUUGGUGAAAUUCCAUACCGGCGGUCAAGCCCGCGAGCCAUUAUGGCAGAUCUGGUGUAAUUCCAGAGCCGACAGUAAAGUCUGGAUGAGAAGAGGAAAUU,33,25,34,23,115
2380,9,CP000853.1/2675114-2674995,AUGAUUCUUCAGGGCAGGGUGAAAUUCCCGACCGGCGGUAUAGUCCGCGACUCGAUAUACAUCGAUUGAACUGGUGAGAUUCCAGUACCGACAGUAAAGUCUGGAUGGGAGAAGAAAAAG,36,26,35,23,120
2381,9,ABDE02000001.1/586343-586474,AUAAGUCUUCGGGGCGGGGUGAAAUUCCCUACCGGCGGUGAAAGUCCGCGAACUUCGGGAACACGGUGUUUCCGGAGCCGAUCCGGUGCGAUUCCGGAACCGACAGUAAAGUCUGGAUGAAAGAAGGCUGAC,32,25,44,31,132
2382,9,CP001645.1/912076-912231,GUACGUCUUCAGGGCGGGGUGAAAUUCCCCACCGGCGGUAUGCGGACCGUGUGUCCGUGAGCCCGCGAGCGCCUUGCAUGCGCCUGCAUGCAGGGGUCAGCAGAUCCGGUGAAAUGCCGGGGCCGACGGUCAGAGUCCGGAUGGAAGAAGAUGUGC,28,27,59,42,156
2383,9,AE016796.2/1572120-1571980,UUUUAUUCUCAGGGCGGGGCGAAAUUCCCCACCGGCGGUAUACCGAAUGAGGUGAGCCCGCGAGCGCUCGAUUCGUCGAGGUCAGCAGAUCUGGUGAGAGGCCAGAGCCGACGGUUAUAGUCCGGAUGAGAGAGAAUGAAA,34,27,48,32,141
2384,9,CP003056.1/1405866-1406005,AUUUUCCUUCGGGGCAGGGUGCAAUUCCCGACCGGCGGUGAUGAGGAAACUCAAAGCCCGUGACCCGUAUUCUCCGGAAUGCGGUGGAUUUGGUGAAAUUCCAAAGCCGACAGUGACAGUCUGGAUGGGAGAAGGAUCAA,35,30,44,31,140
2385,10,ABEF01043191.1/931-798,CAUACUACAGGAGUAGUGGGAAAUAAUGUGUAAAUCAUUGGCUGUACUCGCAACGGUAAAAAAAGCCCGGAAACCACAUAAAGUAUACCACUGUUGGAUGAAGACCGAGAAAAGUCACGUUCCACAAUUUUCAU,50,30,28,26,134
2386,10,ABEF01008614.1/1-139,UACUGAAAGUAUUGUGGGAAAUAAUGUGUAAAUCAUUGACCGUUCCUGCGCUGGUAAGAAUAAANUUUUAGUCCAGACACCACCAGUAUAGCCCUCUGUCGAAUGACGACCAGGAAAAGUCUAGUUCUACAAUGAAAAA,48,36,28,26,139
2387,10,ABEF01048062.1/1373-1515,AUACUGAAAUACAUGGUGGGAAACAAUGUGGAAAUCAUUAACUGUUCCUGCAACGGUAAGAACAAGAGUUUAAGUCCGGGCACCGCCUAGUAUAGACCCCUGUUGAAUGAAGACCAGGAAAUGUCUAGUUCUACAAUGAAAAA,52,33,32,26,143
2388,10,AACY021783667.1/387-517,UAGCUGAAAUGCAUGGUGGGAAAUUCGUGUGAAAGUCAUGAGCUGUACCCGCAACCGUAUAGUCGGAGCGCCACCCAGUUAAGUCCGCUGUUGAAUGAUGGCCGGGAACAGUCUAGUUCUACAAUGAAAAA,38,30,36,27,131
2389,10,AACY024096041.1/425-555,UGACUGAAAUGCAUGGUGGGAAAUCUGUGUGAAACUCAUAGGCUGUACCUGCAACCGUAAAGUCGGAGCGCCACCCAGUUAAGUCCGCUGUUGAAUGAUGGCCAGGAAAAGUCUAGUUCUGCAAUGAAAAA,40,30,35,26,131
2390,10,AACY023165784.1/469-599,AAGCUGAAAUGCAUGGUGGGAAAUCAGUGUGAAAUUCAUUGGCUGUUCCUGCAACCGUAAAGUCGGAGCGCCACCCAGCUAAGUCCUCUGUUGAGCGAAGGCCAGGAAAAGUCUAGUUCUACAAUGAAAAA,41,29,34,27,131
2391,10,AACY023870645.1/164-34,AUACUGAAAAGCAUGGUGGGAAAUCAGUGUGAAAUUCAUUGGCUGUCCCUGCAACCGUAAAGUCGGAGCGCCACCCAGUAUAGUCCGCUGUUGAAUGAUGGCCAGGAGGUGUCUAAUUCUACAAUUUAAAA,39,33,33,26,131
2392,10,AACY021413889.1/650-519,GUAUCGAAAUGCAUGGUGGGAAAUCAGUGUGAAAUUCAUUGGCUGUUCCUGCAAAGGUUAAAGUCCUAGCGCCACCCGAUAUAGUCCGCUGUUGAAUGAAGGCCAGGAAAAGUCUAGUUCUGCAAUUUAAAU,39,36,33,24,132
2393,10,AACY023022368.1/358-488,AUACUGAAAUGCAUGGUGGGAAAUCAGUGUGAAAUUCAUUGGCUGUACCUGCAACCGUAAAGUCGGAGCGCCACCCAGUAAAGUCCGCUGUUGAAUGAGGGCCAGGGAGAGUCUAGUUCUACUAAUAUCUA,38,32,35,26,131
2394,10,AACY020138480.1/1015-884,AUACUGAAAUGCAUGGUGGGAAAUCAGUGUGAAAUUCAUUGGCUGUUCCUGCAACGGUUAUAGUCCGAGCGCCACCCAGUAUAGUCCGCUGUUGAACAAUGGCCAGGAAAAGUCUAGUUCUACAAUUAAAUU,39,36,31,26,132
2395,10,AACY023114032.1/602-472,UAACUGAAAUGCAUGGUGGGAAAUCAGUGUGAAAUUCAUUGGCUCUUCCUGGAACCGUAAAGUCGGAGCGCCACCCAGUUAAGCCCUUUGCUGAACGAAGGCCAGGAAAAGUCUAGUUCUAUAAUGAAAAA,42,31,32,26,131
2396,10,AACY021858808.1/134-265,AUACUGAAAUGCAUGGUGGGAAAUCAGUGUGAAAUUCAUUGGCUGUUCCUGCAACGGUAAUAGUCCGAGCGCCACCCAGUAGAGUCCGAUGUUGAAUGAAGGCCAGGAAAAGUCUAAUUCUACAAUGAAUAA,43,32,33,24,132
2397,10,AACY020496120.1/188-58,AUGUCGAAAUGCAUGGUGGGAAAUCAGUGUGAAAUUCAUUGGCUGUACCUGCAACCGUAAAGUCGGAGCGCCACCCGAUGAAGCCCUUUGUUGGAUGAAGGCCAGGGAAAGUCUAGUUCUACAAUGAAAAA,40,30,36,25,131
2398,10,AACY020633803.1/429-559,GUGCUGAAAUGCAUGGUGGGAAAUUAAUGUGAAAUUCAUUGGCUGUACCUGCAACCGUAAAGUCGGAGCGCCACCCAGUAAAGUCCGCUGUUGAAUGAAGGCCAGGAAAAGUCUAAUUCUUCUAAUUAUUA,40,35,32,24,131
2399,10,AACY021762656.1/83-213,GUACUGAAAUGCAUGGUGGGAAAUCAGUGUGGAAUUCACUGGCUGUACCUGCAACCGUAAAGUCGGAGCGCCACCCAGUAUAGUCCGCUGUUGAACGAGGGCCAGGAAUAGUCUAGUUCUGCAAUAUUUAA,36,32,36,27,131
2400,10,AACY023108236.1/475-603,GUACUGAAGUUUGGUGGGGAAUCAGUGUGAAAUUCAUUGGCUCUACCUGGAACCGUAAAGUCGGAGCGCCACCCAGUAUAGUCCGCUGUUGAAUGAUGGCCAGGGAAAGUCUAAUUCUACAAUUUUAAU,35,36,34,24,129
2401,10,AACY023652229.1/711-851,AUACCGAAAUUUAGGUGGGGAACAAUGUGAAAUUCAUUGGCUGUUCCUGCAACGGUGUGAACGAAAGUUUAAGUCCGAGCGCCACCCGGUAUAGUCCGCUGUUGAACGAAGCCAGGAAAAGUCUAGUUCUGCAAUGCAAAA,43,33,37,28,141
2402,10,AACY022516968.1/418-295,AUAUUGGUCUGGGAAAUAAGUGUGAAAUUCAUUUGCUGUUCCUGCAACGGUUAAAGUCCGAAUGCCAACCAAUAAAGUCCGCUGUGAAUGAUGGCCAGGAAAAGUCUAGUUCUACAAUGAAAAA,42,33,28,21,124
2403,10,AACY021909721.1/309-440,UUGCCGAAAUGCAUGGUGGGAAAUCAGUGUGAAAUUCACUGGCUGUUCCUGCAACGGUUAAAGUCCGAGCGCCACCCGGUAAAGCCCGCUGUUGAAUGAAGGCCAGGAAAAGUCUAAUUCUACAAUGUAAAA,40,30,34,28,132
2404,10,AACY022630724.1/579-709,AUAUUGAAAUGCAUGGUGGGAAAUCUAAGUGUAAUUCUUAGGCUGUACCUGCAACCGUAAAGUCGGAGCGCCACCCAGUAUAGUCCGCUGUUGAACGAGGGCCAGGGAAAGUCUAGUUCUACUAAUAAUAA,40,33,33,25,131
2405,10,AACY023369206.1/771-916,AAGUUGAAUCUUGGUGGGGAAUAAUGUGAAAAUCAUUAACUGUUCCUGCAACGGUAAUAACUUAAUAAAUGUUAAAGUCCGAGUGCCGCCCAACUUAGUCCUUUGUUGAAUGAAGGCCAGGAAAAGUCUAGUUCUACGAUGAAAAA,50,41,32,23,146
2406,10,AACY021644072.1/454-572,GUGCUAAAAGCAUAGUGGGAAAGUGACGUGAAAUUCGUCCACAUUACUUGAUAAGGUCAUAGUCCGAAUGCCACCUAGCACAGAACAGAGCAAGGAGACUCGAAUGGUAAGAUUGAUUA,42,26,30,21,119
2407,10,AACY023991155.1/473-604,GUGUUGAAAUGCAUGGUGGGUAAUCAAUGUGAAAUUCGUUGGCUGUUCCUGCAACGGUUAUAGUCCGAGCGCCACCCAACAUAGUCCGACUAGAAUGAAGGCCAGGAAAAGUCUAAUUCUGUUAACGGCAAA,39,33,34,26,132
2408,10,AACY023374844.1/1359-1486,GUAUUGAAUCUUGGUGGGGAAUAAUGUGAAAAUCAUUAGCUGUUCCUGCAACGGUAAAGUCCGAGUGCCGCCCAAUAUAGUCCGCUGUUGAAUGAUGGCCAGGAAAAGUCUAGUUCUACAAUUUUAAU,37,38,31,22,128
2409,10,AACY021026116.1/737-595,GUACUGAAUAAGUGAGUGGGGAAUAAUGUGUGAAUCAUUAACUGUUCCUGCAACGGUAAAACCUAAAAGUUAAGUCCGAGCGCCACCCAGUAUAGCCCGCUGUUGAAUGAAGGCCAGGAAAAGUCUAGUUCUGCAAUUAAAAA,49,34,34,26,143
2410,10,AACY020572665.1/147-19,GUACUGAAUCUUGACGGGGAAUUAGUGCGAAAUUCACUUGCUGUUCCUGCAACCGUAUAGUCGGAGUGCCGUCCAGUAUAGUCCGCUGUUGAGCGAUGGCCAGGAAAAGCCUAGUUCUGCAAUUUAAUU,31,37,34,27,129
2411,10,AACY020700152.1/351-479,AUACUGAAUCGUGUUGGGGAAGCAAGGUGAAAUACCAUGGCUCUACCAGGAACCGUAUAGUCGGAGUGCCAACCAGUAUAGUCCGCUGUCGAAUGAAGGCCUGGGAAAGUCUAAUUCUACAAUGUAAAG,40,29,35,25,129
2412,10,AACY021675760.1/326-183,AUGCUGCAAUGUAUGGUGGGAAAUUAAUGUGUAAUUCAUUAGCUGUUCCUGCAACGGUAAUAACAUUUGUUUAAGUCCGAGAGCCACCCAGCAUAGACCCCUGUUGAAUGAAGGCCAGGAAAAGUCUAGUUCUACAAUGAAAAA,47,39,32,26,144
2413,10,AACY023752846.1/868-993,UAAAUAAGUUUAUAUGUGAUGAAGUAGAGUGAAAUUCUCUCACUGUCGCGCAACGGUUAAAGUCCGAACUCACGUAUAAGCUAAAGACGUAGCUAGGCUCGCGGAAAGCUAAGCAGUUACUCAAAA,44,31,28,23,126
2414,10,AACY021350931.1/557-442,GGCCUAAAAGCGUAGUGGGAAAGUGACGUGAAAUUCGUCCAGAUUACUUGAUACGGUUAUACUCCGAAUGCCACCUAGGCCAUACAACGAGCAAGGAGACUCAACAUGAUAAGAUU,39,25,28,24,116
2415,10,AACY020649872.1/608-492,UUCCUAAAAGCAUAGUGGGAAAGAGACGUGUAAUUCGUCCACAUUACUUGAUACGGUGAUAGUCCGAAUGCCACCUAGGAAUAGAUAGAGCAAGGAGACUCAAUGAAUAAAGUAACU,43,27,27,20,117
2416,10,AACY023906339.1/379-251,GUGUUGAAACUUGGUGGGGAAUCAGUGCGUAAUUCAUUGGCUCUACCUGGAACCGUAAAGUCGGAGUACCACCCAACAUAGCCCGCUGUUGAAUGAAGGCCAGGAAAAGUCUAGUUCUACUAUUAAAAA,39,32,32,26,129
2417,10,AACY023681118.1/924-793,CAACUGAAAUGCAUGGUGGGAAAUCAGUGUGAAAUUCAUUGGCUGUUCCUGCAACGGUAAAAGUCCGAGCGCCACCCAGUUAAGUCCGCUGUUGAAUGAAGGCCAGGAAAAGUCUAAUUCUACAAUGAAAAA,44,30,32,26,132
2418,10,AACY023147184.1/534-406,AUACUGAAGUUUGGUGGGGAAUCAGUGUGAAAUUCAUUGGCUCUACCUGGAACCGUAAAGUCGGAGCGCCACCCAGUAUAGUCCGUUGUUGAAUGAAGGCCAGGGAAAGUCUAGUUCUACUAAUAAUAA,38,34,34,23,129
2419,10,AACY020983335.1/747-877,AUGUUGAAAUGUAUGGUGGGAAAUCAAUGUGAAACUCAUUGGCUGUUCCUGCAACGGUAAAAGUCCGAGCACCACCCAACAUAGUCCGUUGUCGAAUGAAGCCAGGAGAAGUCUAAUUCUGCAAUGAAAAA,44,31,31,25,131
2420,10,AACY024085015.1/673-814,AUACUGAAGUUUAGGUGGGGAACAAUGUGAGAUUCAUUGACUGUUCCUGCAACGGUGUGAACGAAAGUUUAAGUCCGAGCGCCACCCAGUAUAGCCCGCUGUUGAACGAAGGCCAGGAAAAGUCUAGUUCUACAAUGCAAAA,44,33,37,28,142
2421,10,AACY022588215.1/51-179,CUGCUGAAUCUUAGUGGGAAAUCAGUGUGAAAUUCAUUGGCUGUACCUGCAACCGUAAAGUCGGAGUGCCACUCAGUAAAGUCCGCUGUUGAAUGAAGGCCAGGAAAAGUCUAGUUCUACAAUUAAAAA,41,33,31,24,129
2422,10,AACY022463201.1/577-448,GCAUUGAAUCGUGAUGGGAAAUUAAUGUGAAAAUCAUUAGCUGUGCCUGCAACGGUUAAAGUCCGAGUGCCAUCCAAUGUAGUCCGCUGUUGAAUGAGGGCCAGGGAAAGUCUAAUUCUACAAUUUUAAU,39,37,32,22,130
2423,10,AACY020423335.1/2472-2603,ACACUGAAAUGCUUGGUGGGAAAUCAAAGUGAAAUUCUUUGGCUGUACCUGCAAUCGUGAAAGUCGGAGCGCCACCCAGUGCAGUCCUUUGUCGAAUGAUGGCCAGGAAAAGUCUAAUUCUGCAAUGAAAAA,41,32,33,26,132
2424,10,AACY021169004.1/468-599,AUACUGAAAGCAUGGUGGGAAAUCAGUGUGAAAUUCAUUGGCUGUUCCUGCAACCGUAAAGUCGGAGCGCCACCCAGUAUAGUCCGCUGUCGAAUACGAGCCAGGAAGAGCUUAUUAUUCUACAAUGAAAAA,42,31,32,27,132
2425,10,AACY022398892.1/265-395,AUGUUGAAAUGCAUGGUGGGAAAUCAGUGUGAGAUUCAUUGGCUGUACCUGCAACCGUAAAGUCGGAGCGCCGCCCAACAUAGUCCGCUGUUGAAUGAUGACCAGGGAAAGUCUAAUUCUACAAUGAAAAA,41,31,34,25,131
2426,10,AACY021388442.1/364-226,AUACUGAAUCAUGGUGGGGAACAAUGUGAAAUUCAUUGACUGUUCCUGCAACGGUAAAAGUAAAAUUGAGUCCGAGUGCCACCCAGUAAAGUCCGCUGUCGAGUGAAGGCCAGGAAAAGUCUAACUCUGCAAUAUUAAA,47,33,33,26,139
2427,10,AACY023548791.1/614-484,UCGUCGAAAUGCAUGGUGGGGAAUCAGUGUGAAAUUCGCUGGCUGUUCCUGCAACCGUAUAGUCGGAGCGCCACCCGAUAAAGUCCGCUGUUGAAUGAAGGCCAGGAAAAGUCUAGUUCUACAAUUUAAAA,37,32,35,27,131
2428,10,AACY023126394.1/172-299,UAGCUGAAAGUUGGUGGGAAAUCAGUGUGAAAUUCAUUGGCUGUGCCUGCAACCGUAAAGUCGGAGCGCCACCCAGCUAAGUCCGCUGUGAAUGAGGGCCAGGGAAAGUCUAGUUCUACAAUGAAAAA,38,28,37,25,128
2429,10,AACY020285976.1/1664-1524,GUACUGAAGUUUAGGUGGGGAACAAUGUGCAAAUCAUUGACUAUCCCUGUAACGGUAAGAAUUACAUUCAAGUCCGAGCGCCACCCAGUAUAGUCCGCUGUUGAAUGAUGGCCAGGAAAAGUCUAGUUCUACAAUUUUAAU,43,39,32,27,141
2430,10,AACY020090121.1/1319-1189,AUACUGAAAUGCAUGGUGGGAAAUCAGUGUGAAAUUCAUUGGCUGUUCCUGCAACCGUAAAGUCGGAGCGCCACCCGGUAUAGACCCCUGUCGAAUGAUGGCCAGGAAAAGCCUAGUUCUGCAAAAUAGCA,39,29,34,29,131
2431,10,AACY022422328.1/141-256,GGCCUAAAAGUGUAGUGGGAAAGUGACGUGAAAUUCGUCCAGAUUACUUGAUACGGUUAUACUCCGAAUGCCACCUAGGCCAUACAACGAGCAAGGAGACUCAACAUGAUAAGAUU,39,26,28,23,116
2432,10,AACY021077990.1/123-251,AUACUGAAACAUGGUGGGGAAUUAAUGUGAAAUUCAUUAGCUGUUCCUGCAACGGUAAAGUCCGAGUGCCACCCAGUAGAGUCCACUGUUGAAUGAAGGCCAGGAAAAGUCUAAUUCUGCAAUUUUAAA,42,34,30,23,129
2433,10,AACY023503559.1/603-718,GUGCAUUUGAAGUAGGGAAAAUUCUGUAAAUUCAGAUACUACACCCGUAACGGUUAAAAGUCCGAACGCCUACAUGAAAUGAUGCCCAUGAAGCGGGGAGGCUUCUUAAUGAUGGG,37,28,30,21,116
2434,10,AACY023720091.1/1012-863,ACACUGAAGUACAUGGUGGGAAAUAAUGUGAGAAUCAUUAACUGUUCGUGCAACGGUAUUUUUUAUUUAAAUAAAAAAAAGUCUGAGCGCCACCCAGUGUAGUCCGCUGUUGAAUGAAGGCCAGGAAAUGUCUAGUUCUACUAAUAAUAU,51,44,32,23,150
2435,10,AACY020619257.1/605-730,AUGCUGAAAGGUGGGGAAUCAGUGUGAAAUACAUUGGCUGUACCUGCAACCGUAAAGUCGGAGCGCCACCCAGCAUAGUCCGCUGUUGAAUGAAGGCCAGGAAAAGUCUAGUUCUACUAUUAAAAU,39,29,33,25,126
2436,10,AACY023066769.1/18-144,GAAAUGCAUGGGUGGGAAAUCAGUGUGAAAUUCACUGGCUGUACCUGCAACCGUAAAGUCGGAGCGCCACCCAGUUAAGUCCGCUGUCGAAUGAGGGCCAGGAAAAGUCUAAUUCUACAAUGAAAAA,41,26,34,26,127
2437,10,AACY023374252.1/993-1106,UUCCUAAAAGCAUAGUGGGAAAGCGACGUGAAAUUCGUUCACAUUACUUGAUACGGUUAUAGUCCGAAUGCCACCUAGGAACGUAUAGAGCAAGGAGACUCGUGAAAAGAAUAU,40,27,27,20,114
2438,10,AACY024099162.1/1300-1432,AUACUGAAAUGCAUGGUGGGAAAUUAGUGUGUAAUUCACUUGCUGUACCUGCAACCGUAGAGUCGGAGCGCCACCCAGUAUAGACCCCUGUGGAAUUAAGGCCAGGAAAAGUUUUAAUUUUUACAAAUUUGCA,40,37,31,25,133
2439,10,AACY020100715.1/159-290,AUACUGAAAUGCAUGGUGGGAAAUAAGUGUGAAAUUCACUUGCUGUUCCUGCAACGGUUAAAGUCCGAGCGCCACCCAGUAAAGUCCGCUGUUGAAUGAAGGCCAGGAAAAGUCUAGUUCUACAAUUGAAAG,42,32,33,25,132
2440,10,AACY023194971.1/1360-1487,ACUUUGAAUUUGGUGGGGAAUUAAUGUGAAAUUCAUUAGCUGUUCCUGCAACGGUAAAGUCCGAGCGCCACCCAGAGUAGCCCGCUGUUGAAUGAAGGCCAGGAAAAGUCUAGUUCUACAAUUUAAAU,38,35,31,24,128
2441,10,AACY023852270.1/480-607,GUAUUGAAUCUUGAUGGGGAAUAAUGUGAAAAUCAUUAGCUGUUCCUGCAACGGUAAAGUCCGAGUGCCAUCCAAUAUAGUCCGCUGUUGAACGAGGGCCAGGAAAAGUCUAGUUCUACAAUUUUAAU,39,37,30,22,128
2442,10,AACY022229140.1/494-626,AUACUGAAAUGCAUGGUGGGAAAUAAGUGCGAAAUUCACUUGCUGUACCUGCAACCGUAAAGUCGGAGCGCCACCCAGUAUAGACCCCUGUUGAAUUAAGGCCAGGAAAAGUCCCUACUUCUACAAAUUUGCA,42,31,29,31,133
2443,10,AACY020707565.1/520-390,AUACUGAAAUGCAUGGUGGGAAAUCUUUGUGAAAUUCAUUGGCUGUACCUGCAACCGUAAAGUCGGAGCGCCACCCAGUAGAGUCCGCUGUUGAAUGAAGGCCAGGAAAAGUCUAGUUCUGCUAUUUAAAU,38,35,33,25,131
2444,10,AACY020462061.1/2935-3064,AUACUGAAUCAUGUUGGGGAAUCAAGGUGCAAUUCCAUGGCUCUACCAGGAACCGUAAAGUCGGAGUGCCAACCAGUAUAAGUCCGCUGUCGAGCGAGGGCCUGGGAAAGUCUAGUUCUACAAUGUAAAG,38,29,36,27,130
2445,10,AACY023688126.1/564-702,AUACUGAUGUGGUAGGGAAUAAUGUGCAAUUCAUUAACUGUUCCUGCAACGGUAAAAACUAAAGUUUAAGUCCGAGCGCUACCCAGUAUAGUCCCCUGUCGAAUGAUGGCCAGGAAAAGUCUAGUUCUGCAAUGCAAAA,45,36,31,27,139
2446,10,AACY022255147.1/512-642,AUACCGAAAUGCAUGGUGGGAAAUCAGUGUGAAAUUCAUUGGCUGUCCCUGCAACCGUAAAGUCGGAGCGCCACCCGGUAUAGCCCGCUGUUGGACGAUGACCAGGAAAAGUCUAGUUCUGCAAUGCAAAA,38,28,35,30,131
2447,10,AACY023740574.1/1002-875,UAGCUGAAAGUUGGUGGGAAAUCAGUGUGAAAUUCAUUGGCUGUUCCUGCAACCGUAAAGUCGGAGCGCCACCCAGCUAAGUCCGCUGUGAAUGAAGGCCAGGAAAAGUCUAGUUCUACAAUGAAAAA,40,29,34,25,128
2448,10,AACY022133664.1/468-339,ACGCUGAAAUGCUUGGUGGGAAAUAAGUGUGUAAUUCAUUUGCUGUACCUGCAACCGUAAAGUCGGAGCGCCGCCCAGUGAAGUCCUUUGUGAACGAAGGCCAGGAAAAGUCUAGUUCUACAAUUAAAAA,40,32,33,25,130
2449,10,AACY020286512.1/969-1097,GUAUUGAAUCUUGGUGGGGAAUCAGUGUGAAAUUCAUUGGCUCUUCCUGGAACCGUAAAGUCGGAGUGCCACCCAAUAUAGUCCGCUGUUGAAUGAUGGCCAGGAAAAGUCUAGUUCUACGAUUUUAAU,34,39,33,23,129
2450,10,AACY022538713.1/371-246,CUGUUGAAUUGGUGGGGAAUCAGUGUGAAAUUCAUUGGCUGUACCUGCAACCGUAAAGUCGGAGUGCCGCCCAACAGAGUCCGCUGUGAAUGAUGGCCAGGAAAAGUCUAGUUCUACAAUGAAAAA,37,30,35,24,126
2451,10,AACY024025892.1/364-236,AUACUGAAUCGUGUUGGGGAAUCAAGGUGAAAUUCCAUGGCUCUACCAGGAACCGUAAAGUCGGAGUGCCAACCAGUAUAGUCCGCUGUCGAACGAGGGCCUGGGAAAGUCUAGUUCUGCAAUUUAAAA,38,30,35,26,129
2452,10,AACY020394384.1/899-771,AUACUGAAGUUUGGUGGGGAAUCAGUGUGAAAUUCAUUGGCUGUACCUGCAACCGUAAAGUCGGAGCGCCACCCAGUAUAGUCCGCUGUUGAAUGAAGGCCAGGAAAAGUCUAGUUCUACAAUUUUUAA,37,35,33,24,129
2453,10,AACY020275596.1/242-372,AAGUCGAAAUGCUUGGUGGGAAAUCAGUGUGAAAUUCACUGGCUGUACCUGCAACCGUAAAGUCGGAGCGCCACCCGAUAAAGUCCACUGUUGAAUGAAGGCCAGGAAAAGUCUAGUUCUACAAUGAAAAG,43,28,34,26,131
2454,10,AACY023786175.1/801-929,AUACUGAAUUUGGUGGAAAAUCAAUGUGAAAUUCAUUAAUUCUUCCUGGAACCGUUAAAGUCGGAGCACCACCCUGUAGAGUCCGGUGUUGAAUGAUGAACAGGAAAAUUCUAGUUCUACAAUUUUAAU,42,40,26,21,129
2455,10,AACY023366733.1/1891-1775,UGUUGGGGAUCAAGGUGAAAUUCCAUGGCUCUACCAGGAACCGUAAAGUCGGAGUGCCAACCAGUAUAGUCCGCUGUUGAAUGAGGGCCUGGGAAAGUCUAGUUCUACAAUGUAUAU,32,30,33,22,117
2456,10,AACY023404808.1/162-24,AUACUGAAUCAUGGUGGGGAACAAUGUGAAAUUCAUUGACUGUUCCUGCAACGGUAAAAGUAAAAUUGAGUCCGAGUGCCACCCAGUAAAGUCCGCUGUCGAGUGAAGGCCAGGAAAAGUCUAACUCUGCAAUAUUAAA,47,33,33,26,139
2457,10,AACY022552060.1/272-404,GUACUGAAAAAGUGAGUGGGGAAUCAGUGUGAAAUUCACUAGCUGUACCUGCAACGGUUAAAGUCCGAGCGCCACCCAGUAUAGUCCGCUGUCGAAUUAAGGCCAGGAAUAGUCUUACUUCUACAAUUAAAAA,43,32,31,27,133
2458,10,AACY020898569.1/233-361,AUACUGAAAUUUGGUGGGGAAUCAGUGUGAAAUUCAUUGGCUCUACCUGGAACCGUAAAGUCGGAGCGCCACCCAGUAUAGUCCGUUGUUGAAUGAAGGCCAGGGAAAGUCUAGUUCUACUAAUAAUAA,39,34,33,23,129
2459,10,AACY020888198.1/394-256,GUACUGUUAUUAAGGUGGGAAAUGAUGUGAAAUUCAUCAGCUGUGCUCGCAACGGUAAAUUAGUUAAAGUCCGAAGGCCACUCAGUAUAGUCCGGUGUUAGAAAGUAAUCGAGAAGAAUUACAAUCUUACAAUGAAAAA,50,37,32,20,139
2460,10,AACY023476510.1/141-271,AGACUGAAAUGCAUGGUGGGAAAUCUGUGUGAAAUUCACUUGCUGUUCCUGCAACCGUAUAGUCGGAGCGCCACCCAGUCUAGUCCGCUGUUGAAUGAAGGCCAGGAAAAGUCUAAUUCUGCAAUGUAAAA,38,33,33,27,131
2461,10,AACY020560274.1/1248-1134,CAUUUGAAGUAGGGAAAAUUCUGUAAAUUCAGAUACUACACCCGUAACGGUUAAAAGUCCGAACGCCUACAAGAAAUGAUGCCCAUGAAGCGGGGAGGCUUCAUAAGAUGGGAAA,42,24,28,21,115
2462,10,AACY021751307.1/233-362,AGGCUGAAUCAUGGUGGGGAAUUAAUGUGUAAUUCAUUAGCUGUUCCUGCAACGGUUAAAGUCCGAGUGCCACCCAGUAAAGUCCGGUGUUGAACGAAGGCCAGGAAAAGUCUAGUUCUGCAAUUAAAGU,38,34,35,23,130
2463,10,AACY020087320.1/391-507,UUCCUAAAAGCAUAGUGGGAAAGCGACGUGUAAUUCGUCCACAGUACUUGCUACGGUCAUAGUCCGAAUGCCACCUAGGAAUGUAACAGAGCAAGGAGACUCGAUGAGAAUAUUAUU,38,28,28,23,117
2464,10,AACY023694593.1/36-167,GUACUGAAAUGCAUGGUGGGAAAUCAGUGUGAAAUUCAUUGGCUGUUCCUGCAACUGUUAUAGUCAAAGCGCCACCCAGUACAGCCCGUUGUUGAACGAAGGUCAGGAAAAAUCUAGUUCUGCAAUUUUUAA,39,37,31,25,132
2465,10,AACY020778735.1/570-441,UUGCUGAAAUGCAUGGUGGGAAAUCAGUGUGAAAUUCAUUGGCUGUACCUGCAACCGUAAAGUCGGAGCGCCACCCAGUAAGUCCGCUGUUGAAUGAGGGCCAGGAAAAGUCUAGUUCUACAAUGAAAAA,40,30,35,25,130
2466,10,AACY021405153.1/445-586,AUACUGAAAAGCAUGGUGGGAAAUAAUGUGCAAAUCAUUAGCUGUUCCUGCAACGGUAAAGAUAAAAUCUAAGUCCGAGCGCCACCCAGUAUAGUCCGCUGUUGAAUGAAGGCCAGGAAAAGUCUAGUUCUAAGAUGAAAAA,52,32,33,25,142
2467,10,AACY023240836.1/1134-1004,AUACUGAAAUGCAUGGUGGGAAAUAAGUGCAUAAUUAGCUUGCUGUACCUGCAACCGUGAAGUCGGAGCGCCACCCAGUAUAGACCCCUGUUGAAUUAAGGCCAGGAAAAGUCUACUUCUACAAACGUGCA,41,30,31,29,131
2468,10,AACY020119405.1/1959-1818,GUACUGAAUAAGUGAGUGGGGAAUAAUGUGAAAAUCAUUAACUGUUCCUGCAACGGUAAGGAAAAAAUCUAAGUCCGAGCGCCACCCAGUAUAGUCCGCUGUCGAAUGAAGGCCAGGAAAAGUCUAAUUCUACAAUUUAAAA,52,33,32,25,142
2469,10,AACY021482365.1/361-231,GUACUGAAAUGCAUGGUGGGAAAUCAGUGUGUAAUUCAUUGGCUGUGCCUGCAACCGUAAAGUCGGAGCGCCACCCAGUAUAGUCCGCUGUUGAAUGAUGGCCAGGAAAAGUCUAGUUCUACAAUUAAAAA,39,33,34,25,131
2470,10,AACY023712372.1/854-994,AUACUGAAAGCAUGGUGGAAAACAAUGUGUGAUUCAUUGGCUGUACUCGCAACGGUAAGAACGUAGUUUAAGUCCGAAUGCCAUCCAGUAUAGUCCGCUGUUGAAUGAAGGCCGAGGAAAGUCUAGUUCUACAAUUUAAAU,45,38,34,24,141
2471,10,AACY022049749.1/250-380,AUACUGAAAUGCAUGGUGGGAAAUCAGUGUGAAAUUCAUUGGCUGUACCUGCAACCGUAGAGUCGGAGCGCCACCCAGUAUAGUCCGCUGUUGAAUAAUGGCCAGGGAAAGCCUAGUUCUACAAUGAAAAA,41,30,34,26,131
2472,10,AACY020260549.1/553-425,AUACUGAAUCUUGACGGGGAAUUAGUGCGAAAUUCACUUGCUGUUCCUGCAACCGUAUAGUCGGAGUGCCGUCCAGUAUAGUCCGCUGUUGAGCGAUGGCCAGGAAAAGCCUAGUUCUGCAAUUUAAUU,32,37,33,27,129
2473,10,AACY020511190.1/642-772,AUGCUGAAAUGCAUGGUGGGAAAUCAAUGCGAAAUUCAUUGGCUGUACCUGCAACCGUAAAGUCGGAGCGCCACCCAGCAAAGUCCCCUGUUGAACUAAGACCAGGAAAAGUUAGGUUCUACAAUGCAAAG,43,27,32,29,131
2474,10,AACY021438767.1/632-762,GUGCUGAAAUGCAUGGUGGGAAAUCAGUGUGAAAUUCAUUGGCUGUUCCUGCAACCGUAAAGUCGGAGCGCCACCCAGCAUAGUCCGCUGUUGAAUGAAGGCCAGGAAAAGUCUAAUUCUACGAUGAAAAA,40,30,35,26,131
2475,10,AACY021061315.1/500-370,AUACUGAAAUGCAUGGUGGGAAAUCAGUGUGAAAUUCAUUGGCUGUUCCUGCAACGGUAAAGUCCGAGCGCCACCCAGUAUAGUCCGGUGUUGAAUGAAGGCCAGGAAAAGUCUAAUUCUGCAAUGAAAAA,42,31,34,24,131
2476,10,AACY022421155.1/73-202,GUAUUGAAGUACUUGGUGGGGAAUCAAUGUGCAAUUCAUUGGCUGUACCUGCAACCGUAAAGUCGGAGUGCCACCCAAUAUAGCCCGCUGAGAAUGAUGGCCAGGAAAAGCCUAGUUCUACAAUGAAAAA,41,30,33,26,130
2477,10,AACY020078306.1/1134-1007,AUACUGAAUCAUGGUGGGGAAUAAUGUGAGAAUCAUUAGCUGUUCCUGCAACGGUAAAGUCCGAGUGCCACCCAGUAGAGACCGCUGUUGAAUGAAGGCCAGGAAAAGUCUAGUUCUGCAAUGAAAAA,42,29,34,23,128
2478,10,AACY020039769.1/524-655,AAGCUGAAAUGCAUGGUGGGAAAUCAGUGUGAAAUUCAUUGGCUGUGCCUGCAACCGUAGAGUCGGAGCGCCACCCAGCUUAGUCCGCUGUUGAAUGAUGGCCAGGAAAAGUCUAAUUCUACUAAUGUUAAU,37,34,35,26,132
2479,10,AACY023685440.1/611-749,AUACUGAAUUGGUAGGAAAUAAUGUGAAAAUCAUUAACUGUUCCUGCAACGGUGAAAAAGUAAGAUAAAGUCCGAGCACUACCCAGUAUAGUCCCCUGUCGAACAAUGGCCAGGAAAAGUCUAGUUCUACAAUGAAAAA,54,32,28,25,139
2480,10,AACY020602073.1/269-138,GUACUGAAAUGCAUGGUGGGAAAUUAGUGCGAAAUUCACUUGCUGUUCCUGCAACGGUUAUAGUCCGAGCGCCACCCAGUAUAGUCCGCUGUUGAAUGAAGGCCAGGGAAAGUCUAGUUCUACAAUUAAGUU,36,36,34,26,132
2481,10,AACY021133670.1/546-418,AUAUUGAAUCUUGGUGGGGAAUCAAUGUGAAAUUCAUUGGCUGUUCCUGCAACCGUAAAGUCGGAGUGCCACCCAAUAGAGACCGCUGUUGAAUGAUGGCCAGGAAAAGUCUAAUUCUACAAUUUUAAU,39,37,30,23,129
2482,10,AACY023711012.1/1418-1300,GUGCUAAAAGCAUGGUGGGAAAGUGACGUGUAAUUCGUCCACAUUACUUGAUACGGUUAUAGUCCGAAUGCCACCUAGCACAAAGUAGAGCAAGGAGACUCAAUGAUUAGAAUAAUUCU,40,30,28,21,119
2483,10,AACY021924338.1/634-764,AUAUUGAAAUGCAUGGUGGGAAAUCAGUGUGGAAUUCAUUGGCUGUACCUGCAACCGUAAAGUCGGAGCGCCACCCAAUAUAGUCCGCUGUCGAAUGAAGGCCAGGAAAAGUCUAAUUCUAUAAUGCAAAA,43,31,32,25,131
2484,10,AACY020473610.1/1198-1329,GUGUUGAAAUGCAUGGUGGGAAAUAAGUGUGAAAUUCACUAGCUGUUCCUGCAACGGUAAAAGUCCGAGCGCCACCCAACAUAGUCCGAUGUCGAAUGAAGGCCAGGAAAAGUCUAAUUCUACAAUUUAAAU,44,32,31,25,132
2485,10,AACY020893691.1/240-367,GUAUUGAAUCUUGGUGGGGAAUAAUGUGAAAAUCAUUAGCUGUUCCUGCAACGGUAAAGUCCGAGUACCACCCAAUAUAGUCCGCUGUUGAACGAUGGCCAGGAAAAGUCUAGUUCUGCAAUUUAAAU,39,36,30,23,128
2486,10,AACY020346148.1/1942-2072,GUACUGAAAUGCAUGGUGGGAAAUCAAUGUGUAAUUCAUUGGCUGUACCUGCAACCGUAAAGUCGGAGCGCCACCCAGUAUAGUCCGCUGUUGAACAAUGGCCAGGAAAAGUCUAGUUCUACAAUGAAAAA,42,31,32,26,131
2487,10,AACY021815713.1/181-51,AAGCUGAAAUGCAUGGUGGGAAAUCAGUGUGAAAUUCAUUGGCUGUACCUGCAACCGUAAAGUCGGAGCGCCACCCAGCUAAGUCCUUUGUUGAAUGAUGGCCAGGAAAAGUCUAGUUCUACAAUGCAAAA,41,31,33,26,131
2488,10,AACY023695088.1/1211-1082,AUACUGAAUGUAAGGUGGGAAAUCAGUGUGAAAUUCAUUGGCUCUUCCUGGAACCGUAAAGCCGGAGCUCCACCCAGUAGAGACCGAUGUUGAAUGAAGGCCAGGAAAAGUCUAGUUCUGCAAUUAAAAA,43,30,33,24,130
2489,10,AACY021336735.1/248-118,AGGCUGAAAUGCAUGGUGGGAAAUCAGUGUGAAAUUCAUUGGCUGUUCCUGCAACCGUAAAGUCGGAGCGCCACCCAGCUUAGUCCGCUGAUGAAUGAUGGCCAGGAAAAGUCUAAUUCUAUAAUGAAAAA,41,31,34,25,131
2490,10,AACY023205466.1/471-342,GUAUUGAAUCUUGGUGGGGAAUUAAUGUGAAAUUCAUUAGCUGUUCCUGCAACGGAUAAAGUCCGAGUGCCACCCAAUAUAGUCCGCUGUUGAACAAUGGCCAGGAAAAGUCUAGUUCUACAAUUUUAAU,39,39,29,23,130
2491,10,AACY023012424.1/622-753,GUACUGAAAUGCAUGGUGGGAAAUCAGUGUGAAAUUCAUUGGCUGUUCCUGCAACCGUAAAGUCGGAGCGCCACCCAGUAUAGUCCGCUGUUGAAUGAUGGCCAGGAAAAGUCUAGUUCUACUAAUGUUUCU,35,37,34,26,132
2492,10,AACY022088223.1/815-683,AUACUGAAAUGCAUGGUGGGAAAUCGAUGCGAAAUUCAUCGGCUGAGCCUGCAACCGUUAAAGUCGGAGCGCCACCCAGUAUAGUCCGUUGUUGAACGAGGGCCAGGGAAAGUCUAGUUCUACUAAUGUUUAU,37,33,36,27,133
2493,10,AACY022846062.1/477-605,AUAUUGAAGUUUGGUGGGGAAUCAGUGUGAAAUUCAUUGGCUCUACCUGGAACCGUAAAGUCGGAGCGCCACCCAAUAUAGUCCGUUGUUGAAUGAGGGCCAGGGAAAGUCUAGUUCUACUAAUAAUAA,38,35,34,22,129
2494,10,AACY020159469.1/640-770,GUACUGAAUGAAUGGUGGGAAAUCAGUGUGAAAUUCAUUGGCUGUUCCUGCAACCGUAAAAGUCGGAGCGCCACCCAGUACAGUCCGCUGUUGAACGAAGGCCAGGAAAAGUCUAGUUCUACAAUUUAAUU,39,33,33,26,131
2495,10,AACY022093068.1/580-711,GUACUGAAAUGCAUGGUGGGAAAUCAGUGUGAAAUUCAUUGGCUGUUCCUGCAACCGUAAAGUCGGAGCGCCACCCAGUAUAGUCCGCUGUUGAAUGAUGGCCAGGAAAAGUCUAGUUCUACUAAUGUUUCU,35,37,34,26,132
2496,10,AACY024028590.1/459-589,AUGCUGAAAUGCAUGGUGGGAAAUCGAUGUGAAAUUCAUUGGCUGUACCUGCAACCGUAAAGUCGGAGCGCCACCCAGCAUAGUCCGUUGUCGAAUGAAGGCCAGGGAAAGUCUAAUUCAACGAAAUAAAU,42,29,34,26,131
2497,10,AACY020087471.1/1019-889,AUACUGAAAUGCAUGGUGGGGAAUCAAUGCGAAAUUCGUUGGCUGUACCUGCAACCGUAAAGUCGGAGCGCCACCCAGUAGAGACCGCUGUCAAACGAAGGCCAGGGAAAGUCUAGUUUAACAAUUUAAAU,42,28,34,27,131
2498,10,AACY021293072.1/270-139,AUCUUGAAAUGCAUGGUGGGAAAUCAGUGUGAAAAUCAUUGGCUGUACCUGCAACCGUAAAGUCGGAGCGCCACCCAAGAUAGUCCGUUGUUGAAUGAUGGCCAGGGAAAGUCUAGUUCUACUAAUACUUAA,40,34,33,25,132
2499,10,AACY023653040.1/384-266,GUGUUAAAAGCAUAGUGGGAAAGUGACGUGUAAUUCGUCCACAUUACUUGAUGCGGUUAUAGUCCGAAUGCCACCUAACACAAAGUAGAGCAAGGAGACUCAAUGAUUAGAAUAACUCU,41,30,27,21,119
2500,10,AACY023373959.1/918-1047,AUACCGAAAUGCAUGGUGGGAAAUCAGUGUGGAAUUCAUUGGCUGUCCCUGCACCGUAAAGUCGGAGCGCCACCCGGUAUAGCCCGCUGUUGAACGAAGGCCAGGAAAAGUCUAGUUCUGCAAUGCAAAA,37,27,36,30,130
2501,10,AACY020426083.1/234-364,UAGUUGAAAUGCAUGGUGGGAAAUAAAUGAGUAUUUCAUUUGCUGUACCUGCAACCGUAUAGUCGGAGCGCCACCCAACUAAGUCCGCUGUUGAAUGAAGGCCAGGAAAAGUCUAGUUCUACAAUGAAAAA,43,33,31,24,131
2502,10,AACY021958482.1/566-436,AGAUUGAAAUGCAUGGUGGGAAAUCAGUGUUAAAUUCAUUGGCUGUACCUGCAACCGUAAAGUCGGAGCGCCACCCAAUCUAGCCCGGUGUUGAAUGAUGGCCAGGAAAAGUCUAGUUCUACAAUUUUAGU,38,35,33,25,131
2503,10,AACY021031284.1/481-609,AUGCUGAAGUUUGGUGGGGAAUCAGUGUGAAAUUCACUGGCUGUGCCUGCAACCGUAAAGUCGGAGUGCCACCCAGUAAAGUCCUUUGUCGAAUGAUGGCCAGGAAAAGUCUAGUUCUGCAAUUUAAAA,36,34,35,24,129
2504,10,AACY021666507.1/860-742,GUGCAUUUGAAGUAGGGAAAAUUCUGUAAAUUCAGAUACUACACCCGUAACGGUUAAAAGUCCGAACGCCUACAUGAAAUGAUGCCCAUGAAGCGGGGAGGCUUCUUAAGGAUGGGAGA,39,27,32,21,119
2505,10,AACY022239160.1/343-471,GUAUUGAGUCUUGGUGGGAAAUCAGUGUGUAAUUCAUUGGCUCUUCCUGGAACCGUAUAGUCGGAGUGCCACCCAAUAUAGUCCGCUGUUGAAUGAUGGCCAGGAAAAGUCUAGUUCUGCAAUGAAAAA,35,37,34,23,129
2506,10,AACY023204583.1/125-250,AUAUUGAAUGGUGGGGAAUCAGUGCGAAAUUCACUGGCUGUACCUGCAACCGUAAAGUCGGAGCGCCGCCCAGUAUAGUCCGCUGUUGAACAAUGGCCAGGAAAAGUCUAGUUCUACAAUUAAAAU,38,30,32,26,126
2507,10,AACY021130605.1/63-187,AUAUUGUCGGUGGGAAAUUAGUGUGAAAUUCACUUGCUGUUCCUGCAACGGUUAAAGUCCGAAUGCCACCCAAUAAAGUCCGCUGUGAAUGAAGGCCAGGAAAAGUCUAAUUCUACAAUGAAAAA,42,32,28,23,125
2508,10,AACY022070905.1/141-13,AUAUCGAAUCUUGAUGGGGAAUAAUGUGCAAAUCAUUAGCUGUUCCUGCAACGGUAAAAGACCGAGUGCCAUCCGAUACAGACCGUUGUCGAAUGAAGGCCAGGAAAAGUCUAGUUCUACAAUUUAAAA,44,32,29,24,129
2509,10,AACY021570976.1/760-634,AUAUUGAUAUGGUGGGGAAUCAGUGUGAAAUACAUUGGCUGUACCUGCAACCGUAAAGUCGGAGCGCCACCCAAUAUAGUCCGCUGUUGAAUGAAGGCCAGGAAAAGUCUAGUUCUGCAAUGAAAAA,41,30,33,23,127
2510,10,AACY023326434.1/328-197,AUAGUAAAUAAUUUAGUAGGAAAACAGCGCGAAAUUUGUUGGCUAUACCUGCAACCGUUAAAGUCGGAGAGCCACCCAGUAUAGCCCAGUGUUGAAUGAAGGCCAGGAAAAGUCUAGCUCUGCAACUAAUUU,45,32,30,25,132
2511,10,AACY020861911.1/106-235,GGACUGAAUCAUGGUGGGGAAUUAAUGUGAAAUUCAUUAGCUGUUCCUGCAACGGUUAAAGUCCGAGUGCCACCCAGUAAAGUCCGGUGUUGAACGAAGGCCAGGAAAAGUCUAGUUCUGCAAUUAAAGU,39,33,35,23,130
2512,10,AACY022355432.1/165-24,GUGCUGAAAUGCAUGGUGGGAAACAAUGUGUAAAUCAUUGACUGUUCCUGCAACGGUAAAAACGAAAGUUUAGUCCGAGCGCCACCCAGCAUAGCCCGCUGUUGAACGAUGAUCAGGAAAAAUCUAGUUCUACAAUGAAAAG,48,32,34,28,142
2513,10,AACY020016467.1/57-194,UAACUCUCACGAGGUUGGGAAAGUCAGUGAAUACAUAAUCUGACACUGCCCCCGCAACGGUGAACAACAGUCCGAAUGCCAACGAGGUGAGACCAACAUUAGCGGUGGUGCUAUGAAAAUUAUCUUAAUCAUAUAAAA,48,30,30,30,138
2514,10,AACY022416029.1/255-113,AUACUGAAAUGCAUGGUGGGGAACAAUGUGAAAUUCAUUGACUGUUCCUGCAACGGUGUGAACAUAAGUUUGAGUCCGAGCGCCACCCAGUAUAGCCCGCUGUUGAACGAAGGCCAGGAAAAGUCUAGUUCUGCAAUGUAAAA,44,34,37,28,143
2515,10,AACY022113209.1/484-354,GUAUUGAAAUGCAUGGUGGGAAAUCAGUGUGAAAUUCGCUGGCUGUUCCUGCAACCGUAAAGUCGGAGCGCCACCCAGUAUAGUCCGCUGUUGAAUGAAGGCCAGGAAAAGUCUAGUUCUACAAUUAGAAA,39,32,35,25,131
2516,10,AACY022575647.1/592-722,AUACUGAAAUGCAUGGUGGGAAAUCAGUGUGAAAUUCAUUGGCUGUACCUGCAACCGUAAAGUCGGAGCGCCACCCAGUAAAGUCCGCUGUUGAAUGAUGGCCAGGAAAAGUCUAGUUCUGCGAUGAAAAA,41,30,35,25,131
2517,10,AACY023664897.1/19-147,AUGCUGAAUCUUGGUGGGGAAUCAAUGUGUAAAUCGUUGACUGUACCUGCAACCGUAAAGUCGGAGUGCCACCCAGCAAGUCCGUUGAUGAAUGAAGGCCAGGAAAAGUCUAGUUCUUCUAAUAUUUUA,37,36,32,24,129
2518,10,AACY024040712.1/28-158,AUACUGAAAUGCAUGGUGGGAAAUCAGUGUGAAAUUCAUUGGCUGUCCCUGCAACCGUAAAGUCGGAGCGCCACCCAGUAUAGCCCGCUGUUGAACGAAGGCCAGGAAAAGUCUAGUUCUGCAAUGCAAAA,40,28,34,29,131
2519,10,AACY023995715.1/131-1,AUACUGAAAAGCAUGGUGGGAAAUCAGUGUGAAAUUCAUUGGCUGUUCCUGCAACCGUAAAGUCGGAGCGCCACCCAGUAUAGACCCCUGUCGAAUGAUGGCCAGGAAAAGCCUAAUUCUACAAUACUUAA,42,30,30,29,131
2520,10,AACY023625703.1/312-182,AUACUGAAAUGCAUGGUGGGAAAUCAGUGUGAAAUUCAUUGGCUGUUCCUGCAACCGUAAAGUCGGAGCGCCACCCGGUAUAGUCCGCUGUUGAAUGAUGGCCAGGAAAAGUCUAGUUCUACAAUGAGAAA,39,32,35,25,131
2521,10,AACY020440875.1/1972-1839,GUACUGAAUCGUGAUGGGGAAUAAUGUGAAAUUCAUUAGCUGUACCUGCAACGGUGAAAAAAAAGUCCGAGUGCCAUCCAGUAUAGUCCGCUGUUGAGUGAAGGCCAGGAAAAGUCUAGCUCUACGAUUAUUAA,43,34,34,23,134
2522,10,AACY022354164.1/308-178,GUACUGAAACGCAUGGUGGGGAAUAAAUGUGAAAUUCAUUUGCUGUUCCUGCAACCGUAAAGUCGGAGCGCCACCCAGUAUAGUCCGCUGUUGAACGAAGGCCAGGAAAAGUCUAGUUCUGCAAUUAAAUU,39,33,33,26,131
2523,10,AACY020191282.1/590-462,GUAUUGAAUCAUGGUGGGGAAUUAAUGAGAAUUUCAUUUGCUGUUCCUGCAACCGUAAAGUCGGAGUGCCACCCAAUAUAGUCCGCUGUUGAAUGAAGGCCAGGAAAAGUCUAGUUCUACAAUUUUUAA,38,39,30,22,129
2524,10,AACY023664534.1/643-515,UUGCUGAAUCAUGGUGGGGAAUCAGUGUGAAAUUCAUUGGCUCUUCCUGGAACCGUAAAGUCGGAGUACCACCCAGUAAAGUCCGCUGUUGAAUGAUGGCCAGGAAAAGUCUAGUUCUACAAUUAAAAA,39,34,32,24,129
2525,10,AACY021097151.1/299-429,GUGUUGAAUAAGUGAGUGGGGAAUCAGUGUGAAAUUCAUUGGCUGUGCCUGCAACCGUAAAGUCGGAGCGCCACCCAACAUAGUCCGCUGUUGAAUGAUGGCCAGGAAAAGCCUAGUUCUGCAAUUUUUAA,36,34,36,25,131
2526,10,AACY022116441.1/1-131,AUACCGAAAUGCUUGGUGGGAAAUCAGUGUGAAAUUCAUUGGCUGUACCUGCAACCGUAAAGUCGGAGCGCCACCCGGUAAAGUCCGCUGUUGAAUGAAGGCCAGGAAAAGUCUAAUUCUGCAAUGAAAAA,42,29,34,26,131
2527,10,AACY023884527.1/589-719,AUACUGAAAUGCAUGGUGGGAAAUCAGUGUGAAAUUCAUUGGCUGUACCUGCAACCGUAAAGUCGGAGCGCCACCCAGUAAAGACCGUUGUCGAAUGAAGGCCAGGAAAAGUCUAGUUCUACUAUUUUAAA,42,32,32,25,131
2528,10,AACY020928737.1/777-647,AUACUGAAAUGCAUGGUGGGAAAUCAGUGUGAAAUUCAUUGGCUGUUCCUGCAACCGUAAAGUCGGAGCGCCACCCAGUAUAGCCCGUUGUUGAAUGAAGGCCAGGAAAAGUCUAGUUCUAUAAUUUAAAA,41,34,32,24,131
2529,11,X83878.1/168-267,UUACAAUAUAAUAGGAACACUCAUAUAAUCGCGUGGAUAUGGCACGCAAGUUUCUACCGGGCACCGUAAAUGUCCGACUAUGGGUGAGCAAUGGAACCGC,31,23,24,22,100
2530,11,AF270087.1/2580-2679,AAAAUAAUUUAUAUGACUCAUAUAAUCUAGAGAAUAUGGCUUUAGAAGUUUCUACCGUGUCGCCAUAAACGACACGACUAUGAGUAACAAUCCAAUACAU,39,29,14,18,100
2531,11,AL596165.1/154156-154057,AAUCGUCUACAAUAAUAAAGUCGUAUAAGUUCGGUAAUAUGGACCGUUCGUUUCUACCAGGCAACCGUAAAAUGCCAGGCUACGAGCUAUUGUAAAAUUU,33,29,19,19,100
2532,11,AL596170.1/223345-223246,AUAACUUAAAACCGAAAUACUUAUAUAAUAGUUGCGAUUGGGCGACGAGUUUCUACCUGGUUACCGUAAAUAACCGGACUAUGAGUAGUUUGUAUAAAGA,35,30,20,15,100
2533,11,AB008757.1/115-16,AAUGAAUCACGCUGACUCACUCAUAUAAUCGCAAGAAUACGGCUUGCGAGUCUCUACCAGCCGACCGUAAAUCGGCUGACUAUGAGUGGCAAUGUCAGGA,30,22,23,25,100
2534,11,U51115.1/15592-15691,GAAAUCAAAACACGACCUCAUAUAAUCUUGGGAAUAUGGCCCAUAAGUUUCUACCCGGCAACCGUAAAUUGCCGGACUAUGCAGGGAAGUGAUCGAUAAA,35,22,21,22,100
2535,11,AL591975.1/251119-251020,AAUCCGCUACAAUAAUAUAGUCGUAUAAGUUCGGUAAUAUGGACCGUUCGUUUCUACCAGGCAACCGUAAAAUGCCAGGCUACGAGCUAUUGUAAAAUUU,32,29,19,20,100
2536,11,AL591981.1/205922-205823,AUAACUUAAAACCGAAAUACUUGUAUAAUAGUUGCGAUUGGGCGACGAGUUUCUACCUGGUUACCGUAAAUAACCGGACUAUGAGUAGUUUGUAUAAAGA,34,30,21,15,100
2537,11,ABDP01000013.1/128838-128739,GACAUAAUUAAAUAAUUUGCUCAUAUAAUUCCUGAAUAUGGAGGGAAGUUUCUACCAGAUAACCGUAAAUUGUCUGACUAUGAGUGGAAUCCUACUUAAU,35,33,17,15,100
2538,11,CP000764.1/271074-271175,AGAUAAUAUAAAACAAUCCUUCAUAUAUCCUCAAUAAUAUGGUUUGAGAGUCUCUACCGGGUUACCGUAAACAACCUGACUAUGAAGGCAGUGCGUCUUAUG,34,30,18,20,102
2539,11,AAEQ01000019.1/51159-51260,CUUCGAAAAGAAUCACUGCCUCAUAUAAUCUUGGAGAUAAGGUCCAUAAGUUUCUACCUGGCAACCAUGAAUUGCUAGACUAUGAGGGGAAAAGUGUGUAAC,34,27,22,19,102
2540,11,AAEK01000017.1/86437-86538,AGAUAAUAUAAAACGAUCCUUCAUAUAUCCUCAAAGAUAAGGUUUGAGAGUCUCUACCGGGUUACCGUAAACAACCUGACUAUGAAGGCAGUGUGUCUUAUA,35,29,19,19,102
2541,11,CP000001.1/309094-309195,AAAGAAUAAUAUAUAAGACCUCAUAUAAUCGCGGGGAUAUGGCCUGCAAGUCUCUACCUAACGACCGUUAUUCGUUAGACUAUGAGGGAAAGUCACUCGGUA,34,26,22,20,102
2542,11,CP000410.1/1642356-1642451,AAAAUUGAAUAUCGUUUUACUUGUUUAUGUCGUGAAUUGGCACGACGUUUCUACAAGGUGCCGGAACACCUAACAAUAAGUAAGUCAGCAGUGAGA,31,28,21,16,96
2543,11,AAWP01000021.1/27378-27279,GUAUAAUCGCGCCGUUUGCUUCGUAUAACCCCAAUGAUAUGGUUUGGGGGUCUCUACCAGCUCCCGCAAAGUGCUGAUUACGAAGAGUUGAGAUCACUGU,23,29,25,23,100
2544,11,CP000721.1/2204674-2204778,AAAAAGUUAAUAAUAUUCACUUAUAUAAAUCUGAUAAUAAGGGUCGGAUGUUUCUACCAAGCUACCGUAAAUUGCUAUAGGACUAUAAGUGUCUACUUAAAAAUU,41,35,15,14,105
2545,11,CP000724.1/951516-951617,CUCAGUCGAAAAUUGAAGACUCAUAUAAUGUCGAUAAUAGGGUUCGACAGUUUCUACAGGAUCACCGAAAAUGAUUCUACUAUGAGUGAAAGUGUACCUAGG,35,28,22,17,102
2546,11,AANE01000012.1/49153-49054,AAGUUACCGCUUAAGCCCUCUCGUAUAACCCCACUAAUAUGGUUUGGGGGUCUCUACCAGGAACCGAUAAUUUCUGAUUACGAAGAGUAUUGCGUUAUGC,26,30,21,23,100
2547,11,AE017334.2/342356-342255,UUAAUACGGACGAUGUUACCUCAUAUAUACUCGAUAAUAUGGAUCGAGAGUUUCUACCCGGCAACCUUAAAUUGCUGGACUAUGGGGAAAACUAAUGAAUAU,34,30,20,18,102
2548,11,AAXV01000026.1/31334-31233,AUAGAUUCAUACAAUUUUACUCAUAUAAUAGCGAGGAUAUGGCUUGCAAGUUUCUACCGAUUUACCGUAAAUAAAUCGACUAUGGGUAGCAAUGCUUUUAGA,34,34,18,16,102
2549,11,AAWL01000019.1/26832-26933,AGACAACAUAUUGCUCCUACUCGUAUAAUUUUGAGAAUAUGGCUCAAGAGUCUCUACCGGGCAACCGUAAAUUGCCCGACUACGAGUGAAAGUGUACCUAGG,31,26,22,23,102
2550,11,AE016877.1/298774-298875,AGAAACAAUAAUAUAAGACCUCAUAUAAUCGCGGGGAUAUGGCCUGCAAGUCUCUACCUAACGACCGUUAUUCGUUAGACUAUGAGGGAAAGUCACUCGGUA,34,25,22,21,102
2551,11,BA000028.3/760473-760574,CAAUUUUUAUCCAAUGCCUUUCGUAUAUCCUCGAUAAUAUGGUUCGAAAGUAUCUACCGGGUCACCGUAAAUGAUCUGACUAUGAAGGCAGAAGCAGGUUCG,29,31,21,21,102
2552,11,CP000002.3/2295936-2295837,AAUUUGAUACAUUAUAUCACUCAUAUAAUCGCGUGGAUAUGGCACGCAAGUUUCUACCGGGCACCGUAAAUGUCCGACUAUGAGUGGGCGAUAAGAAAAC,32,26,22,20,100
2553,11,AAEN01000023.1/16980-17081,GAAAAGUGAAUAUUAUGCCGUCGUAUAAUAUCGGGGAUAUGGCCCGAAAGUUUCUACCUAGCUACCGUAAAUGGCUUGACUACGAGGCGUUUUUAUAAAGGU,30,30,25,17,102
2554,11,BA000043.1/272473-272574,UACGGAUAGACGAAAGCCCUUCAUAUAAGCGCAAGAAUAUGGCUUGCGCGUCUCUACCGGGCCGCCGUAAACGGCCCGACUAUGAAGGCAGAAGACGCUGCU,28,18,28,28,102
2555,11,AM406671.1/1321062-1320965,AAAACCGUGGGAAUAUAAUCUUAUUUAUACCUAGAAUAUGGCUGGGCGUUUCUACCUCGUACCGUAAAUGCGAGACAAUAAGGAAAUUCGAUUUUUCA,32,30,19,17,98
2556,11,CP000024.1/1182948-1183043,UCAAACAAUGAGAACAUUACUUAUUUAUGUCACGAAUGGGCGUGACGUUUCUACAAGGUGCCGUAACACCUAACAAUAAGUAAGCUAAUUUAGUCA,34,27,17,18,96
2557,11,AE017333.1/692981-693082,AGUAAUUUAAAAAAGACUUGUCGUAUAAUCAUGGGGAUAUGGCCCAUAAGUUUCUACCAAGCUACCGUAAAUAGCUUGACUACGCUUGUAUACAAUAUUUUA,35,33,17,17,102
2558,11,AP009351.1/425734-425836,GUUAAAUAAUUUACAUAAACUCAUAUAAUCUAAAGAAUAUGGCUUUAGAAGUUUCUACCAUGUUGCCUUGAACGACAUGACUAUGAGUAACAACACAAUACUA,41,32,13,17,103
2559,11,ABCF01000049.1/253-152,UAAAUAUGGUUUGCAUACCUUCAUAUAUCCUCGAUAAUAUGGUUCGAAAGUCUCUACCGGGUCACCGUAAAUGAUCUGACUAUGAAGGCAGUAUUCAUUUUG,29,35,19,19,102
2560,11,CP000724.1/3378356-3378255,AUAAAAACUAAAUAUUCAUCUCGUAUAACAUUGGAAAUAAGGUCCAAAAGUUUCUACCAGACUACCGUAAACAGUCUGACUACGAGGGUUAAAUAAGCAAUA,43,26,15,18,102
2561,11,BA000016.3/2871201-2871102,AUAAAAAAAUAAAUUUUGCUUCGUAUAACUCUAAUGAUAUGGAUUAGAGGUCUCUACCAAGAACCGAGAAUUCUUGAUUACGAAGAAAGCUUAUUUGCUU,37,33,16,14,100
2562,11,ABDW01000010.1/34311-34212,AAUAAAAAAUAAAUUUUGCUUCGUAUAACUCUAAUGAUAUGGAUUAGAGGUUUCUACCAAGAACCGAGAAUUCUUGAUUACGAAGAAAGCAAAUAGGCUU,40,30,17,13,100
2563,11,AAOX01000028.1/44442-44543,ACUGAAUAUGUCGUAUUACGUCGUAUAAUAUCAGGGAUAUGGCCUGAAAGUUUCUACCGAGCUGCCGUAAAUAGCUUGACUACGAGGUAAAUGUUUAUAGGG,30,31,25,16,102
2564,11,AARF01000133.1/10017-10118,UUAAUUUCAUAUAGGAAAACUCGUAUAAAUUCGGGAAUAUGGCCCGAAAGUCUCUACCCAGAAACCGUAAAUUUUUGGACUACGAGAAGAUAAGUACGGCAG,37,26,21,18,102
2565,11,AM180355.1/256217-256318,UAUAUAAAAUAUAAACUCACUCGUAUAUGCUCAGAAAUAUGGUCUGAGAGUCUCUACCAAGAUACCGUAAAUAUCUUGACUAUGAGUGAAAUUAUUAUACCA,39,32,14,17,102
2566,11,AAOX01000007.1/111657-111757,AUUCAUAAAAUAUUUAUUACUGUAUAUGUCCGGAAAUAAGGUCUGGACGUUUCUACCAAGCUGCCGUAAAUGGCUUGUCUACAGGUUAAGCUUUUCCCCGU,27,35,19,20,101
2567,11,CR378679.1/147737-147638,UAAUAAUGGGUAAAGUUACUUCGUAUAACCCCACUUAUAGGGUGUGGGGGUCUCUACCAGAAUCCGUAAAAUUCUGAUUACGAAGAGUUGAGUGAUUGAU,30,31,24,15,100
2568,11,CP000721.1/2808883-2808984,CAACAGUUCAUACAAAAGACUCGUAUAUUUCCGAUAUUAUGGUUGGAAAGUCUCUACCUGCUAUCCGUAAAUUAGCAGACUACGAGGUAGUGUUUUAGUGCU,30,33,20,19,102
2569,11,AAOX01000023.1/19446-19345,AUAAUUUCAUAACGAUACACUCAUAUAAUCGCGGGAAUAUGGCCUGCAAGUUUCUACCGGACUGCCGUUAACAGUCUGACUAUGGGUGAGCAAUGGGAGGCA,30,26,25,21,102
2570,11,AAFV01000199.1/507-412,UGAAUUCAAUAAUGACAUACUUAUUUAUGCUGUGAAUUGGCGCAGCGUCUCUACAAGACACCUUAAUGUCUAACAAUAAGUAAGCUUUUAGGCUUG,30,32,17,17,96
2571,11,AP006627.1/1039390-1039491,AAUGUCCAAUAGGAAAAUACCCGUAUAAUUGCAGGAAUAAGGCCUGCACGUUUCUACCGAGCCACCGUAAAUGGCUUGACUACGGCAUGAUAAAUGGAGCGC,33,22,24,23,102
2572,11,CP000232.1/2146016-2145914,AAAAUAAAUAUGGCAAUGGCCUGUAUAAUUGGGGGAAUAGGGCUCCCAAGUUUCUACCGGGCAACCGUAAAUUGCCCUGGCUACAGCCUGAAAGUGUACCUCA,31,24,25,23,103
2573,11,BA000032.2/1369721-1369820,UAUAAUCGCAAGCGUUUGCUUCGUAUAACCCCAAUGAUAUGGUUUGGGGGUCUCUACCAGUUCCCGCAAAGUGCUGAUUACGAAGAGUUGAGAUCACUGU,25,30,24,21,100
2574,11,BA000043.1/282580-282681,AUAGUGUAUGAGAAGAUCCCUCAUAUAAUUUUGGGAAUAUGGCCCAAAAGUUUCUACCCAAUCACCGUAAAUGAUUGGACUAUGAGGGAAAGGAUCGGUUUU,33,30,23,16,102
2575,11,CP000612.1/2517987-2517886,CUAUAAAUAAAAAAAUUAACUCGUAUAUUUUCAAGAAUACGGCUUGAAAGUUUCUACCAGGCUACCUUAAAUAGCUUGACUACGAGUUUAAUGUCUAUAGUA,38,34,14,16,102
2576,11,CP000612.1/2598111-2598012,AGUUUGUACAAAUUAAUGUUCCGUAUAUGCUUGGGAAUUGGCUCAAGUGUUUCUACCGGGCAACCGUAAUUGCCCGACUACGGGAGGGAAAGUGUACCUA,26,29,26,19,100
2577,11,AAXV01000001.1/285704-285603,AAUGUAAAUUAAAUAAGUCGUCGUAUAAUGUCGGGAAUAGGGCCCGUGAGUUUCUACCAAGUUACCGUAAAUAACUUGACUACGAUUGAGGUUUAUAUACGU,33,32,22,15,102
2578,11,AP006627.1/1554717-1554818,UAAACGAACAAAGCAUCAGCUCGUAUAAUAGCGGUAAUAUGGUCCGCGAGUCUCUACCAGGCUGCCGAUAACGGCCUGACUACGAGUGGUCUUUUUCAGUUG,27,26,25,24,102
2579,11,CP000764.1/357645-357544,UUAAUACGGACGGUGUUACCUCAUAUAUCCUCGAUAAUAUGGAUCGAGAGUUUCUACCUGGCAACCAAUAAUUGCCGGACUAUGGGGAAAACUAAUGAAUAU,33,29,21,19,102
2580,11,CP000557.1/252200-252301,ACGAACAGAACGAAAGCCUUUCAUAUAUGCGUGGGAAUAUGGCUCACGUGUCUCUACCGGGCCGCCGUAAACGGCCUGACUAUGAAGGCAGAAGACGCUGCU,28,20,28,26,102
2581,11,CP000416.1/1798040-1798138,CAAUUAAAAUAAGUGAUUGCCUAUAUAAUGCCAUAAUAAGGUUGGCGAGUUUCUACCCAGGACCGUAAAUUCUGGACUAUAAGCAAAUUGAGAUGAACU,36,28,19,16,99
2582,11,AACY020193176.1/1612-1511,AUUAAAACAUCUUCAAUAAAUCGUAUAAUAGAUCGAAUGUGGCGGUCAAGUUUCUACCAUAUCACCGUAAAUGAUAUGACUACGAUUGAAUCUUUUCCUGUU,34,35,15,18,102
2583,11,CP000728.1/2202500-2202399,ACAAAAUAAAAUAUUCGCUCUUAUAUAAUUCUGAUAAUAGGGUUCAGAAGUUUCUACAGAGUAGCCUUAAACUACUUUACUAUAGGAGAUGUUAUUAGGAUG,37,35,17,13,102
2584,11,AP006716.1/2598940-2598838,CGUUAAAUAAUUUAUAUCACUCAUAUAAUCUAAAGAAUAUGGCUUUAGAAGUUUCUACCAUGUUGCCACAAACGACAUGACUAUGAGUUCAGACUCAAUACAU,38,33,13,19,103
2585,11,ABCF01000002.1/125327-125427,AUUAUAUUUGAAUAAUAACCUUGUAUAAGUUCAGGAAUAUGGCCUGAGCGUUUCUACCAGCUACCAUAAAUAGCUUGUCUACAAGGAUAGUGAUGAUUGAA,34,33,19,15,101
2586,11,AAPS01000004.1/87369-87468,UAUAAUCCCUCUCGUUUGCUUCGUAUAACCCCAAUGAUAUGGUUUGGGGGUCUCUACCAGUUCCCGCAAAGUGCUGAUUACGAAGAGUUGAGAUCAUCGU,23,32,22,23,100
2587,11,BA000004.3/650309-650410,AAUAAAUCGAAAACAUCAUUUCGUAUAAUGGCAGGAAUAGGGCCUGCGAGUUUCUACCAAGCUACCGUAAAUAGCUUGACUACGAAAAUAAUGGGUUUUUUA,36,29,20,17,102
2588,11,ABCQ01000013.1/101307-101406,AACUACGUCAUUAAAUCACUUCGUAUAAUCCCAAUAAUAUGGUUUGGGAGUUUCUACCAAGAUCCUUAAACUCUUGAUUAUGAAGUCUGUAACUUUAAAA,34,35,13,18,100
2589,11,AANE01000012.1/71437-71536,AAUUUAGCCGCGAAAUUGCUUCGUAUAAUCCCAAUGAUAUGGUUUGGGAGUUUCUACCAAGAACCUUAAAUUCUUGAUUAUGAAGUCUGUAACUUUAUGG,29,36,19,16,100
2590,11,CP000382.1/2143272-2143175,GCAGAGAAAUAAAAUAUCACUUAUAUAUACCCUGGAUAUGGCAGGGAGUUUCUACCGGAAACCUAAAAUUUCCGACUAUGAGUGAGUGGACUUGUUGC,32,27,22,17,98
2591,11,BA000028.3/769686-769786,UGAUGUAAUUGAAUAGAAAUGCGUAUAAUUAAGGGGAUAUGGCCCACAGUUUCUACCAGACCACCGUAAAUGGUUUGACUACGCAGUAAUUAUAUUUGUAU,33,32,21,15,101
2592,11,CP000721.1/398929-399026,AAUAUAGCACAUUUGAAAACUUAUAUAUACCUUGAAUAUGGCAAGGAGUAUCUACCGGGAGCCGUAAAUUUCCGACUAUAAGUGAUAUUAGUAUAGGC,35,29,19,15,98
2593,11,ABDQ01000005.1/131908-131807,UAAAUACGUUAUUAAAUAACUCAUAUAAAUCCGAUAAUAUGGUUCGGUUGUUUCUACAGGAAUACCUUAAAUAUUCCCGCUAUGAGUAAAUCUAUGUAUAAU,37,37,13,15,102
2594,11,AAEK01000052.1/27552-27453,AUUAAUUACAUAUGAGAAUCAUGUAUAACUCCAAGAAUAUGGCUUGGGGGUCUCUACCAGGAACCAAUAACUCCUGACUACAAAAUGCGUAUUAUAGCGU,35,28,18,19,100
2595,11,CP000764.1/1409725-1409826,AAUAAAUAAGUUAGCUACACUCAUAUAAUCGCAGGAAUAAGGCCUGCAAGUUUCUACCGAAGUACCGUAAAUACUUCGACUAUGAGUGAGGACGAAUAGAUU,38,26,20,18,102
2596,11,ABCH01000048.1/17619-17718,UACAAUACCAAUCGUUUGCUUCGUAUAACCCCAAUGAUAUGGUUUGGGGGUCUCUACCAGCUCCCGCAAAGUGCUGAUUACGAAGAGUCAAGAUCACAUU,28,28,20,24,100
2597,11,AAXV01000001.1/277776-277678,AGGAAAAACAAAUAAAUCCCACAUAUAUGCUAGAGGAUUGGCUCUAGUGUCUCUACCCGGCACCGUAAAUGCUGGACUAUGCGGGAAAGCACUUUUGGC,31,23,23,22,99
2598,11,ABCF01000040.1/17523-17422,AAAACAACAAGUAAACACCCUCAUAUAAUCUUGGGAAUAUGGCCCAUAAGUAUCUACCCGGUUACCGUAAAUGAUCGGACUAUGAGGGAAAGUAGCUGUCUG,36,24,21,21,102
2599,11,AARF01000407.1/2878-2779,AUCAGUCAAAAUAAACAAACUCGUAUAAUCUCGGGAAUUGGCCCGGGAGUCUCUACCUAAUCACCGGAAUGAUUAGCCUACGAGUGAUGCAACCUCAUAU,33,24,19,24,100
2600,11,CP000557.1/256359-256460,GUGAAUAUUGUCGAAUUCCGUCGUAUAAUCCCGGGAAUAUGGCUCGGGAGUUUCUACCAAGCUACCGUAAAUAGCUUGACUACGAGGGAUGUGAAGUAGAGG,28,27,29,18,102
2601,11,AP008934.1/2407710-2407608,CAGUUAAUAAUUUAUCUAACUCAUAUAAUCUGAAGGAUACGGCUUUAGAAGUUUCUACCAUGUUGCCAUUAACAACAUGACUAUGAGUAACCAAUACAAUACA,39,32,13,19,103
2602,11,BA000028.3/786767-786867,CCGACAAUUGAAAAUGAACCUCAUAUAAAUUUGAGAAUAUGGCUCAGAAGUUUCUACCCAGCACCGUAAAUGGCUGGACUAUGAGGGAAGAUGGAUCAUUU,35,26,22,18,101
2603,11,BA000004.3/676475-676576,CGUUCUUUAUAUAAAGUACCUCAUAUAAUCUUGGGAAUAUGGCCCAAAAGUUUCUACCUGCUGACCGUAAAUCGGCGGACUAUGGGGAAAGAUUUUGGAUCU,29,32,22,19,102
2604,11,CP000612.1/2382946-2382847,UACUCAUAAUGAAAUAGAUUCCGUAUAUGCUUAGGAAUUGGCUUAAGUGUUUCUACCGGGCAACCGUAAUUGCCCGACUACGGAGGGAAAGUGUACCUAG,29,28,24,19,100
2605,11,CP000232.1/1272748-1272647,AAAAAUAAUUUAACCCUGCUUCGUAUAUUCCCGGAAAUGCGGUCCGGGAGUUUCUACCAGGCAACCGUAAAUUGCCCGGCUACGAAGGUUAUUCUUCGUCGU,26,29,22,25,102
2606,11,ABDQ01000007.1/13684-13586,AAAAGAAUAUAACCACGUACUCAUAUAAGCCUAGAAAUAAGGUCGGGCGUUUCUACCAAAUACCGUAAAUAUUUGACUAUGAGUGGUCUAGUGUAAAUA,38,27,18,16,99
2607,11,CP000673.1/2764266-2764166,UAAAUUUUUCGAUAAAUCAUUCGUAUAAUCUUGAUAAUAUGGUUCAAGAGUAUCUACCAAGGCACCAAAAAUCCUUGACUAUGAGUGAAUCACGGGAAAGU,37,31,17,16,101
2608,11,AP006627.1/1115665-1115766,AAGUUAAAAACGAAAACACCUCAUAUAUACUCGGGAAUAUGGCUCGAACGUUUCUACCCGGCAACCGUAAAUUGCCGGACUAUGAGGGGAAGUCAUUACGCG,34,22,23,23,102
2609,11,ABDP01000002.1/29688-29587,UGAAAUAAGUUAAUAAUCAUCCAUAUAAUCUCAAUAAUAAGGUUUGAGAGUCUCUACGAGAGAACCAUAAAUUCUCUGUCUAUGGAUGGAUCUUAGCUAUGC,36,33,17,16,102
2610,11,AAXV01000018.1/6190-6091,AGCUAAAGUAAAUAUUUGAACUGUAUAACCUCAAUAAUAUGGAUUGAGGGUCUCUACCAGGAACCAUAAAAUCCUGACUACAAAACUUUGUUUCAUUUUU,36,33,14,17,100
2611,11,CP000425.1/1176227-1176324,UUGAGCUGCUAUAAACAAUCUUAUUUAUACCUAGAAUAUGGCUGGGCGUUUCUACCUCGUACCGUAAAUGCGAGACAAUAAGGAAAUUCGAUUUUUCA,30,32,18,18,98
2612,11,AAML04000013.1/228851-228749,AUUCAUGUUUUGUACUGUAUAACAUAUAAUUUUGACAAUAUGGGUCAUAAGUUUCUACCGGAAUACCGUAAAUAUUCUGACUAUGUAUACUAUUAUUUAGUUA,33,43,14,13,103
2613,11,CP000002.3/697032-697134,CAUGACAUGAAAACACAUCCUCAUAUAAUCUUGGGAAUAUGGCCCAUAAGUCUCUACCCGAUGACCGUAAAUCAUCGGACUAUGCAGGAAAGUGGACAAUAAA,38,23,19,23,103
2614,11,CP000557.1/264915-265016,AUAGCGUACAAAAAAAUCCCUCAUAUAAUUUUGGGAAUAUGGCCCAAAAGUCUCUACCCAAUAACCGUAAAUUAUUGGACUAUGAGGGAAAGGAUCUGUUUU,37,29,18,18,102
2615,11,AAOX01000028.1/42464-42565,UCAUAAUUUAAUAUGCACCUUCAUAUAUCCUCGAUAAUACGGUUCGAAAGUCUCUACCAGGUCACCUUAAAUGACUUGACUAUGAAGGCAGGUCAUUCUAUA,32,33,15,22,102
2616,11,CP000764.1/308099-308200,AAACAAUAUUAUAUCGCACCUCAUAUAAUCGCGGGGUUAUGGCCUGCAAGUCUCUACCUAACGACCGUUAUUCGUUAGACUAUGAGGGAAAGUCACUCGGUA,30,28,21,23,102
2617,11,AE017333.1/4024324-4024425,AAAUAAUAGAAGCCCACUUCUUGUAUAUAAUCAGUAAUAGGGUCUGAUUGUUUCUACCUGGCAACCGUAAAUCGCCAGACUACAAGGAAGUUUGAAUAGAUU,35,30,19,18,102
2618,11,AE001437.1/2824953-2824856,AAUCGUUAAUAUAGUUUAACUCAUAUAUUUCCUGAAUAUGGCAGGAUGUUUCUACAAGGAACCUUAAAUUUCUUACUAUGAGUGAUUUGUUUGUAUGC,29,40,16,13,98
2619,11,CP000232.1/1265132-1265031,CAAUAAAGCCAGUCUUAACUUCGUAUAUCCCCGGCAAUAGGGACCGGGGGUUUCUACCAGGCAACCGCAAAUUGCCCGGCUACGAAGGUAUAUCUUCGUUGC,26,24,24,28,102
2620,11,BA000004.3/1593074-1592973,AUUUACAUUAAAAAAAGCACUCGUAUAAUCGCGGGAAUAGGGCCCGCAAGUUUCUACCAGGCUGCCGUAAACAGCCUGACUACGAGUGAUACUUUGACAUAG,33,24,22,23,102
2621,11,CP000612.1/3007877-3007778,GGACAUAAAUGAAUCGUUUUCCGUAUAUGCUUGGGAAUUGGCCCAAGUGUUUCUACCAGGCAACCGUAAUUGCCGGACUACGGAGGGAAAGUGUACCUAG,27,26,27,20,100
2622,11,BA000043.1/274257-274358,AUGAAUAUUGUUGAAUUCCGUCGUAUAAUCCCGGGAAUAUGGCUCGGGAGUUUCUACCAAGCUACCGUAAAUAGCUUGACUACGAGGGAUGCGGGAUCGGAG,27,27,29,19,102
2623,11,ABCQ01000053.1/17569-17470,AUUCUGCAAUUAGUUUCCCUUCGUAUAACCCUAAUAAUAUGGAUUAGGGGUCUCUACCAGGAACCAAUAAUUCCUGAUUACGAAGAGUUUAGUACUUUAG,30,34,17,19,100
2624,11,CP000382.1/1443221-1443123,ACAGAAUAUUAAUCACGUACUCAUAUAAGCCCAGAAAUAAGGUCGGGCGUUUCUACCAAAUACCGUAAAUAUUUGACUAUGAGUAGUCUAGUGUAAAUU,36,29,17,17,99
2625,11,AAOX01000052.1/9069-8968,AUUUAUAUAAAGAUUUACCCUUAUAUAAUAAUGGGGAUAUGGCCCAUAAGUUUCUACCUGGCUGCCGUAAAUGGCCGGACUAUAAGGGAAAGAUGAUAUGAC,34,30,22,16,102
2626,11,CP000724.1/944285-944386,AAUUACAUUGUAUAACACACUCAUAUAAUGCCGAAAAUAAGGUUCGGAAGUUUCUACCGGAUGACCGUAAAUCAUCUGACUAUGGGUGAAAUUAUUAUAGGA,37,30,19,16,102
2627,11,BA000028.3/1103943-1104044,AAACCUUAUAUAUAGUUUUUUCAUAUAAUCGCGGGGAUAUGGCCUGCAAGUUUCUACCGGUUUACCGUAAAUGAACCGACUAUGGAAAAGCGGAAAAUUCGA,33,30,21,18,102
2628,11,ABDQ01000002.1/251055-251152,ACAGAGAGAUAAAAUAUCACUUAUAUAUACCCUGAAUAAGGCGGGGAGUUUCUACCGGAAACCGAAAAUUUCCGACUAUGGGUGAGUGGAUUUGUUGC,32,26,24,16,98
2629,11,AAMR01000003.1/106610-106709,UAUAGUAGCAACCGUUUGCUUCGUAUAACCCCAAUGAUAUGGUUUGGGGGUCUCUACCAGCUCCCGCAAAGUGCUGAUUACGAAGGGUUUAGAUCACAAU,26,29,23,22,100
2630,11,AE016877.1/1515239-1515340,AAAUAAAUAGUUAGCUACACUCAUAUAAUCGCGGGGAUAUGGCCUGCAAGUUUCUACCGAAGUACCGUAAAUACUUUGACUAUGAGUGAGGACGAAUAUAAU,36,28,21,17,102
2631,11,CP000961.1/1440820-1440919,GCCUCCACAAAACUUAAGCUUCGUAUAAUCCCAAUGAUAUGGUUUGGGAGUUUCUACCAAGAGCCUUAAAUUCUUGAUUAUGAAGUCUGUAGCUUUAUAU,29,35,17,19,100
2632,11,CP000879.1/2164445-2164546,AAUAAAGAAAAAACCUCUUUCUGUAUAAUGCCGAUAAUAAGGUUCGGCAGUUUCUACCAAACAGCCGUAAACUGUUUGACUACAGUAAGAGGGGUCUGAGAU,36,27,21,18,102
2633,11,ABCC02000029.1/238020-237925,GAAGUAUAAGUAUUCAAAACUUAUAUAUGCUCAAGAUAGGUUGAGCGUUUCUACCAACUACCGUAAUAGUUGACUAUAAGUUUUCACAUCAGGUAC,33,31,16,16,96
2634,11,AL009126.3/698372-698470,GAAAUCAAAACACGACCUCAUAUAAUCUUGGGAAUAUGGCCCAUAAGUUUCUACCCGGCAACCGUAAAUUGCCGGACUAUGCAGGAAAGUGAUCGAUAA,35,22,20,22,99
2635,11,AE009948.1/1094305-1094210,CAAUUAAAUAUAUGAUUUACUUAUUUAUGCUGAGGAUUGGCUUAGCGUCUCUACAAGACACCGUAAUGUCUAACAAUAAGUAAGCUAAUAAAUAGC,35,31,15,15,96
2636,11,AL009126.3/4005526-4005624,CUUAGAAAAAGACAUUCUUGUAUAUGAUCAGUAAUAUGGUCUGAUUGUUUCUACCUAGUAACCGUAAAAAACUAGACUACAAGAAAGUUUGAAUAAAUU,39,32,15,13,99
2637,11,CP000853.1/585464-585565,AGUGAAUAUGGAUUUUAAAUUUAUAUAAUGCUAAUAAUAUGGAUUAGCAGUCUCUACCGAAUAACCGUAAAUUAUUCGACUAUGAAUGAAAGUGUACCUAGG,38,34,18,12,102
2638,11,CP000923.1/528300-528401,AAUAGUUUUAUUAGAGGAACUCAUAUAAUCCCGUGAAUAUGGCACGGGAGUUUCUACAAAGCAGCCGUAAACUGCUUUACUAUGGGUGGAAUUUGUUGUUGC,29,33,24,16,102
2639,11,CP001348.1/1707991-1708092,UUAAAUUAUGGAAAAGUAUCCCGUAUAUUUUCGGUAAUAUGGUCCGACAGUUUCUACGAAGCCGCCGUAAAUGGCUUUGCUACGGGUGUUCAUCUUAGACAU,27,34,22,19,102
2640,11,CP001022.1/235041-235140,GAAUAAACGUAUAGCAACGCUCGUAUAAUAGUGGGGAUUGGCCCACGAGUCUCUACCGGAUCGCCGUAACGAUCCGACUACGGGUGGUGAGUUACUGCUC,25,23,28,24,100
2641,11,AE008691.1/586365-586464,AAAAAUUUAAUAAGAAGCACUCAUAUAAUCCCGAGAAUAUGGCUCGGGAGUCUCUACCGAACAACCGUAAAUUGUUCGACUAUGAGUGAAAGUGUACCUA,37,25,19,19,100
2642,11,CP001022.1/459660-459761,AAAUCAUACAUGCAUCUCCUUUGUAUAUACUCGCGAAUAUGGCGUGAGAGUCUCUACCGGGUCACCUUAAACGACCUGACUAUGAAGGAGCAGACCCUUCGU,28,27,21,26,102
2643,11,AP008230.1/4499767-4499666,AAAAAAUUUAAAUAGGGCGUUCAUAUAAUCGCGGAGAUAGGGUCCGCAAGUUUCUACCGGGCUGCCGUAAAUGGCCUGACUAUGAGCGAAACUGUGCCCAGG,30,23,28,21,102
2644,11,CP000726.1/362953-363054,UCAUAUAUCAUAUAAAAAGCUCGUAUAUCAUCGGUAAUAUGGUCCGAAAGUUUCUACCUGCUAACCAUAAAUUAGCAGACUACGGGGUAUUGUGUAUUUAGU,33,34,18,17,102
2645,11,U51115.1/11655-11754,AGAAAUCAAAUAAGAUGAAUUCGUAUAAUCGCGGGAAUAUGGCUCGCAAGUCUCUACCAAGCUACCGUAAAUGGCUUGACUACGUAAACAUUUCUUUCGU,33,28,19,20,100
2646,11,ABDT01000094.2/185981-186078,GAUACGGCACAUUAAAAAACUCAUAUAUACCCUGGAUAUGGCAGGGAGUAUCUACCGGAAACCUUAAAUUUCUGACUAUGAGUGAUAUUAAUAUAAGC,36,27,18,17,98
2647,11,BA000016.3/2618421-2618324,AAAACGGAAUAUAAACAAACUCGUAUAAGCUUUGAAUAAGGCAAGGCGUUUCUACCGGAAACCUUAAAUUUCCGUCUAUGAGUGAAUUUGAUAUACUA,37,28,17,16,98
2648,11,CP000903.1/3101719-3101616,AUAAUUUUAAAUAACAUCACUCGUAUAUACUCGGUAAUAUGGUCCGAGCGUUUCUACCUAGUUCCCAAUGAAAGAACUGGACUACGGGUUAAAGUAUUCGGUCG,32,32,20,20,104
2649,11,AE005176.1/1159509-1159606,UAGUCUAUAAUAGAACAAUCUUAUUUAUACCUAGGAUAUGGCUGGGCGUUUCUACCUCGUACCGUAAAUGCGAGACAAUAAGGAAAUUCGAUUUUUUA,31,33,18,16,98
2650,11,CP001581.1/3749039-3748942,UCAAUAUUUCCAAAGUCAACUCAUAUAUCCCCAUAAUAAGGGUGGGAGUAUCUACCGAGAACCAUAAAUUUUCGACUAUGAGUGAUUAUUAAUAAUGC,35,30,15,18,98
2651,11,CP000923.1/531630-531731,GACAAUUGAAUAAAAAGCACUCAUAUAAUCUCGAGAAUAUGGCUCGAGAGUCUCUACCGAACAACCGUAAAUUGUUCGACUAUGAGUGAAAGUGUACCUAGG,37,25,21,19,102
2652,11,CP000853.1/582547-582648,UAUUUAAAAACGAAUAUCACUCAUAUAAUACCGAUAAUAUGGUUCGGAAGUAUCUACCGAAUGACCGAGAAUCAUUCGACUAUGAGUGGAAUUAUUAUAUUA,39,32,16,15,102
2653,11,CP000851.1/4146892-4146991,UAAUAUUUACCGUUAACACUUCGUAUAAUCUCAAUGAUAUGGUUUGAGAGUUUCUACCAAGAGCCCUAAACUCUUGAUUAUGAAGACUUUACUUUAUGUA,31,38,14,17,100
2654,11,CP001186.1/253132-253233,GAAAAGUGAAUAUUAUGCCGUCGUAUAAUAUCGGGGAUAUGGCCCGAAAGUUUCUACCUAGCUACCGUAAAUGGCUUGACUACGAGGCGUUUGUAUAAAGAU,31,29,25,17,102
2655,11,D88802.1/12464-12365,AAUUAAAUAGCUAUUAUCACUUGUAUAACCUCAAUAAUAUGGUUUGAGGGUGUCUACCAGGAACCGUAAAAUCCUGAUUACAAAAUUUGUUUAUGACAUU,35,35,15,15,100
2656,11,CP001022.1/474287-474388,GGAAGAUUGAAUAUAACACCUCGUAUAAUAGCAGGGAUAUGGCUUGCAAGUUUCUACCCGACGACCCUAAAUCGUUGGACUAUGGGGUAUAUGGAUGUUCGU,29,29,26,18,102
2657,11,ABDT01000031.2/13681-13582,UUUAAAUUAAUAAAUGAGUUUCGUAUAAUUCCAAUAAUAUGGUUUGGAAGUCUCUACUAGGAACCUAUAAUUCCUAAUUACGAAGAAAAUUUUAUGCAAA,39,36,13,12,100
2658,11,CP001098.1/539421-539522,AUAUAUCAUUGUAUUUUGCCUCGUAUAAUUGUGGAGAUAUGGUCCACGAGUUUCUACCGGACGGCCGUAAACUGUUCGACUACGGGGGAAACACCUGGGAUG,25,30,27,20,102
2659,11,CP003056.1/1723617-1723718,CAAUUCAAUAUGCAAUACCAUCGUAUAUAUUCAGGGAUAUGGCCUGAACGUUUCUACCAAGCUGCCGUAAAUAGCUUGACUACGAGGUAAUGAGAUAGAGUC,33,28,21,20,102
2660,11,AL935263.2/2968829-2968731,UUAUCAAUACAACUAAUUGCCUAUAUAAUGCCAUGAUAUGGAUGGCGAGUUUCUACCCAGUGCCGUAAACACUGGACUAUAAGCGAAUUGAGUCGACGG,31,27,21,20,99
2661,11,CP003056.1/1737361-1737461,AUACAAAGUGAAUAUGACCCUCAUAUAUAAUGGGAAUACGGCCCAUACGUCUCUACCCGGUUACCGUAAAUAAUCGGACUAUGAGGGAAAGCGGAAGUUGG,34,23,24,20,101
2662,12,BX842649.1/277414-277318,ACCUGACGCUAGGGGUGUUGGUGAAUUCACCGACUGAGAAUAACCCUUUGAACCUGAUAGAGAUAAUGCUCGCGCAGGGAAGCAAGAAUAGAAAGAU,32,20,27,18,97
2663,12,Z82044.1/19193-19300,AAUAGUUACUGGGGGUGCCCGCUUUCGGGCUGAGAGAGAAGGCAAGCUUCUUAACCCUUUGGACCUGAUCUGGUUCGUACCAGCGUGGGGAAGUAGAGGAAUUGUUUU,23,30,35,20,108
2664,12,BX571861.1/7126-7022,GCCAUCUCAACGGGGUGCUGGCUGUUUAAAACAGCCUUGCUGAGAGUAAACCCGCCGAACCUGAUCCGGCUAAUACCGGCGUAGGGAUUUGAGCUGCUAACUAUU,25,25,28,27,105
2665,12,AF104225.1/570-680,CGUUACCACAGGGGGGGCUUCUUAGCUGAGAUUGAGUCCACGUGUUUUUGGAUUCUGACCCUUUGAACCUGUUCGUUAAUACGAGCGUAGGGAUUGUGGCGAUUGCAUUUC,20,37,32,22,111
2666,12,AY123045.1/16666-16547,AGUCCCUGUCAGGGGAGUCUCGCCAGAGAGACUGAGAGGCUAAUAGCGAUUUUCGCGGCUUAGCGACCCUUAGAACCUGACCCAGCUGAUACUGGCGUAGGAAGACUCGUAUCUUGAUGA,29,27,35,29,120
2667,12,AB118748.1/319-422,UGGAGGGGUACCGGGUGUACGAGGCAGAGUCCGGUCGUUCUGAGAUUAUACUGUCAUAACUUGAUCUAGAUAAUACUAGCGAAAGGACAUGCGUGGCAUUGAUU,27,28,32,17,104
2668,12,AF070520.1/2088-2190,GCGCAUUCCGAGGGGAGCACUAGACGGUGCUGAGAUGGCGUUGAGCCGGACCCUUGAACCUGAUCCGGGUCAUGCCGGCGUAGGAACGGAAAGAAGGCCGCCA,23,15,38,27,103
2669,12,BX927152.1/148798-148691,AUACUAGGCACGGGGUGCCAACCGGAUGGAAAAAUUCCGGAGGCUGAGAAAACACCCGUUGAACCUGCUCUAGCUCGUACUAGCGAAGGGAUGGCCUUAACGUGGCUA,30,20,32,26,108
2670,12,AL627265.1/128216-128117,CCGAACUCAACGGGGUGCCGCGCUCAUGCGCGCGCUGAGAAAAUACCCGUCGAACCUGAUCCGGAUAAUGCCGGCGAAGGGAUUUGAGGCUACCUCUCAA,24,17,29,30,100
2671,12,AB042239.3/9807-9660,AGGCGUCACAAGAGGAGCUUUUGCUGAGAAUGACCUCCAGUUUUAAGUAAAUUCCAUAACAUUGGAGUUUUGCGCAAAGUCUGGGUGUCUAAACUCUUUGAACCUGAACAAGGUAAUGCUUGCGUAAGGGAUGUGCAGAAAUAAGUGG,44,41,39,24,148
2672,12,X54035.1/52-153,GAUGACCACAAGGGGAGCAUUAAAGCUGAGAGUGAGCGGUUUCGUUCUGACCCUUUGAACCUGUUAGUUAACGCUGGCGUAGGGAUGUGGCAAAUGCAAUAG,27,25,32,18,102
2673,12,AD000014.1/41361-41472,GGGUACCCACGCGGGAGCGCAACGCCGAGUGCGCUGAGAGGACGGCUCGGGGCCGUCGACCGUACGAACCUGACCGGGUAAUGCCGGCGUAGGGAGUUGCAAAUGACCAUCA,24,14,42,32,112
2674,12,BX640423.1/313922-313811,AGGAUCACGCAGGGGUACUCGCUGUCCCGCCUUCAAGGCCGGCAGCGUGUUGAGAGAGUCCCUUCGUACCAGUACGGAUAAUGCCGAUGCUGGGAGCGUAUUCCAGUUGCCG,21,24,36,31,112
2675,12,AL596164.1/123476-123581,AAGAAAAACUAGGGGGGCCGAUUCUGGCUGAGAUAGGAAGGUAAUGCUUUCUGACCCUUUGAACCUGUUUGUUAGUGCAAGCGUAGGGAAGUGAAUGUGAAAGUGA,31,27,34,14,106
2676,12,AK068703.1/2083-2217,UGUUAGGAGGUGGGGUGCCUGUAUUCUCAACGAUCUGAAGGCCUCUUGGCCUGGAUUGUUGUGAAUUGGGCUGAGAAAGUCCCUUUGAACCUGAACAGGAUAAUGCCUGCGAAGGGAGUGUGCAUUUCUACUUUU,28,42,41,24,135
2677,12,AL445066.1/239884-239777,AACUAGGCGAGGGGGAGCUCCAUAAGGGGGCUGAGAGGAUCCGGAUGGAUCGACCCCUGGAACCUGAUCCGGGUAAUACCGGCGGAGGGAAUCGUAUGAUGAAUGAGA,29,17,41,21,108
2678,12,BX572604.1/199848-199986,GCCCGUUCCGAGGGGGGCUCCGACGAGGAGCUGAGAUACCGCACGCUCGCCGCUUCGCUCCGCGAGGCACAGAGACCGCGGUGACCCUUUGAACCUGAUCCGGGUCAUGCCGGCGAAGGGACAGGGAUGCAUCAGACAG,27,19,49,44,139
2679,12,M33642.1/428-524,GUGUACAUCAAUGUCAAGAAGAGGAGAGCGUGGCUGAGAUUAUACGGCGAAACUUGAUCUGGAUAAUACCAGCGAAAGGAUCAUGCUCUCCUCCCCC,29,21,25,22,97
2680,12,AJ002571.1/43977-43865,GGAAAGCACUAGGGGUGCUGUUUUGGCUGAGAUAAAGCGCGGAAGAAACGCGCUUUGAUCCCUUAUGACCCGAUCUGGAUAAUACCAGCGUGGGGAAGUGCAGGUUGACCGAA,30,24,37,22,113
2681,12,AC084406.7/91434-91300,AAGUUGCACCAGGGGUGCCUGUAUUCUCAACGAUCUGAAGGCCUCUUGGCCUGGAUUGUUGUGAAUUGGGCUGAGAAAGUCCCUUUGAACCUGAACAGGAUAAUGCCUGCGAAGGGAGUGUGCAUUUCUACUUUU,30,40,38,27,135
2682,12,AL583918.1/33385-33496,AAAAAACCACGCGGGAGCACACACCAAGUGCGCUGAGAGGACGGAUCGGGGCCGUCGACCGUAUGAACCUGACCGGGUAAUGCCGGCGUAGGGAGAUGAAUAAUGACUGAAA,35,14,37,26,112
2683,12,AL583918.1/38806-38668,ACUUCAGUACACGGGAGUCCCCAGGCAGUCCGAAUCUGCGGGGCUGAGAGUGGGCACAGCCAGAGUGACUGAACCUACCCUUACCCUCCCACACCUGAUCCGGGUCAUGCCGGCGAAGGGAGGUUCAAGAUGCCGUCAG,31,23,42,43,139
2684,12,AB033416.1/2076-2219,UCAUGCAUGAGCCGGUGCCCAUUCUUCUCCCAUCAGCAUGGUCAGUUCAAACUGGUCGUGUUGAUGAUAGGGGGAUGUGGCUGAGAUUAUACGGCAAAACUUGAUCUGGAUAAUACCAGCGAAAGGAUCAUGUCAUCUCCCCUA,36,39,36,33,144
2685,12,AF264948.1/14680-14561,GGUUCCUGUCAGGGGAGUCUCGCCAGAGAGACUGAGAGGCUGAUAGCGAUUUUCGCGGCUUAGCGACCCUUAGAACCUGACCCAGCUGAUACUGGCGUAGGAAGACUCGUAUCUUGAUAA,28,28,36,28,120
2686,12,M73546.1/221-329,UUUAACCACUAGGGGUGUCCUUCAUAAGGGCUGAGAUAAAAGUGUGACUUUUAGACCCUCAUAACUUGAACAGGUUCAGACCUGCGUAGGGAAGUGGAGCGUAUUUGUG,29,31,30,19,109
2687,12,AF269819.1/1816-1718,AUUUGCUACUAGGGGAGCCAAAAGGCUGAGAUGAAUGUAUUCAGACCCUUAUAACCUGAUUUGGUUAAUACCAACGUAGGAAAGUAGUUAUUAACUAUU,33,30,21,15,99
2688,12,BX842573.1/168419-168309,GGGUACCCACGCGGGAGCGCACGCCGAGUGCGCUGAGAGGACGGCUCGGGGCCGUCGACCGUACGAACCUGACCGGGUAAUGCCGGCGUAGGGAGUUGCAAAUGACCAUCA,23,14,42,32,111
2689,12,BX842573.1/159140-159250,CCCUGUAGACACGGGAGUCCCGGGAGCGGGGUCUGAGAGUGGGCGCGCCUGCCCUUACCGUCACACCUGAUCCGGAUCAUGCCGGCGAAGGGAGGUCAAGGAUGGCGUCCG,19,17,42,33,111
2690,12,AL766847.1/94269-94358,AUAGGACAUUUGGGGUGCGUAACAGCUGAGAUUAUACCCAUUGAACUUGAUACAGUUAGUACUGUCGAAGGGAAAUGUGUGCCAUUACAA,28,25,23,14,90
2691,12,AF269570.1/1830-1729,UAGUAUCAUUAGGGGUGCAAUUCAAUUUGCUGAGAGAAAGUCUACUUUCAACCCUUGAACCUGUUGGUUAGCACCAGCGUAGGAAAGUGAGCAAUAUUGAUA,31,30,24,17,102
2692,12,AL939124.1/163164-163269,AUAUUCCGACAGGGGAGCGCCACAGCGCUGAGAGUGCGGCACCGGCCGCAGACCCUCCGAACCUGGCCCAGGUCAUUCUGGGUAGGGAGAUCGGUCACCACUCGAG,22,15,35,34,106
2693,12,M16495.1/2120-2233,GCCAUCUUGUCGGAGUGCCAACCGUCGAACGACGCGAGGCUGAGACCGUUAAUUCGGGAUCCGUGGAACCUGAUCAGGCUAGCACCUGCGAAGGGAAACAAGGGUAACUUGCGG,28,20,37,29,114
2694,12,AL939111.1/162719-162830,CAAGGCACUCGCGGGAGCCCGGACGCACCGGGCUGAGAGGGAGGCUGGCGGCCUCCGACCGUACGAACCUGAUCCGGGUCAUGCCGGCGAAGGGAGGGGCUGGACGCCCAUG,20,11,46,35,112
2695,12,BX569689.1/134905-135013,AAACACCACUAGGGGUGCCUCGAUCGGUUUUCUGGUCGACGGGGCUGAGAUCACACCCUCUGAACCUGACCCGGGUCAUGCCGGCGAAGGGAAGUGACCAGCGUGAUCG,23,20,35,31,109
2696,12,AY316746.1/2276-2378,CUCCAUUCCGAGGGGAGCGCCGGGCGGCGCUGAGACGGCGGUGAGCCGGACCCUUGAACCUGAUCCGGGUCAUGCCGGCGUAGGAACGGAACGAGGCUGCCCU,17,14,40,32,103
2697,12,BX248354.1/27456-27566,AGUGUCCCCCGCGGGCGCCCGAGCACGGGCUGAGAUUGCGCUGAUGCUGUGCAAGCACCGUUUGAACCUGUCUGGUUAACACCAGCGAAGGAAGAGAGGAGCGCGAGCCUA,24,18,38,31,111
2698,12,AB087258.1/15478-15568,CCGACUUAGUCGGGGUGCUGAUAACAGCUGAGAUAAUACCCGUGAACCUGAUACAGUUAAUACUGACGUAGGAAACUAAUGGUCUUACUCC,27,23,21,20,91
2699,12,AF159589.1/4059-4150,ACCUUCACAAAGGGGAGCCAUUGGCUGAGAACGGGGAAACCCGGACCCUUCGAACCUGUUCGUUAAUGCGAGCGUAGGGAUUUGUGAAUGGU,23,20,29,20,92
2700,12,U64312.1/2271-2374,UAGUUCCACUAGGGGUGUCAGUUUGUCUGACUGAGAGAGGGAAGCCUCAACUCUUAAAACCUGAUCUAGCUUGUACUAGCGUAGGGAAGUGGUGGCACAUUCUA,26,29,29,20,104
2701,12,AL672115.1/15647-15763,CGCAUUCACCAGGGGAGUCCCGGCAAGGGGCUGAGAUACUGCUGGCUUUCGCGGCGCAGUGACCCGUUGAACCUGAUCCAGUUCAUACUGGCGUAGGGACGGUGCAAGCGCUUUGCG,21,24,40,32,117
2702,12,AF109218.1/4405-4502,UAAAAUUGCUAGGGGCGCCUUUUGGCUGAGAUAGUUUGACUAGACCCUUAUAACCUGAUUUGGUUCGUACCAACGUAGGAAAGUAGUAUAUUCAGAAU,28,31,23,16,98
2703,12,AF264021.1/2226-2360,AAGUUGCACCAGGGGUGCCUGUAUUCUCAACAAUCUGAAGGGCCCUUGGCCUGGAUUGUUGUGAUAUGGGCUGAGAAAGUCCCUUUGAACCUGAACAGGAUAAUGCCUGCGUAGGGAGUGUGCAUUUCUAUUUUG,30,40,39,26,135
2704,12,AL596168.1/251336-251226,CGUUACCACAGGGGGGGCUUCUUAGCUGAGAUUGAAUCCGCGUGUUUUUGGAUUCUGACCCUUUGAACCUGUUCGUUAAUACGAGCGUAGGGAUUGUGGCGAUUGCAUUUC,20,37,32,22,111
2705,12,AF217503.1/595-688,ACAUGGCAUCGAUGGACUGGGUUCGUUCUGAGAUUAUACGGCUAAAACUUGAUCUGGAUAAUACCAGCGAAAAGGGUCAUGCCUUCUCUCGUUC,24,27,23,20,94
2706,12,AK120238.1/2075-2184,CUAUGUUAGGAGGUGGCCUCUUGGCCUGGAUUGUUGUGAAUUGGGCUGAGAAAGUCCCUUUGAACCUGAACAGGAUAAUGCCUGCGAAGGGAGUGUGCAUUUCUACUUUU,23,35,33,19,110
2707,12,AF004408.1/427-558,ACCAUUCACCAGGGGUGCCCCGGCAAGGGGCUGAGAUUCUGCUGAACAAUACGGCUUUGCCUGUUGUGGCGCGGUGACCCGUUGAACCUGAUCCAGUUCAUACUGGCGUAGGGACGGUGCGGACCUGCGGCU,23,29,44,36,132
2708,12,BX571860.1/177712-177587,ACUUUCUUGUCGGAGUGCCUAGCGUAAGCUGUUUUAUCGCAGCAUACACAGGCUGAGACCGUUAAUUCGGGAUCCGCGGAACCUGAUCGGGUUAAUACCCGCGAAGGGAACAAGAGUAAUCAACCG,33,29,34,30,126
2709,12,AY102616.1/4667-4777,GGCAGUCCCCACGGGCGCCCGAGCACGGGCUGAGAUCGCGCUGAUUSUGCGCGAGCACCGUUUGAACCUGUCCGGUUAGCACCGGCGAAGGAAGAGAGGAAUGGUGCAAUG,23,17,40,30,111
2710,12,U81371.1/247-152,AAAAAACUAUUAGGGUGCCCGUAGUAUGGGUUUAGAAAAAACCUUUUGGACUUGAUAUGGAUCAUACCAGCUUAGGAAAGUAGUGUAAUUUUUUCC,31,31,21,13,96
2711,12,BX248356.1/234808-234920,ACGAGAUGCCCGGGUGCCAUGUGCUUGCUGUACGUGGCUGAGACGGCUGUUUGGCCGAACCGUAGAACCUGAUCUGGGUAAUACCAGCGAUAGGAAGACUUCAUACUGUGACU,25,27,35,26,113
2712,12,BX248356.1/232868-232999,UUUAUAAAUCACGGGUGCUGGACGGCAUACGUUUGCCACAAAGCUGAGACAGGGCGAGAAGACGUGCACGUCCCUGAACCGUUGAACCUGAUCCGGGUAAUACCGGCGAUAGGAAGAAUAAUGAACCGAUCG,39,25,38,30,132
2713,12,AC005496.3/78625-78498,CAAAAGCACCAGGGGUGCUUGAACCAGGAUAGCCUGCGAAAAGGCGGGCUAUCCGGGACCAGGCUGAGAAAGUCCCUUUGAACCUGAACAGGGUAAUGCCUGCGCAGGGAGUGUGCAGUUUUUUUUUU,32,28,40,28,128
2714,12,AK119882.1/1-98,UUGAAUGACUCGGGGUGCCCCUUUUCACAAAGGGCUGAGAAAUACCCGUACCACCUGAUCUGGAUAAUGCCAGCGUAGGGAAGUCAGAUGCCUGCCCG,24,21,27,26,98
2715,12,AL445064.1/126097-125991,CUGGUGUGGUGGGGGAGCUCCAUAAGGGGCUGAGAGGAUCCGGAUGGAUCGAUCCCUGGAACCUGAUCCGGGUAAUACCGGCGGAGGGAAAUUAUGGAAAAAAAUAG,29,20,40,18,107
2716,12,CP000557.1/594796-594903,GACAUCCACUAGGGGGGCCUUUAGAAAGGCUGAGAUCAAAGUGUGCCUUUGAGACCCUUAGCACCUGAUCUGGGUAAUACCAGCGUAGGGAAGUGGAGAGGAGCUACA,30,22,34,22,108
2717,12,CP000141.1/198028-198135,AACGGCCACUGGGGGUGCCGGUCAAAACCGGCUGAGAGGGAGAGUUCUCCCAACCCUUUGAACCUGAUCCGGGUAAUACCGGCGUAGGGAAAGUGGGGUAACUGGAAG,27,18,38,25,108
2718,12,AP006627.1/829775-829676,AAGAACCACUAGGGGAGCCAUCUGGCUGAGAAAAGCGCUGCUUUGACCCUUUGAACCUGAUCUGGCUUGUACCAGCGUAGGGAAGUGGAGAACAAUUGCU,27,22,29,22,100
2719,12,BA000043.1/643262-643369,AUCAUCCACUAGGGGGGCCUUUAGAAAGGCUGAGAUCAAAGUGUGCCUUUGAGACCCUUAGCACCUGAUCUGGGUAAUGCCAGCGUAGGGAAGUGGAGGAGCAGCACA,29,22,34,23,108
2720,12,AACY022101973.1/389-487,UAUAAGUCCAAGGGGUGCCAAUUGGCUGAGAUGGUUUUAACCAAUCCCUUUGAACCUGAUCCGGUUAAUACCGGCGUAGGAAUGGAUUUUCUCUACAGC,25,29,24,21,99
2721,12,AARF01000324.1/6363-6261,UUUUUUCACUAGGGGCGCCCGUACGGGCUGAGACAGAAUGGUUUCUGGACCCUUUGAACCUGAUCUGGAUUAUACCAGCGUAGGAAAGUGGGAAUGCAUGAAU,25,28,30,20,103
2722,12,AAMD01000032.1/31845-31737,CGUUGUCGCUAGGGGUGCCCCCGUCAGGGGCUGAGAUGGCCGUGGACCGGCCAGACCCUUUGAACCUGAACCGGGUCAUACCGGCGGAGGGAAGCGGCGGGCGCUCCAA,18,16,42,33,109
2723,12,CP000510.1/2895423-2895324,CAAAUAUAGUCGGGGGGCCUGAAGGCUGAGAUCGCAUAGUGCGAAACCCGUUGAACCUGAUUCAGUUAAUACUGGCGUAGGGAACUAUAAGUCUUGUUUU,27,27,28,18,100
2724,12,AAEK01000033.1/47712-47817,UUUAUCCACUAGGGGGGCCUAUUAUAGGCUGAGAUCAAAUGGGAAUUUGAGACUCUUAGUACCUGAUCUGGUUAAUGCCAGCGUAGGGAAGUGGAAAAGACAUUGC,30,29,30,17,106
2725,12,CP000076.1/627657-627761,CGGUUCUUGUCGGGGUGCCUUGCUAUGAGGCUGAGAUCGGAUAAUCCGGAUCCCGUUGAACCUGAUCAGGUUAGCGCCUGCGUAGGGAACAAGAUUUCUCGUCAC,20,28,32,25,105
2726,12,ABCF01000004.1/41916-42024,CAAAACCACUGGGGGAGCCUUUUAAAGGCUGAGAUUAAAGUGUACUACUUUAAGACCCUUUGAACCUGAUCUAGUUCAUACUAGCGGAGGGAAGUGUAGUCUGAAUGAU,33,30,27,19,109
2727,12,CP000489.1/34903-34800,CUCAUACACUUGGGGAGCCUCGCACGAGGCUGAGAGGUGCCGGGCACCGACCCAUCGAACCUGAUCCGGGUCAUGCCGGCGUAGGGAAGGGUAGAGUGAAGCGG,22,15,39,28,104
2728,12,AE015929.1/2101479-2101588,UUUAACCACUGGAAGUGCCUUUGUUUAAGGCUGAGAGUAAAGAACUGACUUUAUAAUUCCUGGAACCUGAUCCAGUUCAUACUGGCGUAGGGAAGUGGCGACGCUCAAUU,30,32,27,21,110
2729,12,CP000568.1/733772-733877,UCAUCACGCUAGGGGUGCCAUUGUGGCUGAGAAAGAGACUUAAGUCUCUUAACCCUUUGAACCUGAUGCGGUUAGUACCGCCGGAGGGAAGCGGAAAAUAUUGUUU,27,28,30,21,106
2730,12,CP000771.1/338574-338685,UAAUGCCUGGAGGGGAGCUCCAAAAUGCGGGGCUGAGAGGAAGGAGUCAAUCCUUCGACCCUUCGAACCUGAUCCGGGUAAUACCGGCGGAGGGACCAGGUGACUCAAAAAU,31,19,36,26,112
2731,12,AE017180.1/640928-640827,AUAGUCUGCUGGGGGAGUUCUUGGGAACUGAGACGGGCAACGCCCGAACCCUUUGAACCUGAUCCGGUUUAUACCGGCGUAGGGAAGCGGCCAGAAACAAUC,25,20,32,25,102
2732,12,CP000764.1/2008349-2008244,UCUAUCCACUAGGGGUGCCGAUAUUGGCUGAGAUUAAAGUUUAUCUUUGAGACCCUUAGUACCUGAUCUGGUUCGUACCAGCGUAGGGAAGUGGAAAUGACAAAAU,29,31,27,19,106
2733,12,AP006716.1/943397-943499,UAAUGCUACUAGGGGAGCCAUAGUAAAUGGCUGAGAUGAUUAAUUCAGACCCUUAUAACCUGAUUUGGUUAGUACCAACGUAGGAAAGUAGUUAUGUAAAUGU,34,31,24,14,103
2734,12,AALZ01000004.1/372786-372686,AUCUAUCCGUCGGGGUGCCCUAGGGGGCUGAGAGGUGCGUGCACCGACCCGUCGAACCUGAUCCGGGCAAUACCGGCGUAGGGAACGGGUAUCUUUGUGCA,18,20,36,27,101
2735,12,CP000002.3/1271349-1271457,GUUUUCCACUAGGGGAGUCCUUGAUAAGGGCUGAGAUAAAAGUUUGACUUUUAGACCCUCAUAACCUGAACAGGUUCAAACCUGCGUAGGGAAGUGGCACGGUAUUUGA,30,30,29,20,109
2736,12,CP000058.1/628566-628670,GCGUUCUUGUCGGGGUGCCUUGCUGUGAGGCUGAGAUCGGUUAAACCGGAUCCCGUUGAACCUGAUCAGGUUAGCGCCUGCGUAGGGAACAAGAUUUCUCGUCUC,18,29,33,25,105
2737,12,CP000716.1/1578877-1578987,AGAAAACCCGAGGGGAGCUCCAUAAGCCGGGGCUGAGAGGAAGGCGGAAGUCUUCGACCCUUAGAACCUGAACCGGGUAAUACCGGCGGAGGGACGGGUAGAGAAAAUUUC,33,15,39,24,111
2738,12,AALV01000001.1/1015631-1015532,UAAGAUACCUCGGGGGGCCUGACAGGCUGAGAUGUGCGCGCACGGACCCGUUGAACCUGAACCGGUUAACACCGGCGGAGGGAAGGUCUGGAUACACCUC,23,16,34,27,100
2739,12,AP008934.1/816596-816694,AAACGCUACUAGGGGAGCCAGUUGGCUGAGAUGAUUAAAUUCAGACCCUUACAACCUGAUUUGGUUAAUACCAACGUAGGAAAGUAGUUUAAUCUAAAG,34,26,22,17,99
2740,12,CT573326.1/5282526-5282420,AUGUUCUUGUCGGGGUGCCUUGAAGCAAAGGCUGAGAUCGCAAAGUUGCGGAUCCCGUUGAACCUGAUCAGGUUAGCGCCUGCGUAGGGAACAAGAUUGCUCUCAUU,24,28,32,23,107
2741,12,AE017221.1/302202-302311,GGGGCAGGCUAGGGGUGCCCGAAUGGAAGGGCUGAGAGCUGGGUUUCUCCCAGCAACCCUUGGAACCUGAUCCGGGUAAUGCCGGCGGAGGGAAGCCUAUGCGGAAGACC,23,17,43,27,110
2742,12,AE004439.1/1459568-1459465,GCACUUUAGUCGGGGUGCUUUGUAACCAAAUUGUACAAAGCUGAGAUGAUACCCGUGAACCUGAUACAGCUAACACUGACGUAGGAAACUAAUUAUGCCAAUAA,35,26,22,21,104
2743,12,AE008691.1/1681524-1681422,CUCAAGUGCUAGGGGAGCCAGAAAUGGCUGAGAGGGGAUUCGUUCCCGACCCUUAGAACCUGACCAGGGUAAUGCCUGCGAAGGGAAGCACGUUUUAUUGAGU,26,22,33,22,103
2744,12,AE008691.1/2399659-2399556,UAUGUCCGCUGGGGGAGCCUGAAAAGGCUGAGACGGCAGAAAUGCCGAACCCUUGGAACCUGAUGAGGGUAAUGCCUCCGUAGGGAAUGCGGGCUCAAAAGGCA,28,17,36,23,104
2745,12,CP000114.1/913402-913491,AUAGGACAUUUGGGGUGCGUAACAGCUGAGAUUAUACCCAUUGAACUUGAUGCAGUUAGUACUGUCGAAGGGAAAUGUGUGCCAUUACAA,27,25,24,14,90
2746,12,AE007869.2/2541937-2541826,GCCAUUCACCAGGGGUGUCCCGUCAAGGGGCUGAGAUUCUGCUUUCAUGCGCAGUGACCCGUUGAACCUGAUCCAGUUCAUACUGGCGUAGGGACGGUGCAAAGACCUGAUG,23,26,34,29,112
2747,12,BX548175.1/178356-178459,GCAAAACACUAGGGGUGCCAUUCAGCAAUCGCUGAGUGGCUGAGAUCACACCCUCCGAACCUGAUACGGGUUGUGCCGGCGCAGGGAAGUGAAAUGACGUGAUC,27,19,32,26,104
2748,12,AE004439.1/444121-444213,GACUCUUAGUCGGGGUGCUAUUGCGUUAGCUGAGAUGAUACCCGUGAACCUGAUGCAGUUAAUACUGACGUAGGAAACUAGCAGUCAAUAUUG,25,26,25,17,93
2749,12,AM039952.1/4100743-4100646,CCGCCGAAGUGGGGGUACCGCAGCGUGCUGCGGUUGAGAUAGUCCCUUCGAACCUGAUCCGGCUGAUACCGGCGUAGGGAAGCUUCGUCAGAUGCGAU,18,20,34,26,98
2750,12,AL009126.3/1607367-1607468,GAUUCAUCCUAGGGGUGCUUUGCGAAGCUGAGAGAGACUUUGUCUCAACCCUUUUGACCUGAUCUGGAUCAUGCCAGCGGAGGGAAGCGGUGAAAAGCGGAG,24,24,33,21,102
2751,12,AL009126.3/1242262-1242370,UUUAACCACUAGGGGUGUCCUUCAUAAGGGCUGAGAUAAAAGUGUGACUUUUAGACCCUCAUAACUUGAACAGGUUCAGACCUGCGUAGGGAAGUGGAGCGGUAUUUGU,29,31,30,19,109
2752,12,CP000050.1/1019813-1019911,CCGCCGAAGUGGGGGUACCACAGCACUGCUGCGGUUGAGAUAGUCCCUUCGAACCUGAUCCGGCUCAUACCGGCGUAGGGAAGCUUCGUUAGAUGCGCU,19,21,31,28,99
2753,12,CP000830.1/937748-937645,CAACAACCGUUGGGGUGCCCGAUUCAGGGCUGAGAGGCGCACUGUGCCGACCCAUGGAACCUGAUCCGGGCAAUACCGGCGUAGGGAACGGUCAUCGUGGCAAU,23,17,35,29,104
2754,12,CP000919.1/639572-639660,UAAAGACAUUUGGGGUGCUUUAGGCUGAGAUGAUACCCAUUGAACCUGAUACAGUUAAGACUGGCGAAGGGAAAUGUGAAAUGUUUUUU,27,27,24,11,89
2755,12,CP000918.1/2145369-2145290,UACAGUCUGAGAGGAAGUGUUAAACUUCGACCGCACCUGAUCUGGGUAAUGCCAGCGGAGGGAACGAUACUUAGUCUAAU,23,19,22,16,80
2756,12,AE007870.2/312774-312876,AGCUCUUCCGAGGGGAGCACCAGACGGUGCUGAGAUGGUGGUGAACCGGACCCUUGAACCUGAUCCGGGUCAUGCCGGCGUAGGAACGGAACUGUCGUGCGCU,20,19,37,27,103
2757,12,AL009126.3/3179105-3179206,GAUGACCACAAGGGGAGCAUUAAAGCUGAGAGUGAGCGGUUUCGUUCUGACCCUUUGAACCUGUUAGUUAACGCUGGCGUAGGGAUGUGGCAAAGUCAAAUG,27,25,32,18,102
2758,12,AL766847.1/75304-75206,AAAUACACAAGGGAGUGCCUUGAGCUGAGAUUGCAGAUAUGCAAAAUCCUCUAACCUGAUCUCGUUAGGACGAGCGUAGGAAUUGUGGUUUGAAUUGGU,29,27,27,16,99
2759,12,CP000936.1/749906-749994,UAGAGACAUUUGGGGUGCUUUAAGCUGAGAUGAUACCCAUUGAACCUGAUACAGUUAAGACUGGCGAAGGGAAAUGUGAAACGUUUUUU,27,26,24,12,89
2760,12,AE008691.1/2140374-2140272,UCAAAGUGCUAGGGGAGCCAGAAAUGGCUGAGAGGGGAUUCGUUCCCGACCCUUAGAACCUGACCAGGGUAAUGCCUGCGAAGGGAAGCACGUUUUACGGAAU,28,20,33,22,103
2761,12,AE014074.1/464992-464896,UAUUUCACAAAGGAGUGCUUUGGCUGAGAUCGCAAUUGCGAAAUCCUGAGGACCUGAUCUUGUUAGUACAAGCGUAGGGAUUGUGACCAAUAAUCAA,29,27,24,17,97
2762,12,CP000425.1/327513-327414,UAUUUGCACAAUGGGUCUAUUGACAAGUCUGUCAGUAGCGAGAAAUACCAUCUGACCUGAUCUGGGUAAUGCCAGCGUAGGAAUGUGUUAAGACAAUCGU,29,28,25,18,100
2763,12,AE007317.1/646024-645926,AACAACCACUAGGGGUGCGUAAAGCUGAGAUUAACGACUGUUAGAUCCCUCUGACUCAAUCUAGGUAAUGCUAGCUGAUGGAAGUGGAAAUGAUAAUGG,32,24,26,17,99
2764,12,CP001488.1/228163-228057,CAAAAUUCGUUGGGGUGCCUUGAAAGAGGCUGAGAGACGCAUUCUCACGUCAACCCAUUGAACCUGAUCCGGGUAAUACCUGCGUAGGGAACGGAGUUUGGCGCGUC,26,24,32,25,107
2765,12,AE008691.1/1524796-1524694,CUCAAGUGCUAGGGGAGCCAAAAAUGGCUGAGAGGGGAUUCGUUCCCGACCCUUAGAACCUGACCAGGGUAAUGCCUGCGAAGGGAAGCACGUUUUACGAAAU,29,20,31,23,103
2766,12,BX548174.1/1543261-1543163,AAAUAUAACUAGGGGUGCUAAGUCAAUUACUUAGCUGAGAUCAUACCCUUCGAACCUGAAACAGUUAAAACUGACGCAGGAAAGUUUCAAUUUGAUCGA,36,26,19,18,99
2767,12,AL591688.1/3532865-3532978,GCUGCUCUAACGGGGUGCCCUGGCCGGCUUUGCGACCAUGGCUGAGAGGCUUCGAGCCAACCCGCGGAACCUGAUCCGGCUCAUACCGGCGGAGGGAUUAGAAGCGAUCGGACC,21,19,39,35,114
2768,12,AL935263.2/202700-202607,UCAUAGCAACUGGGGUGCCAUCACGGCUGAGAUAAUACCCAUUGAACCUGAAUCUGGACAAUGCCAGCGCAGGGAGCAAUGCUUUUAUUUGGGG,25,22,26,21,94
2769,12,AL935263.2/99249-99354,UUUAAACACUAGGGGUGUCCAAAAAUGGGCUGAGAUGGUGCUGUAAGUACCGAUCCCUUUGAACCUGUAAGCUCAAACUUGCGUAGGAAAGUGUCACAGCUAAUGU,31,28,27,20,106
2770,12,CP003056.1/3348160-3348049,UCAAACUACUAGGGGUGCCCGGAUUUGGCGGGCUGAGAGAAAAACCGGCGUUUUUCAACCCUUUGGACCUGAUCCGGAUCAUACCGGCGUAGGAAAGUAGGAAUUUGUAAAA,31,26,32,23,112
2771,13,AL939120.1/174742-174619,CCAGGUAAGUCGCCGCACCGGUCACCACCGGAGCGGCUCGGGGUGAAGCCGUACCCGUCAGGGCACGGCCGGGCACCUCCCCGCCCGAACCCGACAGCUCACCUCGCAGGCGUAAGGAGAGGGA,24,11,42,47,124
2772,13,AL939118.1/280215-280371,CGUGCGCACGCGCCGAAUCCCGCAAGGGAACCGGGGAACCACCACAUUGGGGUGAAUCGGGCGUAUGCCGCCGUGGGAACACGGUCGGCAGGCACCCGUAGGAGACCUUCCUGCUCCGAACCCGUCAGCUAACCCGGUAGGCGAAAGGAAGGAAAGG,37,18,54,48,157
2773,13,AL939121.1/140405-140238,AGUCCGGCCUGCCCGCACGGCACCGGAGCCGGGGACCCAACCGAGAACUUUGGGGUGAAUCGGCCUCACCGCCCUCGACGCGAGGACGGUCCGCCGUAGGGCAAACCUUCCGCGCCACACCGCCCGAACCCGACAGCUAACCCGGUAGGCGGAGCACUGGAAGGAGUC,34,17,54,63,168
2774,13,AL939115.1/44787-44621,UCGCGUCAAGCGCCGAAGGCAGGAGCGGGGGACCCAAGGUAAGUGCCGCACCGGGCAGUUGAGCCGGAGCGGCUAGGGGUGGAGCCGAGUUCCGCGAGGAACCCGGCCGGGCAACUCAACCGGCCCGAACCCGACAGCUCACCUCGCAGGCGUCGGUGAGGGGAUCA,34,16,65,52,167
2775,13,AF299117.1/4182-4326,UGUAGUCAAGGCUGAAUUUCCCAAAAAGGAAAACGGGGGAACCAUAAUGGGGGUGAAUCACUUUUUAGGAGUUAAACUUCUUGAAGUGACGGAAAGGUAUCAUUCCGAACCCGGCAGCUAACCUCGUAAGCGUGUGAACCGUUUU,44,36,38,27,145
2776,13,BX927150.1/172169-172001,CAUUCAUGUGGGCCAUAUUGCAGACAGGGACGGGGAAACCACCCACCAUCUUUUCACAAAAGAAGGCAUGGAGGCCAACUCCUUGGGGUGAAGCCAGACAUCCACUGGCAGAGCAACUCCUCCGCUCUAACCCGACAGCUAACCUCGACGGCGACAAAUGAGAGGAAAA,52,26,42,49,169
2777,13,AL939125.1/103160-103305,AGUCCCCGUACGGCGCGAGCCAGGGGAGCCGGGGACCCAUCGCAGUCCCUGGGGUGAAUCGGACGCCCGCGCGCACCGCGAGGGGGUCCGUAGGAGACCUUCCACCUCCGAACCCGUCAGCUAACCCGGUAGGCGAGAGGGAAGGA,28,15,54,49,146
2778,13,AAES01000021.1/15273-15418,AACCUAAAAUCGCUGAGUUCCAGAAAUGGAGCGGGGGAACCAAUUUUGUGCAUCGUCACUUGGGGUGAAUCUUUCAGUUUUGAAAGUAGGGCUACUCUUUAGGCCCGAAUCCGACAGCUAACCUCGUAAGCGUUUAGAGAGGAGGU,39,38,40,29,146
2779,13,BA000043.1/224415-224554,GAAUAUUUAGCGCUGAAUCCGUCAUGGAGCGGGGGACCCACUUGUUGCAACGCUCGUUGCUAGGGGUGAAUCCGAAAGGACGGGCAUCUCUCCAAGCCCGAACCCGACAGCUAACCUCGCAAGCGCUUUGGGGAGGGACG,32,26,44,38,140
2780,13,AE017225.1/3137586-3137727,UAAAACCUUUUGCUGAGUCCAAAUUUUGGAGCGGGGGAACCACUUUUGUAGCUAUGCUACUUGGGGCGAAUCUUUUUUAAGUAGGGAACUCUCACUUCCCGAGUCCGACAGCUAACCUCGUAAGCGUAAUGGGAGAGGAAGG,36,39,38,29,142
2781,13,AAEK01000002.1/18140-18287,UUUUGUAAUACGCUGAGUCCAAUUAUAUGGAGCGGGGGAACCAAUUUGUGCAUUGUCACUUGGGGUGAAUCUUUCAAUUUUGAAAGUAGGGCUACUCUCAAAGUCCGAAUCCGACAGCUAACUUCGUAAGCGUCUUGAGAGAGGACGG,39,43,39,27,148
2782,13,CP000764.1/713115-713260,AACCUUAUAUCGCUGAGUCCAAUGAUUUGGAGCGGGGGAACCAAUUUUGUGCAUUGUCACUUGGGGUGAAUCUUUCAUGAUGAAAGUAGGGCUACUCUUUAGGCCCGAAUCCGACAGCUAACUUCGUAAGCGUUUGGAGAGGAGGU,36,42,41,27,146
2783,13,CP000478.1/2207806-2207671,CCGGAGUAAUCGCCGAGUCCUGCAUGGGCAGGAGCGGGGGAACCGAGUUUUUGGGGCGUAUCGCCGAUCAUGGCGAAGGGCAAGCUCUUCGGCCCGAGCCCGUCAGCUAACCUCGCAGGCGUCGAAGGGUAGAGCC,26,22,50,38,136
2784,13,AAOX01000019.1/14342-14479,UCGAAAGAUGCGCUUAAUCUUUUAAAGAGCGGGGGAUCCAACCGGCAUACACAUGCCUCGGGGUGAAUCCUUUACAGGUAGGGCACUCUCAAAGCCCGAAUCCGACAGCUAACCUCGUAAGCGUUAUUGAGAGGACAA,40,29,35,34,138
2785,13,AE017333.1/525158-525301,AAUCCAAAAUCGCUUAAUCUAAAAAAGAGCGGGGGAACCAUUUAGAGGCGUACAGCCUCCGGGGUGAAUCCUUUUAAAGGUAGGGCAAACUCUCGUGAGCCCGAAUCCGUCAGCUAACCUCGUAAGCGUUAAGAGAGAGGGAGA,46,28,39,31,144
2786,13,CP000726.1/1414382-1414259,AAACAAAUCAUGCCGAAUCUUCUUUAUGAAGUACCGGGGAUACUCUUGGGGUGAAUCUCUUAGGAAUAGGGUACCUCUAACCCGAACCCGUCAACUAACCUGGGAGGCAAUAUGGAGGGAUUUA,37,31,30,26,124
2787,13,AAFX01048773.1/685-551,ACAACUAAAACGCUCAAUUCCCGAGAAGGGGAGCGGGGGACCCAAUCCGUUGGGGCGAAUGGUCCGCUUGGACCUAGGGCAAGCUCUUCAUGCCCGAGCCCGACAGCUAACCCCGUAAGCGUGGCGAGAAGAGCU,34,20,42,39,135
2788,13,CP000764.1/2226760-2226900,UAAAACCUUUUGCUGAAUCCACUAUGUGGAGCGGGGGACCCAUUUUUGUAGCAUUUGCUACUUGGGGCGAAUCUUUUUAAGUAGGGAAACUCUCACUUCCCGAGUCCGACAGCUAACCUCGUAAGCGUAAUGGGAGAGGGA,35,39,37,30,141
2789,13,AAEK01000002.1/19276-19421,AACCUAAAAUCGCUGAGUUCUAGAAAUGGAGCGGGGGAACCAAUUUUGUGCAUUGUCACUUGGGGUGAAUCUUUCAUUUUUGAAAGUAGGGCUACUCUUUAGGCCCGAAUCCGACAGCUAACCUCGUAAGCGUUUAGAGAGGAGGU,39,41,39,27,146
2790,13,AAXV01000026.1/33590-33441,AUUUCUAAAUCGCUGAAGCAAACUAGACGCGGGGGACCCAUUUUAGACGGAGUGCAUAAGCAAUCCUUGGGGUGAAUCUCUUCUUUUGAAGGGUAGGGCUACUCAGGCCCGAAUCCGACAGCUAACCUCGUAAGCGUUAAGAGCAGAUAA,43,35,39,33,150
2791,13,AP008230.1/891859-892004,UGCAGUCAAGGCUGAAUUUCCCAAAAAGGAAAACGGGGGAACCAUAUUGGGGGUGAAUCAUUGUUAAGGAGAGCAAACUCCUUAAAAUGACGGAAAGGUAUCAUUCCGAACCCGGCAGCUAACCUCGUAAGCGUGUGAACCGUUUU,47,32,38,29,146
2792,13,CP000252.1/1919119-1919252,UAAUGCAUGGCGCUUAAUCCUCGAUUCAAGAGGAGCGGGGGACCCGUUCUCCUGGGGCGUAUCGCCAUUUGGCGUAGGGCACCUCUUCGGCCCGAGCCCGUCAGCUAACCUCGCAGGCAUCGAUGAGGGGACUC,24,28,42,40,134
2793,13,CP000612.1/2967251-2967121,UAUUAAAAAACGCCUAAUUUCUAUUGAAAGCGGGGGAACCAGUUAUUAUGGGGUGAACUACCAGUGUGUAGCGGGCUAACUUUCUGUCCGAACCCGUCAGCUAACUCCGUAGGCGUAGAAAGUGGGGAAAU,38,33,35,25,131
2794,13,BA000030.3/4374746-4374567,GUCGCGUAAGCGCCGCAGGCAGGAGCGGGGGACCCAAGGUAGGCGCCGGGCCCAGCACUUGAGGCUGGUCCGGCUAGGGGUGAAGUCGCGCGCCGGAAUCGGCAGAGGAAGGCGCGCGGCCGGGCAACUCAACCGGCCCGAACCCGACAGCUCACCUCGUAGGCGUCGGUGAGGGGAUCA,34,18,73,55,180
2795,13,AAWL01000001.1/57092-56953,AACAAAGCAAAGCCGAAUUCCGUAUGGAAGCGGAGGACCCACCUUUUUGGGGUGAAUUCUGCCACAAGCAGAAAGGAUGUUUACCUCUCUUGCCAUCCUAACCCGACAGCUAACUUCGUAGGCUAAAGCAAAGAGGUCGA,43,29,33,35,140
2796,13,CP000141.1/2221513-2221384,AUUAACCAAACGCUGAAUUCCCGUUACGGGAAGCGGGGGAACCACUUUUUGGGGUGAAUCCUUUUCAGGUAGGGCGACUCCUUCCGCCCGAACCCGUCAGCUAACCUCGUAAGCGUCGAAGGGGGAGCAA,31,27,37,35,130
2797,13,CP000382.1/667370-667242,AUCUGAACAAUGCCGAAUCUCCAUUUGGAGUACGGGGGAUAUAUUUUGGGGUGAAACUUAUUUUUAUAUAAGUAGGGUUCCUCAAUCCUAACCCGUCAACUAACCUCGGAGGCAAAACGAGGAGGAAAU,40,35,30,24,129
2798,13,CP000568.1/1397353-1397223,AGAUUUUAAGCGCUUAAUCAGUUUUGAGCGGGGGAACCAUUUUUUGGGGUGAAUCUUGGUUUUUGCCAGGUAGGGUUAACUCUUUCGACCCGAACCCGUCAGCUAACCUCGUAGGCGUUGAUAGAGGAGUA,29,41,37,24,131
2799,13,CP000612.1/87012-87130,AUGGGAACAAUGCCGAAUCCCAAAGGGUACGGAGGAACCGUUUAUGGGGUGAAUCCUUUUGGUAGGGAUAUCCUUGCCCGAACCCGUCAGCUAACUCCGGAGGCAAAAGGAAAGGAGAA,36,22,36,25,119
2800,13,CP000448.1/1297836-1297702,AUUAGAUUCAUGCCGAAUCCAGUUAAAUAACUGGAACGGGGGAACCAAUUUUGGGGUGAAUCCGGCUUUUGCUGGUAGGGCAAUCCCCUUGCCCGAAUCCGUCAGCUAACCUCGCAGGCUUUUGGGGGAGGGUAU,31,35,39,30,135
2801,13,CP000721.1/1710119-1709985,AUAUAUGUAACGCUUAAUCACUUUGAACGGGAGAACCAUUUUUUGGGGUGAAUCUUAUUACACGAUAAUAAGUAGGGUUAAUUUUCUUCAAUCCGAAUCCGUCAGCUAAUCUCGUAAGCGUAGAAGAGAAGUUUU,42,45,27,21,135
2802,13,CP000764.1/711905-712051,GUUUUUGUAACGCUGAGUCCAAUGAUUUGGAGCGGAGGAACCAAAUGGUGCAUGGUCACUAGGGGUGAAUCUUUCAUGAUGAAAGUAGGGCUACUCUCAAAGUCCGAAUCCGACAGCUAACUUCGUAAGCGUUUUGAGAGAGGGUGG,39,39,44,25,147
2803,13,AAOX01000003.1/202929-203071,AGCACUGAAACGCUGAAUCUUAUUGAGCGGGGGAACCAACUUUUGACUGCAUGCUGCAGUCUUGGGGUGAAGCCAUGAAUGGCAGGGAGACUCUUACCUUCCUAAUCCGACAGCUAACUCCGUAAGCGUUGUUUAAGAGAGUG,37,36,39,31,143
2804,13,CP000721.1/3440152-3440282,AUAAUUAUAACGCUGAAUCUUUUUGAACGGGAGAACCAUUUUUUGGGGUGAAUCUUAUUUUAGGAUAAGUAGGGUUAUUUUCUUCAAUCCGAAUCCGUCAGCUAAUCUCGUAAGCGUUGAAGAGAAGUUUU,37,48,28,18,131
2805,13,BA000043.1/3286126-3285968,CCCUAAAGAUCGCUGAAUCCGAAUAGGAGCGGGGGAACCAACCGUGGCUUUGUGCGCCACAUGGGGUGAAUCCUGUUCAGGACGCCUGUUCUGAACGGGUAGGGUGACUCUCAUCACCCGAAUCCGUCAGCUAACCUCGUAAGCGUGUUGAGAGAAGGG,37,33,49,40,159
2806,13,CP000232.1/459162-459290,AAUAAGCGAGCGCUGAAUCCCUGAAUAGGGAACGGGGGAACCACUUCUUGGGGUGAAUCCUUUUUCAGGUAGGGUUAACUUUCGACCCGAACCCGGCAGCUAACUUCGUAAGCGUAGAAAGGUGAGGUG,34,29,39,27,129
2807,13,AAWL01000006.1/97044-96924,AGCUAUAUAAAGCCUAAUCCAGCUCAGGAGCGGGGGAACCAUUACUGGGGUGAAACUCUUUAGGAGUGGGGUGCCUUCAACCCUAACCCGUCAGCUAACCUCGUCGGCUUAGAGAGGAGAA,33,25,34,29,121
2808,13,CP000612.1/3033561-3033714,UAUUAAAACAGGCCGAAUCUCCGGAAAUUCCGGAGUACGGGGGACAAAAAUUAAUGGGGUGAAUCCGUAACUUUUUCGGAGGUGCAAAAAAGUACGGUAGGGUGCCCUCAACCCGAACCCGUCAGCUAACCUCGAAGGCCAGAGGAGGGUAAAA,50,28,43,33,154
2809,13,BA000030.3/5051634-5051477,CGUGCGCGUGUGCCGAAUCCUGCAAGGGAACCGGGGAACCAUCAACUUGGGGUGAAUCACGCGGAUGCCGCCGUGGCAACACGGCAGGUAUACGCGCGUAGGAGACCUUCCUGCUCCGAACCCGUCAGCUAACCCGGUAGGCCAGAAGGAAGGAAAGG,38,22,53,45,158
2810,13,CP000481.1/1069182-1069310,CGAUCGCCCGCGCCGAAUCCACCAGGAGCCGGGGACCCACCUUCCCCAGGGGUGAAUCCGCGUCCGCGGUAGGGCGACUCUUCCCGCCCGAACCCGUCAGCUAACCCGGUAGGCGCUGAGGAAGAACAG,25,15,40,49,129
2811,13,AAWL01000002.1/117860-117729,AUACUAAACGUGCCGAAGUUCCUUCAAAGGAACACGGAGGAACCAUUACUGGGGUGAAUCCGCACAUGCGGUAGGGAUUUCCCUUAUCCCGAACCCGUCAGCUAACUUCGUAGGCAGAGAAAGGGAGUGGUU,37,28,36,31,132
2812,13,CP000667.1/1922123-1922257,CGUGCCGACCCGCUCAAUCACCGAAAGGUGAACCGGGGACCCGUUCUAUCUGGGGUGAAUCCGCGAGUCUCGCGGUAGGGCGUACUUCCCGUCCGAAUCCGUCAGCUAACCCGGUCAGCGGUAUCGGAAGGAGUC,26,25,42,42,135
2813,13,CP000612.1/2353812-2353671,UGUAAAUAAUAGCUUAAUCCUGUAAAUAUAUGGGAACGGAGGACCCGACUUUUGGGGUGAGUCCGGUUUUUAACGCCGGUAGGGUUUUAACCUUUCGGCCCGAACCCGUCAGCUAACUUCGUAGGCUUUAAAGAAAGGGGAG,37,39,39,27,142
2814,13,AAJM01000133.1/9684-9540,AACCUUAAAUCGCUGAGUUCCAGAAAUGGAGCGGGGGAACCAAUUUUGUGCAUCGUCACUUGGGUGAAUCUUUCAGUUUUGAAAGUAGGGCUACUCUUUAGGCCCGAAUCCGACAGCUAACCUCGUAAGCGUUUAGAGAGGAGGU,38,39,39,29,145
2815,13,BA000004.3/632283-632434,CACCUUUAAUCGCUGAAUCUCUAUUGAGAGCGGGGGAACCAUACCUGACAGAGUUGUUUCUGUCUUGGGGUGAAUCUUAUGUUUUUUAUAAGAAGGGAUACUCUCCAUCCCUAAUCCGACAGCUAACCUCGUAAGCGUUGAUUCGAGAGAGG,38,46,36,32,152
2816,13,AE017194.1/3159877-3160019,UAAAACCUUUUGCUGAGUCCAAAAUUUGGAGCGGGGGAACCAUUUUUGUAGCUUUGCUACUUGGGGCGAAUCUUAUUUAAGUAGGGAAACUCUCACUUCCCGAGUCCGACAGCUAACCUCGUAAGCGUAAUGGGAGAGGAAGG,38,39,38,28,143
2817,13,BA000030.3/2949709-2949550,GGACAGUCAUCGCCGAGUCCCCGUAUGGCGCGAGCCAGGGGAGCCGGGGACCCAUCGCAGUCCCUGGGGUGAAUCGGGCACCCUCUCCUGAGGGAGCCCGUAGGAGACCUUCCUGCUCCGAACCCGUCAGCUAACCCGGUAGGCGAGAAGGAAGGAAAGG,33,21,56,50,160
2818,13,AP008230.1/1719300-1719165,UUAUAAUAAACGCCUAAUCUGGGGUAUCCUAGAGCGGGGGACUAAAUUUCUGGGGUGAAUCGCACCUCCUGUGCGUAGGGCUUACACUUUCGCCCGAAUCCGUCAACUAACCCCGUAGGCUAAGAAAGGUGUCUGA,34,34,35,33,136
2819,13,CP000481.1/2373007-2372860,ACGUCGGAGCCGCCGAACCUGCCUCGCAGGACCGGGGACCCAGCACCGGCGCACAGCGCCCAGGGGUGAAUCCGGUGUUCGCACCGGUAGGGCGAUCUUCCCCGCCCGAACCCGUCAGCUAACCCGGUAGGCGGUCAAGGGAGAGAGG,28,16,52,52,148
2820,13,AE001437.1/1374236-1374371,UCCUUAAGAGUGCCGAAUCUUAAUAAUAUUUAAGUACGGGGGAACACAUUGUGGGUGAAUCUUACGACUAUUCGUAAGUAGGGUGCCUUCAACCCGAAUCCGUAAGCUAACCUCGGAGGCAAAAUUGAUAAAGGAA,44,35,32,25,136
2821,13,AP008230.1/5140258-5140118,AAUUAAGUGAAGCUGAAUCUGAGGUACAAAGCCUCAGAACGGGGGAAACGUCACGUGGGGUGAAUCGCAGGAUAUUGCGUAGGGCAUACACCUUUUGCCCGAAUCCGUCAACUAACCUCGUAAGCAGGAAAGGUGGUCAAA,44,28,40,29,141
2822,13,AP006840.1/606473-606333,CGUCCACAAACGCUGAAUUCCCACCAGGAAACGGGGGACCCAGAAUCCACCAGGGGCCAAGCGCAGUGGCUUCACUGCCCGGGCGACACUCCUGCCGUCCGCGCCCGUCAGCUAACCCCGUAAGCGUCGCAGGGGGAGACC,31,16,41,53,141
2823,13,CP000679.1/237778-237930,CCUUUUGAAAAGCUGAAUUCCCAGGGGUAAAGCCCUGGGAUACGGGGGACCCAACCUUUUUGGGGUGAAUCAGAAGCAAAAAAGCUUCUGUAGGGCUAACCCUUUCGGCCCGAACCCGUCAGCUAACCUCGGAAGCUUUGAAAGGGAGGCAAA,43,31,42,37,153
2824,13,CP000232.1/1412184-1412326,UAUCCUGGAACGCUGAAUUGCGGUGUGCAGCCGUAAGCGGGGGACCCAAUUUCCCGGGGUGAAUCUUGCCGGUUAUACCGGUGGGUAGGGCUAGACGUGGCCCGAAUCCGUCAGCUAACUUCGUAAGCGUGAAGGGAAUACCG,30,31,48,34,143
2825,13,BA000028.3/1706087-1706245,CCUUUUUAGUCGCUGAAACUGUUGCUUUAGUAUUGUGCAGUGCGGGGGACCCAUUUUUGGCAAUAAAACAUUUGUCUUGGGGUGAAUCUAAAUAUUUAGAAGGGAUACUUUAUGUCCCUAAUCCGACAGCUAACCUCGUAAGCGUCAUAGGGAGAAAAG,43,50,38,28,159
2826,13,AE015927.1/2209149-2209011,AUACGUACUAUGCUGAAUCCUAUUUAAAAAAAUAGGUACGGAGGAACCAAGAAAUAGGGGUUAAUCUUUAAAUGUUUAAAGAAGGGAAAACCUUGACCUAACCCGUCAGCUAACUUCGGAAGCAAGAAAGGUGGAAAAA,57,31,30,21,139
2827,13,AAOX01000003.1/202757-202896,UGACCUGAUCCGCUGAAUCCAUACAGAACGGAGGACCCAACUGAUUAUUCCAGAAUAAUUAUGGGGUGAAGCCGAAAGGCCGGGGGACUUCUGCCUUCCGAACCCGUCAGCUAACUUCGUAAGCGUUGCAGGAGAGAGGA,39,28,39,34,140
2828,13,CP000728.1/3775383-3775509,UACUAUUAUUAGCCUAAGUUUUUUAAAACACGGGGAAACCAAAUUUUGGGGUGAAUCGUAAAAUUACGUAGGUUAUACCUUUUCCGAACCCGUCAGCUAACCCCGUAGGCAAAAGGAGUGAGAAAAU,43,35,26,23,127
2829,13,CP000673.1/279064-278931,CAAUAUCAUUAGCCUAAGUUUUAUAAAAAACACGGGGAAACCAGUACUAUUUUGGGGUGAAUCGUAAUUUAUUACGUAGGUUAUGCCUUUUCCGAACCCGUCAGCUAACCCCGUCGGUAAUAAGGAGGAUAUAU,42,40,27,25,134
2830,13,BA000035.2/944145-943971,AAACCACACACGCUUCUACCUUGUAGAAGACUUGCAGACAGGGACGGGGAACCCACCUGCCCACCGCGGGCACCGGAGGUAACUCCUUGGGGUGAAGCCGAAGUUCUCCUUCGGCAGGGCACAUCCUCCGCCCUAACCCGACAGCUAACCUCGACGGCGACAGAUGAGAGGACAU,44,26,47,58,175
2831,13,AAOX01000002.1/156408-156546,AAAAUGAAUCGGCUUAAUCUCAUAUUGAGAGCGGAGGAACCAAUUUUUGGGGCUAAUCCUGCAGGAAGCAGGAGGGAUGAGAAUGAUCUUUCGCCAUCCUGCCCGUCAGCUAACUUCGUCGGCUAAAGCGAGUGAGGUC,38,33,39,29,139
2832,13,CP000673.1/658090-657951,CUAUAAAACAAGCCUAAACUUCCAAAACUGGAAUCAAGUGCGGGGGAUAACAAUAUUUGAGGUGAAUCUUUUUAUUAAAAAGUAGGACAAUCCCUCUCCGAACCUGUCAACUAACCUCGUAGGCUAAUUAGGGAGGAUAU,50,36,27,27,140
2833,13,AE015927.1/2711017-2711139,AAUAACAUAAGCCUAAGUUUAAAACGCGGGGGAACCAUUAAUUGGGGUGAAUCACAUUUAUUUUGUGUAGGUUAGCCUUUACCGAACCCGUCAGCUAACCCCGUUGGUAAAAGGAGUGAAUAA,40,33,28,22,123
2834,13,CP000232.1/2197504-2197633,UAUUUUUUAGCACCGAAUUCCCGGGUAGGCGGGAAACGGGGGAUAUUUUUGGGGUGAAGAGCCAAAGGCUCCGGGCUAACUCUCGGUCCGAACCCGUCAACUAACCUCGUAGGUGUGCGAGAGUGGAGGU,29,30,43,28,130
2835,13,CP000667.1/3890461-3890591,GCGGGGCCACCGCCUAAUCACCUGCCAGGGUGAGCCGGGGAACCAGGUACCUGGGGUGCAUCCGCGUCAGCGGUAGGGAUCUUCCGUCCCGAACCCGUCAGCUAACCCGGUCGGUGGUUGACGGAAGGACA,24,20,46,41,131
2836,13,AAXV01000025.1/10441-10579,AUUUAAUAAUGGCCAAAUCUCAAACAUUGAGAACGGAGGACCCAAUAUAUUGGGGUUAAUUCUGAAAUACAGAAAGGAUGAGAAACUCUUUCGCCAUCCUACCCGUCAGCUAACUUCGUCGGCUAAAGCGAAGGAGGUC,47,33,30,29,139
2837,13,AE017180.1/2728254-2728393,ACAUUCAUGCAGCCGAGAUCCGUUCGCGAGAACGGGUGCGGGGGACCCACUUCGGGGGCGUAUUCCGGCAAUGGCGCCGGAUAGAGGACUUUCAGCCUCGAGCCCGUCAGCUAACCUCGUAGGCAUCUGGAAGGGCACGA,29,24,47,40,140
2838,13,AP009389.1/2311724-2311891,CUGUAUGCAUCGCUGAAUUCCGAAAGGAAGCGGGGGACCCAACCAUUGGGGUGAAUCCCGUUCAGCUGCCGGCAACCCUGCGGACACCAACCGGCAGCUAACGGGUAGGGCUAAUUCCUUCGGCCCGAAUCCGUCAGCUAACCUCGCAAGCGUUGAAAGGAAGGAUAA,43,29,48,48,168
2839,13,AE001437.1/3232090-3232211,UAUCAUUAGCCUAAAUUUUAAAAACGGGGAAACCAAUUUUUGGGGUGAAUCGCAUAAUAUAUGCGUAGGUUUGUGCCUUUACCGAAUCCGUCAGCUAACCUCGUAGAAUAAAAGGAGGAAGA,41,34,27,20,122
2840,13,CP000002.3/542499-542640,UAGCGCCACACGUUUAAUCCUUUAGUAGGAGUGGGGGACCCGAUCAUUUGGGGUGAAUUUUUCUGUUCCCGUGCGAACCGAAAGACGGACAUCUCUUCGUCCGAACCCGUCAGCUAACCUCAUCAACGUGAAGAGAGUCAUG,34,36,36,36,142
2841,13,BA000030.3/5911883-5911718,AUCAAUCCACCACUCACUCACGCACGGCAGGAGCGGGGAAACCAGGUAAGUCGCCGUCCGGUCACCACGCCGGAGCGGCUCGGGGUGAAGCCGCGUCCUCGGACGCGGCCGGGCAUCUCCAGCCCGAACCCGACAGCUCACCUCGCAGGCGCCGGAGAGGAAAUUC,35,18,52,61,166
2842,13,CP000473.1/5838272-5838399,AAUAUGAAGUCGCCGAGCUCCACCUGGAGACGGGGGACCCAAGUUUUUUUGGGGCGCAGUCCGCAAGGACGGAGUACUUUCAAGCUCUAGCCCGACAGCUAACCCCGUAGGCGGAUUUGAGAGUCACC,30,25,38,35,128
2843,13,CP000679.1/819128-818978,AUAUCAAAAAAGCUGAAUUCCUGUGUAAAGAGCACAGGAUAGGGGGGACCCACUUUUUCGGGGUGAAUCAAGGCAUCUUGCCUUGUAGGGCAAAUAUCCCUUUCUGCCCGAACCCGUCAGCUAACCCCCGAAGCUUUGAAAGGGAGGUUUG,41,36,39,35,151
2844,13,BA000030.3/4296121-4296312,GCGCGGCCUCCGCCGAGUCCGGCGUGCCGCCCGUGGCAGCUGGAGCCGGGGACCCAACCGACCUCGGGGUGAAUCGGCUCAGCCGCCUUGAAGGGCUUCAACCGCCUUGAAGGGCAACGACCGUAGGGCAAACCUUCCGAAGCACGCGCCCGAACCCGACAGCUAACUCGGUAGGCGGAACACGGAAGGAGA,40,21,65,66,192
2845,13,BA000030.3/2009780-2009620,CCCGCACACUCACCCGUGCCCGGCAGGAGCGGGGGACCCACAGGCAACAACGCCUGUUCCGGUCUCCGGAACAGGCUAGGGGUCAAGUCGCGCGCAAGCGCGGCCGGGCAUCUCCAGCUCGCACCCGACAGCUCACCUCGCAGGCAUCGGAGAGGAAUGCA,33,17,51,60,161
2846,13,AL939129.1/64567-64726,ACUCAUCGACCACCCGUACACGGCAGGAGCGGGGGACCCACAGGUAGAACUGCCUGUUCCGGUUCCCGGAACGGCUUGGGGUAAAGCCGCGCUCCGGCGCGGCCGGGCAUCUCCAGCCCGCACCCGACAGCUCACCUCGCAGGCGCCGGAGAGGAAUUCA,31,20,51,58,160
2847,13,AE000516.2/965771-965549,GCCGAUAGCACGCCGAACUCCAUCCAGUGGGCGAGGGAUUCCGACCGCGGAUGGAGGCGGGGGACCCACCAGGUCCGCCGAGAUCGGACCGGAGCCGCAUACGGCUCCUUGGGGUGAAGCCAACGUCGUUCGCCGAUGUACGACCGCGGCCGGGUGAUCCUCUCCACGGCGAAUCCAACCCGAACCCGACAGCUGACCUCGUAGGCGUGUACCGAGAGGAAUU,45,31,74,73,223
2848,13,CP000454.1/860269-860482,UCACGGUACGAAUCACCUCCUGGCAGAGGCGGGGGAACCACAACCGGCCGUUGCAAGACGGCCUUGGGGUGAAGUCCGUCAGCGGCAAAGCACCUCCGACGAAGGAUUCCUUUGGGAUACCCCUGUGUCGGAUGCCUUGCAUUGGCGGACCGGGUCUUUGAUCUCUCUGACCCGAAUCCGACAGCUAACUCCGCAGGCUUCCCAGAGAGGAUAA,46,41,63,64,214
2849,13,CP000001.1/1793577-1793723,UUUUCUAAAUCGCUGAAACCGCAUGGUGCGGGGGACCCGUUCUUAUGGAUUAGUUCUUAAUCCAAUGGGGUGAAUCCUUGAAAAAGGUAGGGCUACUCAUAGGCCCGAAUCCGACAGCUAACCUCGUAAGCGUUAUAUUGAGAAGGA,40,39,38,30,147
2850,13,CP001124.1/643212-643081,GGAAUUUAGCAGCCGAGAUCCGUCACCGACGGAUGCGGGGGACCCACUUAAGGGGCGUAUUCCAGACAAUGGAUAGGGCACUUCCAAGCCCGAGCCCGUCAGCUAACCUCGUAGGCAUUUGGGAGAGCAUGG,32,23,42,35,132
2851,13,CP001348.1/597732-597876,AAUAAUUUAUCGCUGAAUUAUGGCAGUUUGACUGCUAUAAGCGGGGGAACCAUUCAAAUGGGGUGAAUCCUGUGUUAUCAGGUAGGGUUAGUCUCUUACAACCCGAAUCCGGCAGCUAACUUCGUAAGCGUUGGGGAGAAAGUGA,40,40,40,25,145
2852,13,CP001348.1/2317685-2317544,AAAUUAAAAAGCUGAAUCCUCGAAAGAGGUACGGAGGAACCAAGAUUUGGGGUUAAUCCAUUCUUUAUUCUUUUAUUGAAUGGUAGGGAGGUCCUAUUGCCCGAGCCCGUCAGCUAACUUCGGAAGCGCUACUAUAGGAGGG,41,38,37,26,142
2853,13,CP001022.1/2525926-2525774,UCUCAAAGUACGCCGAGUUCAUGAUUGAAGCGGGGGACCCAACCGUCACGACACGUGACACGGGGUGAAUCUUCUCAGACAAGAGAAGUAGGGCAAAAUCCUAGGUAUGCCCGAAUCCGACAGCUAACCUCGCAGGCGUUUUAGGAGGGAACG,44,27,44,38,153
2854,13,ABDA02000001.1/440841-440988,UUUUUGUAAACGCUGAGUCCAAUUAUAUGGAGCGGAGGAACCAAUUUGUGCGUAGGCACUAGGGGUGAAUCUUUCAAGUUUGAAAGUAGGGCUACUCUCAAAGUCCGAAUCCGACAGCUAACUUCGUAAGCGUCUUGAGAGAGGACGG,41,39,41,27,148
2855,13,CP001348.1/872452-872592,GUACAAAAUAUGCUGAAUCCUUGUGAUUUAUGACGAGGUACGGAGGAACCAAGAAAAGGGGGUUAAUCCAUUUUAUAUGGUAGGGUGAUCCUAUUACCCGAACCCGGCAGCUAACUUCGGAAGCACAGUAUAGGAGGAAUA,46,34,37,24,141
2856,13,AE008691.1/1020677-1020802,AGUUAAAACAUGCCGAAUCCCCGAUAAGGGGUACGGGGGAUGUAAAUUUGGGGUGAAUCCACGUAUUGUGGUAGGGUGGCCCUCACCCGAACCCGUCAACUAACCUCGGAGGCAAAGGGGGUAAAU,35,25,39,27,126
2857,13,CP000885.1/2073734-2073865,GAUGAAACAAAUCCGAAUAUCUUUAUGGUAGUGGGGGAACCAAUUUCAGGGGUGAAUCUUAGUAUUUUAAGAGGGGCAGCUUGGGAGCCCUAAUCCGUCAGCUAAUCCCAUAGGAGAAUACCAAGCGAAUGA,42,32,35,23,132
2858,13,CP000853.1/56237-56106,AUAUACAUAGCGCUGAAUUCUUUUAAGAAGCGGGGGAACCAUUAUUUUGGGGUGAAUCUCAUAUCUAUGAGACGGGUCAACUCUUUCGAUCCGAAUCCGUCAGCUAACCUCGUAAGCGUUGAAAGGGGAGAC,37,36,33,26,132
2859,13,CP000850.1/603238-603111,GCGGUACCACCGCCCAAUCGCCGCGGGGCGGGCCAGGGAACCAGGCACAUGGGGUGAAUCCGCAUCAGCGGAGACCACUUCCGGCCCGGACCUGUCAGCUAACCCGGUCGGCGGUCAACGGAAGGGAU,26,14,45,43,128
2860,13,CP001336.1/3262209-3262073,AAGAAAUGUGGGCUGAAUCCGGACCGUGUGUCUGGAACGGGGGAUAAUCUUUUGGGGUGAAUCGCAGUCAUGCGUAGGGCUUGCACCUUUUUGCCCGAAUCCGUCAACUAACCUCGUAAGCGACGAAAGGUGGAAAA,35,32,42,28,137
2861,13,CP000850.1/1933321-1933455,CGUGCCGACCCGCUCAAUCGCCGUAAGGCGAACCGGGGACCCGUUCCACCUGGGGUGAAUCCGCGAGCUUCGCGGUAGGGCGUACUUCCCGUCCGAAUCCGUCAGCUAACCCGGUCGGCGGUAUCGGAAGGAGUC,23,23,44,45,135
2862,13,AE008691.1/1853404-1853270,UAAUCGUUAUCGCUGAACCCGAAAAGGGGCGGGGGACCCACACUUUUGGGGCGAAUCUCUUCCUACGGGAAGAGUAGGGUUACUCCUUCGACCCGAGCCCGUCAGCUAACCUCGCAAGCGUGGGAAGGAGAAAUA,34,26,40,35,135
2863,13,AB001488.1/19151-19294,GAAAACAAAUCGCUUAAUCUGAAAUCAGAGCGGGGGACCCAAUAGAACGGCUUUUUGCCGUUGGGGUGAAUCCUUUUUAGGUAGGGCUAACUCUCAUAUGCCCGAAUCCGUCAGCUAACCUCGUAAGCGUUCGUGAGAGGAGAU,39,36,38,31,144
2864,13,ACMD01000040.1/12378-12525,UUUUGUAAUACGCUGAGUCCAAAUGUAUGGAGCGGAGGAACCAAUUUGUGCGUCGUCACUAGGGGUGAAUCUUUCAAUGUUGAAAGUAGGGCUACUCUCAAAGUCCGAAUCCGACAGCUAACUUCGUAAGCGUCUUGAGAGAGGACGG,40,39,41,28,148
2865,13,CP000924.1/1503502-1503372,UAUGCAAUCUUGCCGAAUCCGAAAGGUACGGAGGAACCGCUUUUUGGGGUUAAUCUGCAGUGAAGCUGCAGUAGGGAUACCUUCUGUCCCGCACCCGACAGCUAACUCCGGAGGCAAUAAAGGAAGGAGAU,36,28,37,30,131
2866,13,CP000923.1/2119184-2119053,AAAUGCUAAACGCUGAAUUCGUAAAGAAGCGGGGGAACCACUUUGGGGGUGAAUCCAUCUUUUGAUAAGAUGGUAGGGUUAUCUUUCGACCCGAACCCGUCAGCUAACCUCGUAAGCGUUGAAAGAGGAGGA,39,31,37,25,132
2867,13,AL009126.3/3188193-3188341,UCUCUUUUACCGCUUAAUCAAACACGAACGGGGGAACCAACGAUUGGCUGUUUUAUUAACAGCCUUGGGGUGAAUCUUACUAAGUAAGAGGGGGUACUCUGAAUCCCUAAUCCGACAGCUAACCUCGUAGGCGUAUACAGAGAGGAGGU,42,38,37,32,149
2868,13,CP000820.1/6974887-6974725,UGACUCCCUCCGACGAGCAUCUGAGGCAGGAACGGGGGACCCAUGUUUCUCUGGGCGUCGCCUCCUCGGCGCCCUUGGGGCGAAGCCGGACACGCAUGAGGCGUUCGGCCGGGCUCCCAGCCCGAACCCGACAGCUCACCUCGCAGGCGUAGGGGAAGGACCA,28,23,55,57,163
2869,13,AE008691.1/927258-927390,ACAUGCUAAACGCUGAAUUCGUUAAGAAGCGGGGGACCCACUCUUUUGGGGUGAAUCCAUCUUUUAAAAGAUGGUAGGGUUAUCUUUCGACCCGAACCCGUCAGCUAACCCCGUAAGCGUUGAAAGAGAAGGA,38,32,34,29,133
2870,13,CP000903.1/3134671-3134815,UACAACCUUUUGCUGAGUCCAAAUUUUGGAGCGGGGGAACCAAUUAUGUAGCUUUUUGCUACUUGGGGCGAAUCUUUUUUAAGUAGGGAAACUCUCACUUCCCGAGUCCGACAGCUAACCUCGUAAGCGUAAUGGGAGAGGAAGG,37,41,38,29,145
2871,13,AE008691.1/890816-890945,UUUGCAAUCUUGCCGAAUCCGAAAGGUACGGAGGAACCGCUUUUUGGGGUUAAUCUGCGGAUUCCCGCAGUAGGGAUGCCUUCUGUCCCGCACCCGACAGCUAACUCCGGAGGCAUUAAAGGAAGGAGAU,31,30,37,32,130
2872,13,CP001186.1/738417-738564,UUUUUGUAAACGCUGAGUCCAAUUAUAUGGAGCGGAGGAACCAAUUUGUGCGUCUGCACUAGGGGUGAAUCUUUCAAAUUUGAAAGUAGGGCUACUCUCAAAGUCCGAAUCCGACAGCUAACUUCGUAAGCGUCUUGAGAGAGGACGG,41,40,39,28,148
2873,13,CP000850.1/4190713-4190844,GCGUGGCCGCCGCCUAAUCGCCUGCCAGGGCGAGCCGGGGAACCAGGUACCUGGGGUGCAUCCGCGUCAGCGGUAGGGAUCUUCCGUCCCGAACCCGUCAGCUAACCCGACCGGCGGUUGACGGAAGGACAU,23,19,46,44,132
2874,13,AP008230.1/4597555-4597682,ACUUAAUAUGGGCUUAAUUUCCCAAGGGGAAAACGGGGGAACCAAUUUAGGGGUGAAUCGUUUUAAACGUAGAGCAUGUUUCAGCUCGAACCCGUCAGCUAACCUCGUAAGCAUUGAAGCACAUGAGG,39,31,33,25,128
2875,13,CP001176.1/769318-769465,UUUUUGUAAACGCUGAGUCCAAUUAUAUGGAGCGGAGGAACCAAUUUGUGCAGUGUCACUAGGGGUGAAUCUUUCAAGUUUGAAAGUAGGGCUACUCUCAAAGUCCGAAUCCGACAGCUAACUUCGUAAGCGUCUUGAGAGAGGACGG,41,40,40,27,148
2876,13,CP001083.1/1451441-1451318,AAACAAAUAAUGCCGAAUCUUCUUUACGAAGUACCGAGGAUACUCUUGGGGUGAAUCUCUUAGGAAUAGGGUACCUCUAACCCAAACCCGUCAACUAACCUGGAAGGCGAUAUGGAUGGAUUUA,40,31,27,26,124
2877,14,AY316747.1/71407-71301,GCAGAUGUUUCUAGGGUUCCGAUGCCGUCAGGGCAUGUCUGGACCGAGAGAAACCUCCGGUGGGGAGACAUCCACCGGGUCCACGGCGGGAUAAAAGCCCGGGAGGC,23,17,39,28,107
2878,14,BX569692.1/338223-338321,GGCGGAGAAACCUAGGGUUCCGAUCCCGUCAGGGAUGCCUGGUCCGAGAGGUUUCGGUCGGUUCUGCCGGCUGCACGGAGGGACAAAAGCCCGGGAGAC,19,16,38,26,99
2879,14,D78189.1/4535-4646,UGUAAAGUUUUCUAGGGUUCCGCAUGUCAAUUGACAUGGACUGGUCCGAGAGAAAACACAUACGCGUAAAUAGAAGCGCGUAUGCACACGGAGGGAAAAAAGCCCGGGAGAG,37,21,33,21,112
2880,14,AB016894.1/3319-3421,AGAAAGGUUUUCUAGGGUUCCGCGGCUGCUUUGUGGCCGGCCUGUGACCGAGAGAAAACGCGCGGCAUUCUCGCGUACACGGAGGGACAAAAGCCCGGGAGGA,23,18,37,25,103
2881,14,BX571660.1/22706-22807,CGAACAGAUGGCUAGGGUUCCGAUGAUCGCUUGAUCAUGCUGGUCCGAGAGCUAUCGGCCUCUUGAGUAGAGGUUACACGGAGGGAUAAAAGCCCGGGAGGU,24,22,35,21,102
2882,14,BX572597.1/165163-165059,AGAGUUGGUGGCUAGGGUUCCGGCCUGUUUCAGGCGCUGGUCCGAGAGCUGCCCCCCGAAGGGAGAAAUCCUUCGGACGCACGGCGGGACAAAAGCCCGGGAGAC,21,16,39,29,105
2883,14,AF116356.1/182-293,UGAGUUGGUGGCUAGGGUUCCGGCGUUUUUCUGAAGCGCGACUGGUCCGAGAGCCACCACCGGCGGAGGAGAAAACCCGUCGGGUGCACGGCGGGACAAAAGCCCGGGAGAC,23,17,43,29,112
2884,14,AE017333.1/1406463-1406565,GUUAAAGUUUUCUAGGGUUCCGCACAUUCGUAUGUGGCCUGGUCCGAGAGAAAACACAUAUGAUUUGUUCAUAUGCACACGGAGGGAUAAAAGCCCGGGAGUA,29,27,28,19,103
2885,14,BA000045.2/1020511-1020399,AAAACUGGCUUCUAGGGUUCCGGUCCCGCUCCUGUGGUGGGACGGCUGGUCCGAGAGAAGCAGCCGGUCCGACAGCAGGGCCGGUCACACGGCGGGAGAAAAGCCCGGGAGAG,23,15,44,31,113
2886,14,CP000091.1/18427-18312,CCGAAGGGUAGCUAGGGUUCCGGUCGUGCCAUGCGCGCGAUGGCUGGUCCGAGAGCGACCGGCCACCGGCACCUGAUCCGCCGGCGGCUCCACGGCGGGACAAAAGCCCGGGAGGU,19,14,45,38,116
2887,14,CR543861.1/1073618-1073719,CAUAAGGUGAUCUAGGGUUCCGAUGCUGUUUACUAACAGGAUGGCUGGUCCGAGAGAUUACGGUUCGUAAGAACUACACGGAGGGAUAAAAGCCCAGGAGGU,29,23,32,18,102
2888,14,AP008934.1/2424072-2423973,AAUAAAGCUUUCUAGGGUUCCGCAAGGUGAUUACUUUGGUCUGGUCCGAGAGAAAGCCACAUAUUUUUAUGUGACACGGAAGGAUAAAAGCCUGGGAGAU,30,27,27,16,100
2889,14,CP000075.1/4719777-4719879,GCAAUAGCCGACUAGGGUUCCGGCUUGCCGCCAGGCAAGUGGCUGGUCCGAGAGUUGGCGACCUCCAGUAGAGGUUACACGGCGGGACAAAAGCCCGGGAGAC,23,15,37,28,103
2890,14,AP006627.1/4004674-4004578,CACAAAUGCGCCUAGGGUUCCGCUUCAUUUGUAAGGGCUGGUCCGAGAGGUGCACACGGCGUCUGCCGUGACACGGAGGGAUAAAAGCCCGGGAGAC,22,17,33,25,97
2891,14,BA000004.3/741978-741875,CCAAAUGUUUUCUAGGGUUCCGCUUGCAAGGCAAGGCCUGGUCCGAGAGAAAACGCAAAAAAGAUUGUCUUUUUUGUCCACGGAGGGAGAAAAGCCCGGGAGAU,30,23,30,21,104
2892,14,BX950851.1/2166770-2166871,UGAAUAGCUGGCUAGGGUUCCGAUCCAUGCAAUAUGGAUGUCUGGUCCGAGAGCUGGCGACCUCCAGUUGAGGUUACACGGCGGGACAAAAGCCCGGGAGAC,24,20,34,24,102
2893,14,BA000043.1/632114-632216,GGGAAUGUUUUCUAGGGUUCCGCGGCUGCUUUGCGGCCGGCCUGCGACCGAGAGAAAACGCGCGGCAUCGCCGCGUGCACGGAGGGACAAAAGCCCGGGAGGA,20,15,40,28,103
2894,14,AE017333.1/3988916-3988810,AAGGUGGUUUUCUAGGGUUCCGCAGUGCCCUCCCGCGCUGGUCUGGUCCGAGAGAAAACACAUAGCGAAGUAUCGUUAUGACACGGUGGGAUAAAAGCCCAGGAGUU,26,24,33,24,107
2895,14,AP006840.1/808978-808865,GAUCAGGUUUUCUAGGGUUCCGCGGCGUCACGGCGCCGGUCCGGUCCGAGAGAAAACGCACAACCGGCGGGAGAGCGCCGGCUGUGUACACGGCGGGACAAAAGCCCGGGAGGA,24,14,44,32,114
2896,14,BA000028.3/3401735-3401639,GUAAAUACUUUCUAGGGUUCCGCCUUAUUGGGUCUGGUCCGAGAGAAAGUGCAAAGAAUUUUUUCUUUGUCCACGGAGGGAUAAAAGCCCGGGAGAU,25,28,27,17,97
2897,14,BA000022.2/801401-801280,GGAUAUUGUUUCUAGGGUUCCGAUUCCUGGUGAUGUGGGGAAUGGCUGGUCCGAGAGAAACAGGCUAGGCUUUGUAAAGAUUUUUGCCACUAGCUACACGGCGGGACAAAAGCCCGGGAGAC,29,30,40,23,122
2898,14,CP000091.1/1611056-1610941,CCGAAGGGUCGCUAGGGUUCCGGUCGCGCUGCGCGCGAUGUCUGGUCCAAGAGCAACCGGCCUCAGGCGCGCUCGACCGCGUCCAGGCUCCACGGCGGGACAAAAGCCCGGGAGGU,19,15,43,39,116
2899,14,CP000089.1/86805-86928,UUAAUGGGCGGCUAGGGUUCCGGUUUCGUCGGAAAUGUCUGGUCCAAGAGCUGCCGGUUCUGUCUGCCGUGGGUGAUUGCCGCGGUGUGUCAGAGCUCCACGGAGGGAUAAAAGCCCGGGAGGA,21,29,47,27,124
2900,14,CP000304.1/2184496-2184399,GAAAUAGCCGACUAGGGUUCCGACUCGCUCGCGAGUGGCUGGUCCGAGAGUUGGCGACCUCCAGUGAGGUUACACGGCGGGAUAAAAGCCCGGGAGAA,23,16,35,24,98
2901,14,ABDW01000004.1/105268-105170,UAUAAAGUUUUCUAGGGUUCCGUAACUUUUUAGUUAGUCUGGUCCAAGAGAAAACGCACAGAAAGACUGUGAACACGGAAGGAUAAAAGCCUGGGAGAU,34,25,25,15,99
2902,14,AACY020487820.1/810-909,GAAAUGGAUGACUAGGGUUCCGAUCCGCCCAGGCGGGUGACUGGUCCGAGAGUCAUCGACCUCCGAUGAGGUUACACGGCGGGAUAAAAGCCCGGGAGAA,25,16,35,24,100
2903,14,AP008230.1/4836847-4836749,AAAAAUGUUUUCUAGGGUUCCGCAACACGCUUUGUUGGUCUGGUCCGAGAGAAAACUCACAGCCUGGCUGUGUCACGGAGGGAUAAAAGCCUGGGAGAG,26,23,30,20,99
2904,14,CP000301.1/5067771-5067660,GGAGUUGGCUGCUAGGGUUCCGGCCUUGCGUGAUGCAGGGUGCUGGUCCGAGAGCGGCCGCUUGCGGGGGAGACAUCCUCGCAGGACACGGCGGGACAAAAGCCCGGGAGAC,19,17,47,29,112
2905,14,AACY022570280.1/322-224,CCAAUAGCUGGCUAGGGUUCCGGUUCACGCAGGUGAAUGUCUGGUCCGAGAGCUGGCGACCUCUGCGAGGUUACACGGCGGGACAAAAGCCCGGGAGAC,21,17,35,26,99
2906,14,CP000110.1/1021660-1021560,GCGGAUGAAAUCUAGGGUUCCGAUCUCUUCACGGGGAUGCCUGGUCCAAGAGGUUUCCACCGGCCUUGCCGGUUGCACGGAGGGACAAAAGCCCGGGAGAC,21,19,34,27,101
2907,14,AM180355.1/2762349-2762255,AAUUUAGUUUUCUAGGGUUCCGCAUUUUAUAAUGGUCAGGUCCAAGAGAAAACGCACAAUUGUUGUGUACACGGAAGGAUAAAAGCCUGGGAGAU,30,27,24,14,95
2908,14,CP000460.1/60769-60638,CUUCAGGAUCGCUAGGGUUCCGGUCGUGCGGCGUGUGCCGCGCGAUGCCUGGUCCGAGAGCAAUCCGGUCUUGCCUUCGCCUCGACGAGAGGAAACGGCGAGGCUCCACGGAGGGAUAAAAGCCCGGGAGGU,23,23,49,37,132
2909,14,AACY020561157.1/192449-192570,UCUUAGGGGUGCUAGGGUUCCGGUUCAUCGAACGUCUGGUCCGAGAGCAGCCCGGUGCGGGUUCGUCCGAUCGCGAGACCGGACGCACACGCGCUACACGGCGGGACAAAAGCCCGGGAGAU,23,20,44,35,122
2910,14,CP000304.1/2174098-2173996,UUCAAGGAGAACUAGGGUUCCGGCUCACAGGGAGUGGGCGCUGGUCCGAGAGUUCUCCGGUCCCAGGGACGGGACUACACGGAGGGAUAAAAGCCCGGGAGAC,24,15,39,25,103
2911,14,CP000542.1/4178508-4178625,CAGAAGGGUCGCUAGGGUUCCGGUCGCACACAUCGAUGCGGCGCUGGUCCGAGAGCAACCGGCCUCAGGCGCGCACGACCGCGCCCAGGCUCCACGGCGGGACAAAAGCCCGGGAGAU,24,12,42,40,118
2912,14,CP000450.1/2598462-2598562,GCUUUACGAAACUAGGGUUCCGGCUUUCCAAGGGAAGUGACUGGUCCAAGGGUUUCGGGCCCUUUCAAGGGGUUCCACGGAGGGAUAAAAGCCCGGGAGGU,22,22,35,22,101
2913,14,CP000529.1/42882-42765,ACAAAUGACAGCUAGGGUUCCGGCCACUUGUUCGCAAGCGGUGUCUGGUCCGAGAGCAGUCGGCCAGCAGCGGCCCACACCACUGCAGGUUCCACGGCGGGACAAAAGCCCGGGAGGU,26,17,39,36,118
2914,14,CP000394.1/1970354-1970241,AACGUAUGCGACUAGGGUUCCGGCUGCCUGUGCAGUGACUGGUCCGAGAGUCGCAAUCCGGUACCUCCUUUCAGGAAAGGGCUGGACACACGGCGGGAUAAAAGCCCGGGAGGU,25,21,39,29,114
2915,14,CP000511.1/851507-851616,GUGGGGCGCGCCUAGGGUUCCGCCGGCAGGCAGCCGGGUCUGGUCCGAGAGGCGCAGGCGGCCGGCACCGGAGCCCGGCCGUUCCACGGCGGGACAAAAGCCCGGGAGAC,16,9,48,37,110
2916,14,AACY022304416.1/191-289,GGCGGAGAAACCUAGGGUUCCGAUCCCGUCAGGGAUGCCUGGUCCGAGAGGUUUCGGUCGGCACAACCGGCUGCACUGAGGGACAAAAGCCCGGGAGAC,22,14,36,27,99
2917,14,CP000616.1/127215-127094,UCUUAGGGUCGCUAGGGUUCCGGUUCAUCGAACGUCUGGUCCGAGAGCAGCCCGGCGCGCGGGCGUCCGAUCACGAAAACGGACGCCCGCGCGCUACACGGCGGGACAAAAGCCCGGGAGAU,24,17,43,38,122
2918,14,AACY020944359.1/616-715,CAAAUAGAGCGCUAGGGUUCCGGCCGCUGUAGCGGUGACUGGUCCGAGAGCACUCGACCUUUCAGACAAGGUUACACGGCGGGAUAAAAGCCCGGGAGAC,25,16,33,26,100
2919,14,CP000521.1/1496368-1496463,UCAAAAGUGAUCUAGGGUUCCGAUACUUACAGUAUGUCUGGACCGAGAGUUCACGGUUCCUAGCGAACUACACGGAGGGAUAAAAGCCCGGGAGGA,28,20,28,20,96
2920,14,AACY023003357.1/203-105,GAAAUGGACGGCUAGGGUUCCGGCCUGCUUCAAGCAGGUGCUGGUCCGAGAGCUGUCGACCUCGGUGAGGUUACACGGCGGGAUAAAAGCCCGGGAGAG,21,17,38,23,99
2921,14,CP000721.1/3993909-3993812,AUUUAAGUUUUCUAGGGUUCCGCAGUUUGUAACUGGCAGGUCCGAGAGAAAACGCAUAGUUUAUACUAUGUUCACGGAAGGAUAAAAGCCUGGGAGAU,29,28,26,15,98
2922,14,CP000774.1/2046573-2046691,GUUGGCAGCGGCUAGGGUUCCGGCUUCGCGUGUAGUUGUUUGCGAAGUGCUGGUCCGAGAGCCGCACCCUGUCCGGUGAACAGCGGGCAGGUACACGGCGGGACAAAAGCCCGGGAGAC,21,21,46,31,119
2923,14,CP000271.1/1848426-1848294,CUUCAGGAUCGCUAGGGUUCCGGUCGGACGCUUUCAUGCGCACGAUGCCUGGUCCGAGAGCAAUCCGGUCUUGCCGUUCACCUUCUUUCAAGGCGCCGGCGAGGCUCCACGGAGGGAUAAAAGCCCGGGAGGU,23,28,43,39,133
2924,14,AANE01000002.1/189556-189666,CAAUGGUAUAGCUAGGGUUCCGACUUUGAAAAAAGUGUCUGGUCCGAGAGCUAUCGACCUCACCUGACAUUCUCAGUGAAGGUUACACGGAGGGAUAAAAGCCCGGGAGAA,33,24,31,23,111
2925,14,ABDX01000001.1/159014-159112,UAUAUGGUUUUCUAGGGUUCCGUAGCUUUUUAGUUAGUCUGGUCCAAGAGAAAACGCACAGAUAAACUGUGAACACGGAAGGAUAAAAGCCUGGGAGAU,31,27,26,15,99
2926,14,AACY020686856.1/831-737,GCGGAUGAAAUCUAGGGUUCCGGUCUACGGGACGACUGGUCCAAGAGAUUUCAGCCGGCUCUGCCGGCACACGGAGGGAUAAAAGCCCGGGAGAC,23,15,33,24,95
2927,14,CP000544.1/2583259-2583363,GCAAUAGGCGUCUAGGGUUCCGUCCGCAGGCAUGCGGAGCCUGGUCCGAGAGUCGCCGACCUCUCCCAGAGGGGGGUUACACGGAGGGACAAAAGCCCGGGAGAU,22,15,39,29,105
2928,14,CP000781.1/1413287-1413177,CGAGUUGGUGGCUAGGGUUCCGGCAUCCCGCGGGAUGUGCUGGUCCGAGAGCUGCCACUGCUCCGGGAGACAUCCGGGGCGGGUGCACGGCGGGAUAAAAGCCCGGGAGAC,18,17,46,30,111
2929,14,AAMT01000009.1/114932-114823,GUGCAGGACGCUUAGGGUUCCGCCGCGCCAAAGCGCGGGUCUGGUCCGAGAAGCGUCACCCAUCCGGCAAAUUCCGGCAGGGCACACGGCGGGCCAAAAUCCCGGGAGAC,23,13,38,36,110
2930,14,AACY022971551.1/806-690,ACAAUGGCCGACUAGGGUUCCGGCUCGUCCGAUGACGAGUGGCUGGUCCGAGAGUGGGCGACCUCAUCAGCGGCGGGGAGCCGCGAGGUUACACGGCGGGACAAAAGCCCGGGAGAA,25,15,46,31,117
2931,14,AACY021185329.1/257-381,AGAAUAGCUGACUAGGGUUCCGGCGCCAAAUGGCGCGCGACUGGUCCGAGAGUCAGCGACCUCGAUCGACGCGACGAAAAAGAUUGCGUUUGCAGGUUACACGGCGGGACAAAAGCCCGGGAGAU,33,19,42,31,125
2932,14,CP000463.1/1370978-1371085,AGAGUUGGUGGCUAGGGUUCCGAUCUUGCGUGCAAGGUGCUGGUCCAAGAGCCGCCCCCCGAAGGGAGAAAUCCUUCGGAUGCACGGCGGGACAAAAGCCCGGGAGGC,23,17,40,28,108
2933,14,CP000282.1/1455387-1455513,CCAAUGGAUGGCUAGGGUUCCGGCUGUAAAUAAACAGUGACUGGUCCGAGAGCCAUCGACCUUCUAAGUGGUAGCCAAUUUGCAUAUUGGUAAGAGGGUUACACGGCGGGAUAAAAGCCCGGGAGGA,35,27,40,25,127
2934,14,CP000283.1/2437685-2437791,AGAGUUGGUAGCUAGGGUUCCGGCCUUGUCUGAAGGCGCUGGUCCGAGAGCUGCCCCCCGAAGGGAGAAAUCCUUCGGACGCACGGCGGGACAAAAGCCCGGGAGGC,22,16,40,29,107
2935,14,AAXV01000003.1/157177-157083,UGUAAAGUUUUCUAGGGUUCCGUAGCUGAUGCUAGUCUGGUCCGAGAGAAAACCACAAUUUUUUUGUGACACGGAGGGAUAAAAGCCUGGGAGAU,26,27,27,15,95
2936,14,CP000680.1/1531681-1531564,GAAAUGGCCGACUAGGGUUCCGGCCCACCCGCACGGGUGGGUGACUGGUCCGAGAGUGGGCGACCUCGGAGCGGCGGGAAGCCGCGGGGUUACACGGCGGGAUAAAAGCCCGGGAGAA,24,13,50,31,118
2937,14,AAFY01010653.1/807-706,CAAAUAGAGCGCUAGGGUUCCGGCUGAGCUGUUCAGUGACUGGUCCAAGAGCACUCGACCUNUCAGACAAAGGUUACACGGCGGGACAAAAGCCCGGGAGAC,28,16,31,26,102
2938,14,AAYA01000003.1/309765-309872,GGGCAGGGCGUUUAGGGUUCCACCGCCAUACGGCGGGUUCGGUCCGAGAAAUGCCACCCGGCGGGCAAACUCCCGCAGGGCACACGGCGGGGCAAAAUCCCGGGAGAC,22,12,40,34,108
2939,14,CP000460.1/61202-61326,UCUUAGGGGUGCUAGGGUUCCGGUUCAUCAUCGAACGUCUGGUCCAAGAGCAGCCCGGCGCGAGUUCGUCCGGUCGCAAGACCGGAUGCACGCGUGCUACACGGCGGGACAAAAGCCCGGGAGAU,25,22,43,35,125
2940,14,AACY022815670.1/204-110,GCGGAAGAGAUCUAGGGUUCCGGUCCUUCGGGACGACUGGUCCAAGAGGUUUCAGCCGGCUCGCCGGCGCACGGAGGGAUAAAAGCCCGGGAGAC,20,14,36,25,95
2941,14,CU234118.1/7058767-7058665,AGAGUUGGCAGCUAGGGUUCCGGUUCUCAUCGCGAGAACGCUGGUCCGAGAGCAGCCGCCAGGGGAGAGCCCUGGUGCACGGCGGGAUAAAAACCCGGGAGAC,23,14,39,27,103
2942,14,CP000656.1/84923-84804,GUGGGGCGCGUCUAGGGUUCCGCCGGCGGCAUUCGUCGAACAGGCCGGGUCUGGUCCGAGAGACGCAGGCGGCCGGCACCGACGCAGACCGUUCCACGGCGGGAGAAAAGCCCGGGAGAC,21,13,49,37,120
2943,14,CP000414.1/1882072-1882171,UCUAUAGUUUUCUAGGGUUCCGCUAUAAUAAUAGGUCUGGUCCAAGAGAAAACAUACAAUGAUUACAUUGUACACACGGACGGAUAAAAGCCUAGGAGAU,35,27,21,17,100
2944,14,CP000697.1/2994092-2993982,GCAAAGCCGAGCUAGGGUUCCGGCCGGAUCAAAAAUCCGGCGCUGGUCCGAGAGCUUCAGCCGCGCGGGAGACAUCCGCGCGGUCCACGGCGGGACAAAAGCCCGGGAGAG,25,11,41,34,111
2945,14,AACY022488354.1/229-332,GCAAUGGCCGACUAGGGUUCCGGCUCGCUUGAAAAGCGAGUGGCUGGUCCGAGAGUUGGCGACCUCCAGUUGAGGUUACACGGCGGGAUAAAAGCCCGGGAGAC,23,18,38,25,104
2946,14,AANO01000003.1/316950-317071,GGAAGCAGCUUCUAGGGUUCCGGUUCGCGUCAGUUCGCUUCAGCGAGCCCGAUGCGGCGUCUGGUCCGAGAGAAGCUCACCGGGGUCACCCGGUUGCACGGAGGGAUAAAAGCCCGGGAGAC,23,21,44,34,122
2947,14,AACY020631184.1/852-757,GGAGAAACCUAGGGUUCCGGUUCCGUCAGGGAUGACUGGUCCGAGAGGUUUCGGUCGGUUCUGCCGACUGCACGGAGGGACAAAAGCCCGGGAGAC,20,17,36,23,96
2948,14,AM236083.1/312516-312624,AGAGUUGGUGGCUAGGGUUCCGGCGUCGCAAGACGUGGCUGGUCCGAGAGCUGCCACCGGCAGGGGAGACAUCCUGCCGGGUGCACGGCGGGACAAAAGCCCGGGAGAC,21,14,45,29,109
2949,14,AAKY01000210.1/24279-24412,CUUCAGGAUCGCUAGGGUUCCGGUCGCACGGCGUCACACGCCGAGCGACGUCUGGUCCGAGAGCAAUCCGGUCUUGCCGCCUGCCUUUGCGAGGCCCCGGCGAGGCUCCACGGAGGGACAAAAGCCCGGGAGGU,22,21,47,44,134
2950,14,AACY023278747.1/300-199,CAAAUAGAUCGCUAGGGUUCCGGCGUUAUAGACAACGUGACUGGUCCGAGAGCAAUCGACCUUCAUUCGGAGGUUACACGGCGGGAUAAAAGCCCGGGAGGU,27,20,32,23,102
2951,14,AAFY01015288.1/310-411,CUAAUAGAUAACUAGGGUUCCGGUGAAUUUACUUCACGUCUGGUCCGAGAGUUGUCAACCUCAUGAGUAGAGGUCACACGGAGGGAUAAAAACCCGGGAGGU,29,24,29,20,102
2952,14,CP000673.1/2546156-2546053,UUUAAAGUUUUAUAGGGUUCCGCAGUUUGAAAUUGAUAAUUGGUCUGGUCCAAGAUAAAACGCACAGUUUGCUGUGUUCACGGAAGGAUAAAAGCCUGGGAGAU,31,32,27,14,104
2953,14,AL954747.1/2634203-2634101,GUUUCACGAAACUAGGGUUCCGGCUUUCCCAGGGAAAGUGACUGGUCCGAGAGUUUCGGGCCCUGCCAGCAGGGUUCCACGGAGGGAUAAAAGCCCGGGAGGU,22,20,36,25,103
2954,14,CP000450.1/2598249-2598146,AUUACUUUGGGCUAGGGUUCCGGCUUUCCAAGGGAAGUGACUGGUCCGAGGGCCCGAGGCUUCUCCAUAACGAAGCGCCACGGAGGGAUAAAAGCCCGGGAGAU,24,20,35,25,104
2955,14,CP000616.1/127702-127837,CUUCAGGAUCGCUAGGGUUCCGGUCGUGUGGCGCAGGCGCGCCGCGCGAUGUCUGGUCCGAGAGCAAUCCGGUCUUGCCUUCGCCUCGACGAGAGGAAACGGCGAGGCUCCACGGAGGGAUAAAAGCCCGGGAGGU,24,23,51,38,136
2956,14,AACY020561157.1/192016-191883,CUUCAGGAUCGCUAGGGUUCCGGUCGUGCGGCGUUCGCGCCGCGCGAUGGCUGGUCCGAGAGCAAUCCGGUCUUGUCUUCUCCUCGCUUCGAGGAAACGGCGAGGCUCCACGGAGGGAUAAAAGCCCGGGAGGU,21,27,48,38,134
2957,14,AAFY01000234.1/1647-1549,ACUAAAGGUAGCUAGGGUUCCGACUUAUUUAUAAGUGUCUGGUCCGAGAGCAACCGACUCUUAAAUAGAGUUACACGGAGGGAUAAAAGCCCGGGAGGU,30,23,28,18,99
2958,14,CP000103.1/1087459-1087562,GUAGCGCGAAACUAGGGUUCCGGCUUCUUUUUCGAAGUGUCUGGUCCGAGAGUUUCCGGCUUCGUCAUGACGAGGCUCCACGGAGGGAUAAAAGCCCGGGAGAU,21,25,34,24,104
2959,14,AAFX01006062.1/502-399,GUAAAGCGAAACUAGGGUUCCGGCUUUCUGCUGAAAGUGUCUGGUCCGAGAGUUUCCGGCUUCGUCGUGACGAGGCUCCACGGAGGGAUAAAAGCCCGGGAGAU,23,23,35,23,104
2960,14,AL954747.1/2634421-2634524,AUUACUUCAGGCUAGGGUUCCGGCUUUCCCAGGGAAAGUGACUGGUCCGAGAGCUUGAGGCUUCGUCAUACGAAGCUCCACGGAGGGAUAAAAGCCCGGGAGGU,24,22,34,24,104
2961,14,CP001348.1/2951117-2951220,CAUAUAGUUUUAUAGGGUUCCGCAGUUUAAUUUAAACAACUGGUCUGGUCCGAGAUAAAACGCACAGUUUAAUGUGUUCACGGAAGGAUAAAAGCCUGGGAGAU,33,30,25,16,104
2962,14,CP000908.1/4131856-4131747,CGAGUUGAUCGCUAGGGUUCCAGCAUCUCUUUGAUGUGUUCGGUCCGAGAGCGGUUGCCGCGGCGGGAGACAUCCGCCCGGAUGCACGGCGGGAUAAAAGCCCGGGAGAC,20,21,40,29,110
2963,14,CP001053.1/1408226-1408092,CUUCAGGAUCGCUAGGGUUCCGGUUGUGCGCAGAUCAAUGCGCACGAUGUCUGGUCCGAGAGCAAUCCGGUCUUGCCGUUCACCUUCUUUCAAGGCGCCGGCGAGGCUCCACGGAGGGAUAAAAGCCCGGGAGGU,25,29,44,37,135
2964,14,ABDT01000102.2/4407-4311,AGAUAAGUUUUCUAGGGUUCCGCAGUUUAUAGCUGGUCAGGUCCAAGAGAAAACGCACAGUAAAAUGUGUUCACGGAAGGAUAAAAGCCUGGGAGAU,32,23,27,15,97
2965,14,CP000960.1/472628-472749,UCUUAGGGUUGCUAGGGUUCCGGUUCAUCGAACGUCUGGUCCGAGAGCAGCCCGGCACGGGUUCACCCGAUCGCGAGACCGGAUGCGCACGUGCUACACGGCGGGACAAAAGCCCGGGAGAU,24,21,42,35,122
2966,14,AL009126.3/3988942-3988840,ACAGUGGUUUUCUAGGGUUCCGCAAUGCAAAUUGGACUGUGACCGAGAGAAAACACAUAGCAGCUUGGCUGUUAUGACACGGUGGGAUAAAAGCCCAGGAGUU,30,24,30,19,103
2967,14,CP000853.1/1397256-1397351,AUUUAAGUUUUCUAGGGUUCCGCAGCUUAUAACUGGCAGGUCCGAGAGAAAACACACAGCUAAUUGUGUACACGGAAGGAUAAAAGCCUGGGAGAU,31,23,25,17,96
2968,14,CP001083.1/2486240-2486145,AUUUAAGUUUUCUAGGGUUCCGCAGCUUGUAGAUGGCAGGUCCGAGAGAAAACACACAGUUGACUGUGUACACGGAAGGAUAAAAGCCUGGGAGAU,29,23,28,16,96
2969,14,CP002620.1/1522002-1521902,CCAAUAGCCGGCUAGGGUUCCGGCUCGCCACAGGCGAGCGACUGGUCCGAGAGCUAGCGACCUCCAGCGAGGUUACACGGCGGGACAAAAGCCCGGGAGAA,24,11,35,31,101
2970,14,FN668941.1/529411-529517,AAUAGAGUUUUAUAGGGUUUUGCAAUUAUUAAUGAUUGGCCUGGUCCGAGAUAAAACCCACAACAUAGUUUUUGUUGUGAACACGGAAGGACAAAAACCUGGGAGAU,36,31,25,15,107
2971,14,CP003056.1/927248-927350,AAAACUGUUUUCUAGGGUUCCGCGGAAGAAAUUCCGGCCUGGUCCGAGAGAAAACACACAGUCGUAUUAUGCUGUGACACGGAAGGAUAAAAGCCUGGGAGAU,32,22,29,20,103
2972,14,CP003056.1/927033-926937,ACAUUAGUUUUCUAGGGUUCCGCAGUACGCUGGUCAGGUCCAAGAGAAAACACACAGUUGGAAACUGUGCACACGGAGGGAUAAAAGCCCGGGAGAU,30,19,28,20,97
2973,14,CP000094.2/1520387-1520287,GCAAUGGCUGACUAGGGUUCCGGCUCGCAUCUGCGAGUGGCUGGUCCGAGAGUUGGCGACCUCCAGUUGAGGUUACACGGCGGGACAAAAGCCCGGGAGAC,20,18,37,26,101
2974,15,BABA01009937.1/46-141,UCAGAGUAGAAAACGAUGCGUUAAGUGUCCAGCAGACGGGGAGUUGCUGCCGGAACGAAAAGCAAAGCUUGCGGUAUCGUUUUCGCAUCCCGCUGA,26,20,29,21,96
2975,15,BABB01000157.1/63-158,GCAGAGUAGACACAUGUGCGUUAAGUGCCGGAUGAACAGGGAGUUGUCACCCGGACGAAAAGAAAAUCUUGCGGUACAUGAGUCGCAUCCCGCUGC,27,18,29,22,96
2976,15,BABF01004573.1/52-147,GCAGAGUAGGUUUGUGUGCGUUAAGUGCUGGUUGAACAGGGAGUUGUCAGCCGGACGAAAAGAUUUUCUUGCGGUACACGAAUCGCAUCCCGCUGC,21,25,31,19,96
2977,15,BABE01004909.1/284-381,AGCAGAGUAGGUCAGGAAGCGUUAAGUACCAUCUGAACGGGGAGUUGUCAGACGGGCGAAAAGUUUAUCUUGCGGUUUCCUGGUCGCAUCCCGCUGUU,22,25,31,20,98
2978,15,BAAU01016335.1/416-525,GCAGAGUAGGUAUAUGUGCGUUAAGUGCCGGAUGAACAGGGAGUAGUCAACCAGACGAAAGGGGCAAGAUAUGAAACUGUUCCUGCGGUACAUGAGCCGCAUCCCGCUGC,31,21,35,23,110
2979,15,BAAV01010818.1/618-715,AGCAGAGUAAGUGCCUACGCGUUAAGUGCCGGAGUACGGGGAGUUGACAUCUGGACGAAAGCCUUCGGGCUGCGGUGUAAGCAUUGCAUCCCGCUGCU,21,21,33,23,98
2980,15,BABG01026644.1/586-688,GCAGAGUAGGAAUACAGGCGUUAAGUGCUGGUUGAACAGGGAGUUGUCAGCCGGACGAAGAGACCCUCCGGGGUUUCGCGGUCAGUAUUCCGCAUCCCGCUGC,22,21,35,25,103
2981,15,BAAX01022545.1/141-43,CAACAGAGUAAGACCCUGCGCGUUAAGUGCCGCAUCAACGGGGAGUUGUGCUGCGGACGAAGGUAUUAGCCGCGGUGCAGGGUCUGCAUCCCGCUGCUG,20,19,34,26,99
2982,15,BABG01004557.1/3-100,CAACAGAGUAAGGCCAUGUGCGUUAAGUGCCGCAUCAACGGGGAGUUGUGCUGUGGACGAAGGUGUACCCGCGGUGCAUGGUCUGCAUCCCGCUGCUG,19,21,34,24,98
2983,15,BAAX01002679.1/2103-2006,CAACAGAGUAAGGCUAUGCGCGUCAAGUGCCGCAUCAACGGGGAGUUGUGCUGCGGACGAAGGGAGACCCGCGGUGCAUGGCCUGCAUCCCGCUGCUG,20,16,35,27,98
2984,15,BAAU01000940.1/627-724,CAACAGAGUAAGGCUAUGCGCAUCAAGUGCCGCAUCAACGGGGAGUUGUGCUGCGGACGAAGGGAGACCCGCGGUGCAUGGCCUGCAUCCCGCUGCUG,21,16,34,27,98
2985,15,BABE01017430.1/618-522,UGCAAAAUAGGAUUUUAUGCGUCAAGUGUUCGGUGAAUGGGGAGUUGUCACUGAAACGAAAAGUGCGUCUUACGGUAUAUUAUCCGCACCCGUUGCA,26,28,26,17,97
2986,15,BABE01001528.1/194-88,UAGCGAAGUAGGAUUUUAUGCGUCAAGUGUUCACAGGCUGGGGAGUCGCCGUGAAACGAAAAGCAGAAAGCGUGCUGCUUACGAUAUAAUUUCCGCACCCGUUGCUA,29,26,30,22,107
2987,15,BABD01033677.1/236-329,CAGAGUAGGAACAGCGCGUCAAGUGCGUCGGGAUGGGAAGUUGUCCGGCGACGAAGGGGCUGCGCGCCCCGCGGUGCUGUUGCCGCUUCCGCUG,14,16,38,26,94
2988,15,BAAZ01000245.1/2377-2470,GGGAGUAGGAACUGUGCGUUAAGUACCGGUCGGAUGGGAGGUUGCCGCCGGGCGAAGGAGCUUCGGCUCCGCGAUACGGUUACCGCAACCGCCU,17,17,36,24,94
2989,15,BAAZ01020636.1/794-894,UUUAGAGUAGGAAAUAAAUAGUAAAGACUUAAUAAACGGGGAAGUUGUUAUUAGGGCNAAUAAAUAUUUUUAUGCCUUAUUAUUUUCGCAUUCCGCUAAGA,36,35,19,10,101
2990,15,BABA01028836.1/106-1,CAGAGUAGGGUAGAUGCGUGUACAUUAGUCUACAGUGUCUGAGGACGGGGACGUGACCUCGGAACGAAUGGCGAAAGCCUACGAUAUUUUACCCGUCGUCCGCUGC,25,24,33,24,106
2991,15,AAPZ02000001.1/1062273-1062367,UGGGGUAGGAAUCUCAGAGUUAUUGUCUAACGGAACGGAAUGUGAACGUUAGAAGGAGGCUAAUGACUAGCUGCUUUGUUAUUCCGCAUUCACCA,26,27,26,16,95
2992,15,AACY023280528.1/886-799,CAGAGUAGAUAGGAAGCAUUAAGUGUUAAGAAAUGGGUUGUUGUUCUUAAACGAAGCAUAUCGCUAUGAUUUUCUGUCGCAACCGCUG,26,27,22,13,88
2993,15,CP001098.1/71606-71705,GGCAGAGUAGGUGGCUAUGCGUAAAUAGUGCUUAAGGAUGGGACGUUGCCUUAAGACGAAAUGCCUAUCAGGCUGCGGUAUAGCCACCGCGUCCGCUGUC,23,23,32,22,100
2994,15,ABAW02000025.1/72799-72896,AGCAGAGUAGGAUAGGAAGCGUUAAGUAUCUUCUGAACGGGGAGUUGUCAGAAGGGCGAAAAGAUUUUCUUGCGAUUUCUUAUCCGCAUCCCGCUGUU,25,28,28,17,98
2995,15,AE015927.1/1800312-1800211,GUUAGAGUAGGUGAUUGCGCGUGAAGUGCUAGUUGGAUAGGAUGUUGCCACUAGACGAAAAAAUCUUUUGGAUUUUGCGAUGCAUAUACCGCUUCCGCUAAC,26,31,28,17,102
2996,15,ABEE02000015.1/221133-221224,GGCAGAGUAGGAAACUUGCAUUAAGUGUUACAAGAUGGGAUGUUGCUUGUAAACGAAGAGAUUUCUCGUGGUUAGUUUUCGCAUCCACUGUU,24,30,25,13,92
2997,15,CP000422.1/1424554-1424642,UGGAGUAGGAAUCGAUGCGUUAAGUGCCAACAAGACGGAGAGUUGCUUGUUGGACGAAUGCUUGUCAGCGAUAUCGAUUCCGCAUCUCG,22,23,27,17,89
2998,15,CR936503.1/348925-349019,CGGAGUAGGGAUUAAAGCGUUAAGUGCUGGUGGAACGGAAUGUGAACACCAGACGAAGAGCAGUAAUGCUCGCGGUUUUAGUCCCGCAUUCGCCG,25,20,31,19,95
2999,15,CP000414.1/123971-124060,GGGUAGAUUGAUGCGCGUUAAGUGCAGCGGAGACGGAAUGUGAGCCGCUGACGAAACAAACAUUCAUUGCUAGCAUUUUUUCGUGUUAGC,23,24,27,16,90
3000,15,ABDQ01000031.1/13491-13593,GGCAGAGUAGGUAUUUGUGCGUUAAGUGUCAGUGGAACGGGAAGUUGUCCAUUGAACGAAAAAUGAAUUUUCAUUUGCGGUGCAUAUAUCGCAUUCCGCUGCC,26,31,29,17,103
3001,15,AAQK01002842.1/285-380,ACAGAGUAAAAAUAUGUGCGUUAAGUGCCUUUAACACGGGGAGUUGGUUAAGGAACGAAAAGUUAUUCUUGCGGUACAUAUUUUGCAUCCCGCUGU,28,29,24,15,96
3002,15,CP000724.1/4463946-4464038,GGCAGAGUAGGUGUUAUGCGUUAAGUGUUAGGGGAUGGGAAGUUGCUCCUAAACGAAGAACUCAUUUCGCGAUAUAACACCGCGUCCACUGUC,24,24,27,18,93
3003,15,BABG01026548.1/656-558,GACAGAGUAGGUUAACGUGCGUAAAGUGCCUGAGGGACGGGGAGUUGUCCUCAGGACGAACACUGAAAGGUGGCGGUACGUUUUCCGCAUCUCGCUGUU,22,23,34,20,99
3004,15,CP000939.1/904743-904843,AACAGAGUAGGUAAUUACACGUUAAGGUUUAGAGGACGGGAAGUUGUCUCUAAAAGAAAAAUCUUUAAAAGAUUUGCGAUGUGUUACCGCAUUCCGCUGUU,33,30,24,14,101
3005,15,AAQL01011279.1/614-718,AGCGAAGUAGGAUUUUAUGCGUCAAGUGUUCACAGGCUGGGGAGUCGCCGUGAAACGAAAAGCAGAAAGCGUGCUGCUUACGAUAUGAUUUCCGCACCCGUUGCU,27,25,31,22,105
3006,15,ABCC02000039.1/266095-266205,GCAGAGUAGGUAUAUGUGCGUUAAGUGCCGGCUGGACAGGGAGUUGUCAGCUGGACGAAAGAGGAUUCCCAAAGGGAAACUGUCUGCGGUACAUAUGCCGCAUCCCGCUGC,27,23,37,24,111
3007,15,AAYG02000031.1/153078-152980,AGCAGAGUAGAAGUAUGUGCGUUAAGUGCCGGUUGGACGGGGAGUUGCCAGCAGGACGAAAAGUGAAUGCUUGCGGUACAUAUUUCGCAUCCCGCUGCU,24,23,33,19,99
3008,15,AAQK01008307.1/175-79,AACAGAGUAAGACCCUGCGCGUUAAGUGCCGCAUCAACGGGGAGUUGUGCUGCGGACGAAGGUAUUGACCGCGGUGCAGGGUCUGCAUCCCGCUGCU,20,19,33,25,97
3009,15,CP000382.1/1647712-1647607,GGCAGAGUAGGUAUUUGUGCGUUAAGUGUCAUUGGAACGGGAAGUUGUCCAUUGAACGAAAAAUGAAUUUAUUUCAUUUGCGGUGCAUAUAUCGCAUUCCGCUGCC,27,34,28,17,106
3010,15,AAQK01002704.1/947-835,UGCAAAAUAGGUUUCCAUGCGUCAAGUGUUUUGUGGAUGGGGAGUUGCCACAGAAACGAAAAGUCGGUUCGCGUGCGGACCGGACUUACGAUAUGGUUACCGCACCCGUUGCA,27,28,34,24,113
3011,15,CP000853.1/2619446-2619544,CAGAGUAGAUAUUGCGCGUUAAGUGUUGAAGGAUGGGAAGUUGCCUUCAAACGAAAAAUAGUACCAUGUACUAUUUGCGGUGCAAUAUCGCAUCCGCUG,29,27,26,17,99
3012,15,CP000407.1/125748-125890,ACAGAGUAGAUGGUUUGCGUCAAGUGUAUGUGGAUGGGGUGUUGCCACAUAACGAAGCUGAUCUUUGCUUGCAUCUGAUGUCUCCUAGAGUAGGAACAUUGGUCCUGGCUGAGAGUAGCGCGGUAAACCAUUGCAUCCGCUGU,32,41,43,27,143
3013,15,CP000423.1/2247840-2247748,UAGGAGUAGGAACCUGCGCGUUAAGUGCUGCCGGAACGGAAUGUGAACGGCAGACGAAGACAAGUGUCGCGGUGCAGGUGCCGCAUUCGCCUG,22,16,34,21,93
3014,15,CP000724.1/4839802-4839709,GACAGAGUAAAUAAUAUGCGUAAAGUGUCAAAGGAUGGAACGUUGUAUUUGAACGAAGAGCAAAUGCUUGCGACAUAUUAUUGCGUUCGCUGUU,31,27,24,12,94
3015,15,CP000673.1/3903929-3904044,AGCAGAGUAGAACGUUGUGCGUAAAUCAUUGAUUUGCAGUGCCUUCUGAACGGGGAGUUGUCAGAGGGACGAAAAGCCUUUUAGGGCUUACGGUACAAGGUUCGCAUCCCGCUGCU,28,30,35,23,116
3016,15,AAVO02000004.1/164832-164736,UGCAAAAUAGGAUCAUAUGCGUCAAGUGUUCAGCGAAUGGGGAGUUGUCGCCGAAACGAAAAGUCCGUCUUACGGUAUAUGAUCCGCACCCGUUGCA,27,23,26,21,97
3017,15,AE001437.1/2534636-2534729,AGCAGAGUAGAUAUUGUGCGUCAAGUGUUAGAGGAUGGGAAGUUGUCUCUAAACGAAAAGCUUAGUCUUGCGGUUCAAUAUCGCUUCCGCUGUU,24,29,26,15,94
3018,15,AP007281.1/1983266-1983360,UGGGGUAGGAAUCUCAGAGUUAUUGUCUAACGGAACGGAAUGUGAACGUUAGGAGGAGGCUUAUAACUAGCUGCUUUGUUAUUCCGCAUUCACCA,25,28,26,16,95
3019,15,AAQK01005422.1/60-187,GGCAGAGUAAGCUUCCGUGCGUGAAGUGCCGAGUGGACAGGGAGUUGUCACUCGGACGAAGAGACAGGAAGGCGAUGAGUCUGUCAUCGCCAUCCCGUCUCGCGGUACGGAAGCUGCAUCCCGCUGCU,27,24,44,33,128
3020,15,ACHL01000137.1/17495-17397,UACAGAGUAGAAAAUAAAGCGUUAAGUGCUAAGAGGAUGGGAUGUUGCCUCUUGGACGAAGGACGUAAUGUUCGCGGUUUUAUUUUCGCAUUCGCUGCA,27,29,28,15,99
3021,15,AP009049.1/1524197-1524313,AGCAGAGUAAAUAUUAUGCGUAAAGUGUUAGAGAAUGGGAGGUUGUCUCUAAACGAAAAGCUUAAAUACUUGUUAUAUAAGAUUUAAAGCUUACGAUAUAAUAUUGCUUCCGCUGUU,41,39,24,13,117
3022,15,CP000233.1/1666649-1666554,GGGGUAGGAAUCCUUGCGUAACGGACUAAUGGAACGGAAUGUGAACAUUAGUAGAUUAAGUCCGAUAUGACUUAGCGUUUGGUUUCCGCAUUCACC,26,27,26,17,96
3023,15,AAQK01006702.1/2245-2148,GCAGGAUAGUUGCUUCGGACUCAGUGCUCCGGGGACGGGGAGUUGUCCCGGGGACGAAAAGCCAGAUGGCUUACGGUGCGGCAUCCGCAUCCCGCUGC,17,18,36,27,98
3024,15,CP000416.1/852209-852116,CGGAGUAGGAAAUAAAGCGUCAAGUGCCGGUGGAACGCAAUGUGAACACCGGACGAAGGGCAAUUGGCCCGCGAUUUUAUUUCCGCAUUGGCCG,25,18,30,21,94
3025,15,CP001348.1/1695232-1695339,GGCAGAGUAGAUUUUUGUGCGUUAAGUGCCGGAAGGACGGGAAGUUGCCUUUCGGACGAAAAACAAUAAUUUUUAUUGUUUGCGGUACAAAUAUCGCAUUCCGCUGCC,28,32,29,19,108
3026,15,CP000727.1/864723-864823,AACAGAGUAGGUAAUCACACGUUAAGGUUUAGAGGACGGGAAGUUGUCUCUAAAAGAAAAGUCUUUAAAAGAUUUGCGAUGUGUUACCGCAUUCCGCUGUU,32,29,25,15,101
3027,15,AAXG02000014.1/43071-43187,GGCAGAGUAGGAGCGCGUGUGCAGUACCUCGCAAGGGGUCCAGUGCCGGCGGGACGGGGAGUUGUCCGCCGGACGAAAAGCCACAGGCUUGCAGUACGCCCUCCGCAUCCCGCUGCC,21,16,43,37,117
3028,15,ABGD02000012.1/179260-179163,GGCAGAGUAGGAACCGGCGCGUUAAGUGCCGCCUGAACGGGGAGUUGUCAGGCGGACGAAAAGAGUUUCUUGCGGUGCCGGUUUCGCAUCCCGCUGCU,18,20,36,24,98
3029,15,ABFY02000012.1/69214-69315,AGCAGAGUAGGAAAACGUGCGUUAAGUGCCAGCCGGACGGGGAGUUGCCGGCGGGACGAAAAGUAAGGAUUACUUGCGGUACGUUUUUCGCAUCCCGCUGCU,24,21,35,22,102
3030,15,ABWO01000186.1/26189-26089,AGCAGAGUAAGAGUAUGUGCGUUAAGUGCCAGUUGGACGGGGAGUUGCCAGUCGGACGAAAAGCAAAAUUGCUUGCGGUACAUACUCUGCAUCCCGCUGCU,26,23,31,21,101
3031,15,ABYI02000015.1/33605-33505,AGCAGAGUAGAGAUGUGUGCGUUAAGUGCCAGCCGGACGGGGAGUUGCCGGCAGGACGAAAAGCCUGGAAGCUUGCGGUACAUAUCUCGCAUCCCGCUGCU,23,19,35,24,101
3032,15,ABVQ01000035.1/347941-347845,AGCAGAGUAGAAUUUUGUGCGUUAAGUGCUGAGUGAACAGGGAGUUGUCAUUCGGACGAAAAGAUUUCUUGCGGUACAGAAUUCGCAUCCCGCUGCU,25,27,28,17,97
3033,15,CP001078.1/2874589-2874491,GACAGAGUAGAUAUUUGCGCGUUAAGUGUUAAGAGGACGGGAAGUUGCCUUUUAAACGAAAAACUUUUGUUUGCGGUGUAAAUAUUGCAUUCCGCUGUU,27,33,26,13,99
3034,15,ACCJ01000114.1/2562-2664,UGCAGAGUAGGUUUAUGCGCGUUAAGUGCCGGCUGAACAGGGAGUUGUCAGCUGGACGAAAAGGGAAUCAUCCCUUGCGGUGCGUAGGCCGCAUCCCGCUGCA,22,22,35,24,103
3035,15,ACEC01000113.1/20426-20527,AGCAAAGUAGACAUUUGCGCGUUAAGUGUCCGAUGAACGGGGAGUUGUCAUCGGAACGAAGGGAAGUUUCUUCCUGCGGUGCAAAUGUUGCAUCCCGUUGCU,24,27,31,20,102
3036,15,ACOK01000004.1/41711-41613,UGAAGAGUAAAAAUGCGUUCGUUAAGUGUUGACUGAACGGGGAGUUGUCAGUCAAACGAAAAGCUUCGGCUUGCGGUUCGUAUUUUGCAUCCCGCUUCA,25,29,27,18,99
3037,15,ABQR01000045.1/213424-213528,AGCAGAGUAGGCAUAUGUGCGUUAAGUGCCGGCUGAACAGGGAGUUGUCAGCUGGACGAAAGGAACCUUCGGUUUCCUGCGGUACAUAAGCCGCAUCCCGCUGCA,25,22,33,25,105
3038,15,ACIN02000021.1/2207-2306,AGCAGAGUAGAAAAUCUAGCGUAAAGUGCCAGCCGGACGGGGAGUUGCCGGCAGGACGAAGAGUUAAAUGCUCGCGGUGAGGUUUUCGCAUCCCGCUGUU,25,20,34,21,100
3039,15,ACAO01000008.1/73651-73753,AUCAGAGUAGGAAAUAAAGCGUUAAGUGCUGAAAGGAUGGGAUGUUGCCUUUCGGACGAAGAACGAUCAUUCGUUCGCGGUUUUAUUUUCGCAUUCGCUGCAU,27,31,28,17,103
3040,15,ACIP02000001.1/94372-94274,UGCAGAGUAGAAACCACGGCGUUAAGUGCCUCCUGAACAGGGAGUUGUCAGUGGGACGAAGAGGGGAUCCUCGCGGUCAUGGUUUCGCAUCCCGCUGCU,21,21,33,24,99
3041,15,ACAJ01000006.1/70988-71087,AUCAGAGUAGGAAAUAAAGCGUUAAGUGUCGAAAGGAUGGGAUGUUGCCUUUUGGACGAAGAACGAUUCGUUCGCGGUUUUAUUUUCGCAUUCGCUGCAU,26,31,28,15,100
3042,15,ACCF01000156.1/25104-25200,AACAGAGUAGGUUCCUGCGCGUUAAGUGCUUUCUGAACGGGGAGUUGUCAGAAGGACGAAAAGGUUUCUUGCGGUGCAGGUUCCGCAUCCCGCUGAC,21,24,31,21,97
3043,15,ACJM01000014.1/36600-36692,UGCAGAGUAGGUGGCAUGCGUUAAGUGCUAAGGGAUGGGAAGUUGCCCUUAGACGAAAGGUUUAUCCUGCGAUAUGUCACCGCAUCCACUGCC,22,23,28,20,93
3044,15,ABIL02000006.1/201569-201478,CGCAGAGUAGAUAAGAUGCGUUAAGUGUUAAAGGAUGGGAAGUUGCCUUUAAACGAAAACGAAAGUUGCGGUAUCUUAUUGCGUCCGCUGUG,27,25,27,13,92
3045,15,ACBZ01000165.1/18004-18100,UGCAAAAUAGGAUUUCAUGCGUCAAGUGUUCAGUGGAUGGGGAGUUGCCGCCGAAACGAAAAGUACGUCUUACGAUAUGAGGUCCGCACCCGUUGCG,25,23,29,20,97
3046,15,ACKX01000080.1/10519-10620,UGCAGAGUAGAGAAUAAAGUGGUUAGUGCCCGACACACAGGGAGUUGGUGUCGAGACGAAGAGCCGAAUCGGUUCCCAGUUUUAUUUUCGCAUCCCGCUGCC,25,24,30,23,102
3047,15,ACKZ01000029.1/132325-132227,AUCAGAGUAGACUUUAUUGCGUUAAGUGCCCGGAGGAUGGAAUGUUGCCACUGGGACGAAAAUGGAAACAUUGCGAUAAUUUAGUCGCAUUCGCUGCAU,28,27,27,17,99
3048,15,ACIL02000003.1/15754-15855,ACCAGAGUAAGAAAAGAAGCGUUAAGUGAUAGCGAGAUGGAAUGUUGCUCCUAUACGAAAAAAUGCUGGACAUUUUGCGGUUUCUUUUCUGCAUUCGCUGCA,31,29,25,17,102
3049,15,ABHH01000004.1/97682-97579,AUCAGAGUAGGAAAUAAAGCGUUAAGUGUCGCUGGGAUGGGAUGUUGCCCGCGAACGAAAGAUUGUUUAGGCAAUUUGCGGUUUUGUUUCUGCAUUCGCUGCAU,25,32,31,16,104
3050,15,CP001034.1/2651359-2651454,GGUAGAGUAGGUGUCUCGCGUUAAGUGCCAAGGGAUGGGACGUUGCCCUUGGACGAAAGCUAUUAAGAGCUGCGUUGGGACAUCGCGUUCGCUAUC,20,24,33,19,96
3051,15,AM946015.1/1244497-1244587,GACAGAGUAGAUGGUUUGCGUUAAGUGUAUGUGAAUGGGAUGUCGUCACAUAACGAAGCUUAUUGCGCGGUAAAUCAUCGCAUCCGCUGUU,23,27,26,15,91
3052,15,ABJK02000016.1/18473-18563,CACAGAGUAGAUGAUUCGCGUCAAGUGUGUGUGAAUGGGAUGUCGUCACACAACGAAGCAAUUUGCGCGGUGAAUCGUUGCAUCCGCUGUU,22,24,27,18,91
3053,15,ACGC01000009.1/96239-96150,AUCAGAGUAGAUAAAGAGCAUUAAGUGUUAGGAAAUGGGUUGUUGUUCCUAAACGAAGCGAAUGCGUGAUUCUUUAUCGCAACCGCUGCC,27,25,23,15,90
3054,15,AP008971.1/956558-956470,AACAGAGUAGGGUUGAUGCGUUUAGUGUAAUGGGAUAGGGAGUUGCCCAUUAACGAAAUCAUUGCGAUAUCAAUGCCGCUUCCGCUGAU,24,25,25,15,89
3055,15,DQ489736.1/97227-97326,GGGUAGAUAGUUGUGCGUUAAGUGUGAAGGAAACGGAAUGUGGGCCUUCAACGAAAUGUUUUCGAUAUUGAAAACGUGCGAUGCAACUGUCACAUUCACC,29,27,28,16,100
3056,15,ACLL01000013.1/10304-10210,GUUGGGGUAGGAACUCCAGAGUUAUUGUCCAGCGGAACGGAAUGUGAACGCUGGAAGGAGGCCGCAGGGCUGCUUUGGUUUUCCGCAUUCACCAC,20,22,32,21,95
3057,15,ACGV01000122.1/3906-3812,UGUUGGGGUAGGAAUUACCGAGUUAUUGUCCAGCGGAACGGAAUGUGAACGCUGGAAGGAAGUAUUAGCUGCUUGAUAAUUUCGCAUUCACCACA,26,26,27,16,95
3058,15,ACGH01000132.1/62035-62149,UAUGGGGUAGGAAACAAUGCGUUAAGUGUUGAAGGGACGGAAUGUGACCUUCAAACGAAAACCAAUCGGCUUCGACUUGCUGAUUGGUUGCGGUGUUGUUUUCGCAUUCGCCAUU,28,34,33,20,115
3059,15,ABYO01000283.1/48498-48413,AUCAGAGUAGAUAAAGAGCGAUUAGUGCUGGAAAAUGGGUUGUUGUUUCCAGACGAAACUUCCGAUUCUUUAUCGCAACCGCUGAC,25,24,21,16,86
3060,15,ACIQ02000013.1/140241-140142,CGCAGAGUAGAGAUCCGAGCGGUAAGUGUCCUCGAACGGGGAGUUGACGAGGAACGAAGCUGAGAGCCUCAGCGCGGUUCGGAUCCCGCAUCCCGCUGCG,22,15,36,27,100
3061,15,ABWK02000009.1/209906-209808,AGCAGAGUAGGUGUUUAUGCGUUAAGUGCCGGGUAUACGGGGAGUUGAUAGCCGGACGAAAGCCAUCAGGCUGCGGUGUAAGCAUUGCAUCCCGCUGCU,22,23,34,20,99
3062,15,ACTV01000001.1/67473-67374,UGCAGAGUAGAUUUGUAUGCGUAAAGUGCCCUCUGGAUAGAGAGUUGCUGGAAGGACGAAAAGGUAAAUCUUACGGUGUACAAACUCGCAUCUCGCUGCA,29,25,28,18,100
3063,15,AP012027.1/393698-393787,AGCAAAGUAAAUGACACGCGUUAAGUGCAUACAGAUGGGAAGUUGCUGUAUGACGAAGCGAAAGCGCGGUGUGUUAUUGCGUCCGUUGCG,25,21,29,15,90
3064,15,ACGS02000005.1/10939-11039,ACAGGGGUAGGAAGUCCUGCGUCACGGGCUGACGGAACGGAAUGUGAACGUCAGCAGAAAGGUCCUGUCAUUGGCCUGCGUGGUUCUUCCGCAUUCACCAU,22,22,32,25,101
3065,15,ACBY02000010.1/41255-41369,UGCAGAGUAGGGAUCCGCGCGUGGGGCAGUGGCCCCGAAGUGCCUGACCGACGGGGAGUUGUGGCAGGACGAAGUGACCGGAAGGUCCGCGGUGCGCAUCCCGCAUCCCGCUGCU,19,17,46,33,115
3066,15,FP929037.1/1870907-1871006,CGCAGAGUAGGGGAGCAGGCGUUAAGUGCCGGAUGGACAGGGAGUUGCCGUCCGGACGAAGAAGGAAACCUUCGCGGUCUGUUCCCCGCAUCCCGCUGCA,21,16,36,27,100
3067,15,ABYJ02000297.1/736-845,AGCAGAGUAGAACUCUGUGCGUUAAGUGCCAUGUGAACAGGGAGUUGUCACACGGACGAAAAACAAAAGCGCUGCUUUUGUUUGCGGUACAGAAUUCGCAUCCCGCUGCU,30,26,30,24,110
3068,15,ACHM02000003.1/346335-346246,UACAGAGUAGGGUUGAUGCGUUUAGUGUAAUGGGAUAGGGAGUUGCCCAUUAACGAAAUUAUUGCGAUAUCAAUGCCGCUUCCGCUGAUA,24,27,25,14,90
3069,15,AP010655.1/1460325-1460413,ACAGAGUAGAUGAUUCGCGUUAAGUGUGUGUGAAUGGGAUGUCGUCACACAACGAAGCCAUAAGCGCGGUGAAUCAUUGCAUCCGCUGU,24,22,26,17,89
3070,15,ACCL02000010.1/116901-116811,AGUAGAGUAGGUCUUAUACGUAAAGUGUCAUCGGAUGGGGAGACUUCCGGUGAACGAAGGGUUACCGCGUUAUAUGACCGCUUCCGCUACU,22,24,27,18,91
3071,16,CP002582.1/3780440-3780356,UUAAUGAGAAUAAAUCAGGUUAUUAUGUUGGAUGUAAUAACUGGGCCAAUUUAUUGGCAACAGGAAUUAAACCUGUGGGACUAUA,30,27,19,9,85
3072,16,CP001997.1/495019-495096,UCCUUACAAGAUCAGGCGGCUUUUAGUGCGGCCGGGCCUCUUUUGAGGCAGUGGGAUUUCAAGACUCGCGGGACUUAG,14,21,25,18,78
3073,16,CP002028.1/1768652-1768573,AAAGCAUAAUGGAUCAGGUAGAACGGAAAAGUUUUACCGGGCUCUUAUGAGCAGCAGGAUUAUAAACCUGUGGGACCGUG,26,18,23,13,80
3074,16,AAWL01000017.1/25112-25035,AUAAUACAACAGGAACAGGCGGCUGCCGCGAGGCAGUGCAGCCGGGCGUUUGCAGCAGAAAGGCUCUGCGGGACCUGC,19,10,28,21,78
3075,16,ADLR01000090.1/3100-3003,AUAUGAUACAGUGAGCAGGCGACGGCCGAAAUGAGAAUCGUCGCCGGGCUGCCGAAAGGCGGCAGCAGACUGUGUGACAGCACAUCUGCGGGACAGUU,26,15,34,23,98
3076,16,ACCJ01000322.1/14085-13994,AUGGCAUAAAGGAAACAGGCCGCGGGCGGCAGCGCGCGGGCCGGGCCGCAUUAGCGGCAGCAGGUGGAUCAGGCGGCAUCUGCGGGACAAUG,20,9,39,24,92
3077,16,AGTN01503842.1/168-240,AUAGCUCUUAAGGAUCAGGCGGCAAAGGCGUGCAGCCGGGCACUAUGCAGCAGGGAAGACCUGUGAGACCUUA,20,12,24,17,73
3078,16,AGTN01590760.1/12-115,UAUGCAUUAACAGAGCAGGCGAUGCAUCUGAAAUUUAUGUUUCAGAUAUGUGGGGCUGGGCCGGGCUAUCUGCCGGCAGCAGGUAUAUAACCUGUGGGACUGAU,25,28,32,19,104
3079,16,CP001684.1/2164884-2164979,CCAUCCCAUUCUGAACAGGCCGUGGCAAUACCAUGGAGCCGGGCCGGCCCAGCCGGCAGCGGAGCGUUUGCACGUUGGCGCGCCCGCGGGACAGAA,18,12,33,33,96
3080,16,ADFP01000095.1/5329-5413,ACGGCACAAACUGAACAGGCCGUCCCCUCGGGGAGCGGGCCGGGCCGCCGCGGCGCGGCAGCGGACGACGAUCCGCGGGACGGAA,16,4,35,30,85
3081,16,AEDB01000024.1/46397-46304,AAUAUAAAAAUAGAGCAGGCGAUACACCUAAUAAGGUGUGUGGGGCUGGGCCGACGAAAGUUGGCAACAGGUGAAAAAUACCUGUGGGACUAUA,34,18,28,14,94
3082,16,ADGC01006520.1/5852-5937,UAACUUUGAACUGAGCAGGCAAUGCAGCGCAUGAGGCCGGGCCCGAGAGGCAGCAGAUUGAAACAACAAACAUCUGCGGGACAGUA,28,12,26,20,86
3083,16,ABQR01000046.1/117420-117521,ACAGUACAAUCUGAUCAGGCCUUAAAGUGGAUGGAACGGAACAUCCAUGGAGGAGCCGGGCCGCUUUAGCGGCAGCAGGUAGGAAACACCUGCGGGACAGUC,29,16,33,24,102
3084,16,ACTP01000040.1/119838-119957,ACAGUACAAACUGAGCAGGCUGUGUUUUCUGCCGGCGUAUGUAUUUCAAGCCGGAAAGGAUCCAUGGAUAGCCGGGCCGUUUUGACGGCAGCAGAUGGAGCUUACAUCUGUGGGACAGUA,29,29,37,25,120
3085,16,AEVN01000015.1/26987-27081,ACAGUACAAACUGAUCAGGCGGUAAACCUUCUUCCGGGUUUUUGCAGCCGGGCCCUCUGGGCAGCAGACCUUGACGCAACGUCUGCGGGACAGUU,20,21,27,27,95
3086,16,AEDB01000052.1/16213-16310,ACAGUACAAUCUGAUCAGGCGAUGAAUGCGAAUUCAUGGUGCCGGGCUGCUUCAAAUAGCGGCAGUGGGUGAGUGAUACACACAUCUACGGGACAGUA,28,21,29,20,98
3087,16,CP002109.1/2377684-2377591,ACAGUACAAACUGAACAGGCGAUAGCGAUCUUAGCUAUAGGGCCGGGUUGCCGGGGGCGACAACGGAUGACUUUCGUGCAUCUGUGGGACAGUA,24,19,31,20,94
3088,16,FR667692.1/20575-20683,UCAUUGUGAUCUGAACAGGCGGUGAACGUAACACGAGGUUCAUGCAGCUGGGCUGCAAUUAUUUGCGGCAGCAGACUAUGUAUUCUAAGGGCAUAUCUGUGGGACAGUU,27,30,32,20,109
3089,16,CP001603.1/69513-69621,UCAUUGUGAUCUGAACAGGCGGUGAACGUAACACGAGGUUCAUGCAGCUGGGCUGCAAUUAUUUGCGGCAGCAGACUAUGUAUUCUAAGGGCAUAUCUGUGGGACAGUU,27,30,32,20,109
3090,16,FR667693.1/43791-43683,UCAUUGUGAUCUGAACAGGCGGUGGACAUAUAAAAGGUCCAUGCAGCCGGGCUGCAAUUUUUGCGGCAGCAGAGUAUGUAAAUAAUAAGGGCAUACCUGUGGGACAGUU,31,27,32,19,109
3091,16,ACHL01000004.1/2975-2867,UCAUUGUGAUCUGAACAGGCGGUGGACAUAUAAAAGGUCCAUGCAGCCGGGCUGCAAUUUUUGCGGCAGCAGAGUAUGUAAAUAAUAAGGGCAUACCUGUGGGACAGUU,31,27,32,19,109
3092,16,ACCR02000006.1/49989-49881,UCAUUGUGAUCUGAACAGGCGGUGGACAUAUAAAAGGUCCAUGCAGCCGGGCUGCAAUUUUUGCGGCAGCAGAGUAUGUAAAUAAUAAGGGCAUACCUGUGGGACAGUU,31,27,32,19,109
3093,16,ADDX01000036.1/19553-19630,GCGCCCCAUACGGAACAGGCCGUAAAGGAGCCGGGCCGCUGCGGCGGCAGCAGAUGGUGAGGCAUCUGUGGGACAAAA,19,8,30,21,78
3094,16,ABYI02000012.1/66005-65911,GCGGUACAAACUGAGCAGGCGAUGGAUCUUGUGUGAUCAGGUCCGUGGGGCCGGGCCGUUUUCGGCAGCGGAUGCAUGGCAUCCGCGGGACAGUA,17,19,37,22,95
3095,16,AEXQ01000083.1/43353-43249,ACAGUACAAACUGAACAGGCAGCGACUAAGUCGUGUGGCCGGGUUGCUUAGCAACAGCAGAUUUAAUUAUUCAUAUUGAUGAUAAUUAACAUCUGUGGGACAGUA,34,28,25,18,105
3096,16,ADMN01000037.1/5181-5285,ACAGUACAAACUGAACAGGCAGCGACUAAGUCGUGUGGCCGGGUUGCUUAGCAACAGCAGAUUUAAUUAUUCAUAUUGAUGAUAAUUAACAUCUGUGGGACAGUA,34,28,25,18,105
3097,16,ADJS01006913.1/2727-2603,GCAGUACAAACUGAUCAGGCUACAUUCAUUUUCAAAAAGAUGAUGUUAAGAAAAUGGUGUGCAUGCCGGGCCGGUCAAUUACCGGCAGCAGAUGAGACGAUGAUUCAUACAUCUGUGGGACAGUA,40,30,32,23,125
3098,16,AAXB02000001.1/302330-302454,GCAGUACAAACUGAUCAGGCUACAUUCAUUUUCAAAAAGAUGAUGUUAAGAAAAUGGUGUGCAUGCCGGGCCGGUCAAUUACCGGCAGCAGAUGAGACGAUGAUUCAUACAUCUGUGGGACAGUA,40,30,32,23,125
3099,16,ACIE02000035.1/129003-128921,ACAGUACAGACUGAUCAGGUCAUAAGACCGGGCUGUUAAAAAAACAGCAGCAGAUGAAAUUAACAGCAUCUGUGGGACAAGUG,32,15,21,15,83
3100,16,ACDH01000075.1/27393-27312,ACAGUACAGACUGAUCAGGUCAUAUGACUGGGCUGUUAAAAAACGGCAGCAGAUGAAAUCAACAGCAUCUGUGGGACAAGUG,29,16,22,15,82
3101,16,AAXG02000045.1/2452-2549,ACAGUACAAACUGAGCAGGCCACGGAUUCCUCUGGAAUCCAUGGAGCCGGGCCGCAGUUGCGGCAGCAGAUGAUCUCCUGUACAUCUGUGGGACAGUU,23,20,29,26,98
3102,16,AGTN01644247.1/468-372,ACAGUUCAAGGUGAGCAGGCGAUGAACCCUCCGGGGUUCGUGGGGCCGGGCCGUAAAAUCGGCAGCAGAUUGUUCAACACACAUCUGUGGGACUUUA,23,20,31,23,97
3103,16,ACIO01000756.1/6332-6236,ACAGUACAAACUGAGCAGGCAAUGUCUGAUCAUGCGACAUGAAGCCGGGCCGCUUCGGCGGCAGCAGAUGGGUAUCAGGCGCAUCUGUGGGACAGUA,25,17,32,23,97
3104,16,BABF01002650.1/1069-975,ACAGUACAAACUGAGCAGGCAAUGUCUGUAAAUGACAUGAAGCCGGGCCGUCGAGACGGCAGCAGAUGGGUAUCAGGCGCAUCUGUGGGACAGUA,28,16,31,20,95
3105,16,AEDB01000020.1/61018-61119,ACAGUACAAACUGAUCAGGCGAUAAACCCCAAAUUUUAAGGUUUAUGCAGCUGGGCCAUAAACGGCAGCAGAUGAAAAAUAUAACACAUCUGUGGGACAGUG,38,21,23,20,102
3106,16,ACTJ01000082.1/4659-4566,ACAGUACAAACUGAGCAGGCAAUGACCAGAGCGGUCAUGCAGCCGGGCUGCGAAAGCGGCAACAGAUGAUUACACGCACAUCUGUGGGACAGUU,29,14,28,23,94
3107,16,FP929053.1/1847000-1846820,ACAGUACAAACUGAGCAGGCGAUGCUUUUCGGAAUCGAAAAUAUUUAUCGAAGGCAUGGGGCCGGGCCGCAGGAAGCGGCAGCGGAUAUGGAUUUAAACGUAAUUGCAAAGAACCUGCAUUCACGGAAUAUGAGGUGAAGCAGAAUGUGACUUUGCUUUCAGACAUAUCUGCGGGACAGUG,55,40,53,33,181
3108,16,ADJT01012376.1/11594-11414,ACAGUACAAACUGAGCAGGCGAUGCUUUUCGGAAUCGAAAAUAUUUAUCGAAGGCAUGGGGCCGGGCCGCAGGAAGCGGCAGCGGAUAUGGAUUUAAACGUAAUUGCAAAGAACCUGCAUUCACGGAAUAUGAGGUGAAGCAGAAUGUGACUUUGCUUUCAGACAUAUCUGCGGGACAGUG,55,40,53,33,181
3109,16,BABE01011344.1/446-627,ACAGUACAAACUGAGCAGGCGAUGCUUUUCGGAAUCGAAAAUAUUUAUCCGAAGGCAUGGGGCCGGGCCGCAGGAAGCGGCAGCGGAUAUGGAUUUAAACGUAAUUGCAAAGAACCUGCAUUCACGGAAUAUGAGGUGAAGCAGAAUGUGACUUUGCUUUCGGACAUAUCUGCGGGACAGUG,54,40,54,34,182
3110,16,BAAV01020169.1/36-217,ACAGUACAAACUGAGCAGGCGAUGCUUUUCGGAAUCGAAAAUAUUUAUCCGAAGGCAUGGGGCCGGGCCGCAGGAAGCGGCAGCGGAUAUGGAUUUAAACGUAAUUGCAAAGAACCUGCAUUCACGGAAUAUGAGGUGAAGCAGAAUGUGACUUUGCUUUCAGACAUAUCUGCGGGACAGUG,55,40,53,34,182
3111,16,AGTN01696258.1/1405-1313,ACAGUACAAACUGAGCAGGCGAUGAAUCAUAUACGAUUCAUGGAGCCGGGUCGCCCUACACGCGGCAGCAGAUACUGCAUCUGUGGGACAGUA,27,17,26,23,93
3112,16,ACII01000103.1/12160-12054,ACAGUACAAACUGAGCAGGCGAUGCCCGAGAUGCUUGAGGGCGUGGGGCCGGGCCGCGCGAAGCGGCAGCAGAUAUGAAAAUUUUCAGACAUAUCUGUGGGACAGUG,28,18,38,23,107
3113,16,BABE01016748.1/605-499,ACAGUACAAACUGAGCAGGCGAUGCCCGAGAUGCUCGAGGGCGUGGGGCCGGGCCGCGCGAAGUGGCAGCAGAUAUGAACAUUUUCAGACAUAUCUGUGGGACAGUG,27,18,38,24,107
3114,16,BABE01000339.1/4553-4659,ACAGUACAAACUGAGCAGGCGAUGCCCGAGAUGCUCGAGGGCGUGGGGCCGGGCCGCGCGAAGUGGCAGCAGAUAUGAACAUUUUCAGACAUAUCUGUGGGACAGUG,27,18,38,24,107
3115,16,ADJS01017039.1/13737-13800,ACAGUACAAACUGAGCAGGCGAUGCCCGAGAUGCUCGAGGGCGUGGGGCCGGGCCGCGCGAAGU,14,7,26,17,64
3116,16,AGTN01101874.1/525-623,ACAGUACAAAACUGAGCAGGCGAUGAACCUUUAAGGUUCGUGGGGCCGGGCCGCGUGAGCGCGGUAGCAGAUUGCGAGCGUCACAUCUGCGGGACAGUU,23,18,35,23,99
3117,16,AGTN01285523.1/140-242,ACAGUACAAACUGAGCAGGCGAUGAACCGCCGGAAGAUGGGGGUUCUGGGGCUGGGCCGCCGAGGCGGCAGCGGAUGAUGGGCGACACAUCUGCGGGACAGUG,23,13,43,24,103
3118,16,AGTN01307508.1/5-99,ACAGUACAAACUGAGCAGGCGAUGAACCUAAGCGUUCGUGGGGCCGGGCCGCUUUGGCGGCAGCAGAUCGUAAACACAGCAUCUGUGGGACAGUG,24,16,32,23,95
3119,16,CP002400.1/855172-855273,ACAGUACAAACUGAGCAGGCGAUGGAUCCUUUUGGGGUCUGUGGGGCUGGGCCGCUUUGGCGGCAGCGGGUUUGCAUCUUUGAUCACACCUGCGGGACAGUG,17,25,37,23,102
3120,16,ACTR01000042.1/628-533,ACAGUACAAACUGAGCAGGCGAUGAACCUUUAGGUCAUGGGGCCGGGCCGCUUUUGUGGCAGCAGAUUGCAAUUUCAGCACAUCUGUGGGACAGUU,23,23,29,21,96
3121,16,ABFY02000067.1/269385-269480,ACAGUACAAACUGAGCAGGCGAUGAACCUUUAGGUCAUGGGGCCGGGCCGCUUUUGUGGCAGCAGAUUGCAAUUUCAGCACAUCUGUGGGACAGUU,23,23,29,21,96
3122,16,CP000885.1/2639822-2639717,ACAGUACAAACUGAGCAGGCGAUGAACUUUAUUUCUAUAAAGUCAUGGGGCCGGGCCGCAAGAUGCGGCAACAGAUUGAAUUUCAAUUCACAUCUGUGGGACAGUA,33,25,27,21,106
3123,16,CP001348.1/1290748-1290851,ACAGUACAAACUGAGCAGGCGAUGGACCUUUCAUAGAGGUACAUGGGGCCGGGCCACCCAGUGAGUGGCAGCAGAUUGCAAUCAUGCACAUCUGUGGGACAGUA,29,19,32,24,104
3124,16,CP000939.1/1702810-1702899,ACAGUACAAACUGAGCAGGCGAUGAACUACAAGUUCAUGGGGCCGGGCCUUAAUUGGCAGCAGAAAGGAUUAAAUACCUGUGGGACAGUA,30,17,26,17,90
3125,16,CP002011.1/1712339-1712433,ACAGUACAAACUGAGCAGGCGAUGAACUUGUAUACAAGUUCAUGGGGCCGGGCCUUAAUUGGCAGCAGGAAGGAUUAAAUACCUGUGGGACAGUA,30,20,28,17,95
3126,16,CP000962.1/1779920-1780014,ACAGUACAAACUGAGCAGGCGAUGAACUUGUAUACAAGUUCAUGGGGCCGGGCCUUAAUUGGCAGCAGGAAGGAUUAAAUACCUGUGGGACAGUA,30,20,28,17,95
3127,16,AGTN01407302.1/1961-2052,ACAGUACAAACUGAGCAGGCGAUGAACCGGAAGGUUCAUGGGGCUGGGCCGCAACCGCGGCAGCAGAUGGAAAGCACAUCUGUGGGACAGUA,27,12,32,21,92
3128,16,CP002160.1/238435-238344,ACAGUACAAACUGAGCAGGCGAUGGACUUUUAUAAAAGUUCGUGGGGCCGGGCCUUUUUUGGGCAACAGGAUUUAAUACCUGUGGGACAGUA,25,24,27,16,92
3129,16,CP001056.1/1566915-1567006,ACAGUACAAACUGAUCAGGCCGAUAAAUGAUUUUAUUUAUGGAGCCGGGCCAUAAUAGUGGCAACAGGAUAUUUAAUACCUGUGGGACAGUA,31,24,22,15,92
3130,16,CP001078.1/1526627-1526718,ACAGUACAAACUGAUCAGGCCGAUAAAUGAUUUUAUUUAUGGAGCCGGGCCGUAAUUUUGGCAACAGGAUAUUUAAUACCUGUGGGACAGUA,29,26,22,15,92
3131,16,ACSC01000002.1/2287722-2287631,ACAGUACAAACUGAUCAGGCCGAUAAAUGAUUUUAUUUAUGGAGCCGGGCCGUAAUUUUGGCAACAGGAUAUUUAAUACCUGUGGGACAGUA,29,26,22,15,92
3132,16,ACBY02000011.1/20821-20727,CCAGUACAAACUGAGCAGGCGACGCCCUUUGCAGGGCGUGGGGCCGGGCCGCCCGUGCGGCAGCAGAUGAAGGUAACGGCAUCUGUGGGACAGUU,19,14,36,26,95
3133,16,ADJS01001306.1/1758-1671,ACAGUACAAACUGAACAGGCCGGAUAUCUUAUCUGGGGCCGGGUCACAACGUGACAGUGGAAUGAAUUGUUUUAUCCGCGGGACAGUA,25,20,25,18,88
3134,16,BABG01026138.1/868-788,ACAGUACAAACUGAGCAGGCCGGGGAUUUCCUGGGCACGGGUCGUAAAUGACAGUGGAUCGAAGACAUCUGCGGGACAGUA,23,14,27,17,81
3135,16,BAAZ01003956.1/1271-1191,ACAGUACAAACUGAGCAGGCCGGGGAUUUCCUGGGGCCGGGUCGUAAAUGACAGUGGAUCGAAGACAUCUGCGGGACAGUA,22,14,28,17,81
3136,16,FP929039.1/1384329-1384246,ACAGUACAAACUGAGCAGACCAUUGGCGAAAGCCAAGGAGUCGGGCCAUCAUGGCAGUGGAAUCUUUACAUCCACGGGACAGUA,27,14,23,20,84
3137,16,ABEY02000006.1/25295-25212,ACAGUACAAACUGAGCAGACCAUUGGCGAAAGCCAAGGAGUCGGGCCAUCAUGGCAGUGGAAUCUUUACAUCCACGGGACAGUA,27,14,23,20,84
3138,16,ACCL02000009.1/43428-43513,ACAGUACAAACUGAGCAGACCGUAACAGUCCGUUAUGGAGUCGGGUCACAUGCGUGACAGUGGAAAUGUUCAUCCACGGGACAGUU,25,18,24,19,86
3139,16,BABG01002502.1/1745-1891,ACCGUACAAACUGAGCAGACCGGGAUUAUAUGAUAUCUUAUGCCUGUUAUGUGAAAAUCAGAUUAAAUCACAUGAUAAUAUACAAGUAUCAUCCAGGAGUCGGGUCACACGCGUGACAGUGGAAUCUUUUCUAUCCACGGGACAGUG,47,39,32,29,147
3140,16,BABG01020281.1/807-661,ACAGUACAAACGGAGCAGACCGGGAUUAUAUGAUAUCUUAUGCCUGUUAUGUGCAAAUAAGAUUAAAUCACAUGAUAAUAUAAAAGUAUAAUCCAGGAGUCGGGUCACACGCGUGACAGUGGAAUCUCUUCUAUCCACGGGACAGUA,51,37,32,27,147
3141,16,BAAU01003136.1/1053-933,ACAGUACAAACUGAGCAGACCGGGAUUAUCGUAUAUAACGAUUAUUAAUGAAGCUUAUUAUAUAAUCCUGGAGUCGGGUCACACGCGUGACAGUGGAAUCUUUUCUAUCCACGGGACAGUA,38,33,27,23,121
3142,16,BAAX01024222.1/601-517,ACAGUACAAACUGAGCAGACCGUGAAUAUCAUGGGGUCGGGUCGCAGAAGCGACAGUGGAAGUUAGUUUCAUCCACGGGACAGUA,26,16,26,17,85
3143,16,FP929055.1/2372574-2372659,ACAGUACAAACUGAGCAGACCGUGAUAUCAUAUCAUGGAGUCGGGUCGCAGAUGCGACAGUGGAAUCUUUCAUCCGCGGGACAGUA,25,18,24,19,86
3144,16,BABB01018152.1/626-536,ACAGUACAAACUGAGCAGGCCAAAGGCGUUUACUGCCUUGGGAGCCGGGCCGCAGGCAGCGGCAGCAGACAGAAGCGUCUGUGGGACAGUG,23,12,33,23,91
3145,16,ABCC02000047.1/101761-101671,ACAGUACAAACUGAGCAGGCCAAAGGCGUUUACUGCCUUGGGAGCCGGGCCGCGGGCGGCGGCAGCAGACAGAAGCGUCUGUGGGACAGUG,21,12,35,23,91
3146,16,AAYW02000017.1/89779-89685,ACAGUACAAACUGAGCAGGCGGUGGGAUGACCACAGGGCCGGGCCACACAGGGUGGCAGCAGAUAAAGAAUGAAUUUAUGAUCUGCGGGACAGUA,30,14,32,19,95
3147,16,BAAY01006628.1/1007-962,GGCCCAUCGGGCAGCAGAUUCGUAAACAAACAUCUGCGGGACAGUA,14,7,13,12,46
3148,16,FP929038.1/798430-798532,ACAGUACAAACUGAUCAGGCGGGGCGCACUUUUUAUAAGCGAUCGCAGCCGGGCCCUUUCGGGCAGCAGAUGAAUGAAAUGGUGAAGCAUCUGCGGGACAGUU,27,21,32,23,103
3149,16,AGTN01289422.1/351-261,CCAGUACAAACUGAGCAGGCCGGGGCAGGUGCUCUGGAGCCGGGCCGCCCCGCGAGCGGCAGCAGAUGAGACGAACAUCUGUGGGACAGUG,20,10,35,26,91
3150,16,CP002563.1/2417023-2416920,CCAAUUAAAUCUGAACAGGCGGUGAACUCUUAGAGGUUCAUGCGGCCGGAUCACACAUGUGUGAUAGCAGAGUAGUGCCAAAAAGGCACACCUGUGGGACAGUA,32,21,29,22,104
3151,16,ABHH01000006.1/34797-34694,CCAAUUAAAUCUGAACAGGCGGUGAACUCUUAGAGGUUCAUGCGGCCGGAUCACACAUGUGUGAUAGCAGAGUAGUGCCAAAAAGGCACACCUGUGGGACAGUA,32,21,29,22,104
3152,16,ACXX02000003.1/385221-385320,AAACUAUAAUUUAGAGCAGGCGAUGCAGCUGUAGACCUUUUAAGACAGUUGUGUGGGGCUGGGCCGAAACGGCAACAGGAUAUAAACCUGUGGGACUAAG,31,22,30,17,100
3153,17,CP000462.1/2127857-2127812,CCUCGGGGACGACCUCGAGGCCUCCUGAUACGCAGGGACGACCCUG,8,6,15,17,46
3154,17,CP000781.1/1410192-1410143,AGGCCGGGACGACCCGGCCAUUCCCUCGGGACCCGGCCGGGACGACCCGG,7,3,19,21,50
3155,17,BA000040.2/4473825-4473773,UGGGAGGGACGGCCCUCCUAUCCACCAGCAUAUCAGCCGCGGGGACGACCCUG,10,7,17,19,53
3156,17,BX572600.1/144591-144548,UCGAGGACGACCUCAAAAUCACCUUUUCGGCCGGGACGACCCGG,10,7,12,15,44
3157,17,CP000572.1/1233467-1233513,GCCCGGGGACGACCCCGGGCCGUCGAUGUUCAACGGGGACGACCCCA,8,4,17,18,47
3158,17,CP000283.1/2608526-2608481,GCUCGAGGACGACCUCCCAAUCACCCUUUCGGCCGGGACGACCCGG,8,6,13,19,46
3159,17,CP000058.1/4535822-4535869,AGCAACGGACGACCGUUGCGUAGAUAGAUCAAUAGCGGGACGGCCCGC,13,6,16,13,48
3160,17,CP000390.1/1077820-1077866,GUGCAGGGACGGCCUUGCUUUCUUCUAUCCGGAUGAGGACGGCCUCA,7,12,15,13,47
3161,17,CP000563.1/3324894-3324846,GCUUAGGGACGACCCUAAACAUGCCUUAAUUUGGUAGGGGACGACCCCU,12,11,13,13,49
3162,17,CP000075.1/4724000-4724047,AGCAACGGACGACCGUUGCGUAGAUUGAUCAAUAGCGGGACGGCCCGC,12,7,16,13,48
3163,17,CP000444.1/1985002-1985050,GCUUAGGGACGACCUUAAAUACGCCGAUAUCAAUUUGGGGACGACCCCG,13,10,13,13,49
3164,17,CP000614.1/2627011-2626967,GCCCGGGGACGGCCCCGGGCCGUUCGCUUCAACGGGGACGACCCC,5,4,17,19,45
3165,17,CP000463.1/3411592-3411635,UCGAGGACGACCUCAAAAUCACCCUUUCGGCCGGGACGACCCGG,10,6,12,16,44
3166,17,CP000270.1/1349405-1349446,UCGUAAGGACGACCUUGCGUUUUCACGAACGGGGACGGCCCC,8,8,13,13,42
3167,17,CP000076.1/5115332-5115385,UCGCGAGGACGACCUCGCGACUCAUUCGAGCGAUCAAUUCCGGGGACGACCCCA,12,8,15,19,54
3168,17,AM286690.1/2165346-2165394,CCCUGGGGACGACCCCGGCGGCCAAGGCUAUAAAGACGGGACGGCCCGU,10,4,18,17,49
3169,17,CP000453.1/2185364-2185316,GGCCGGGGACGACCCUGGCCGCCAGAACGAAAACGGCGGGAGGACCUGG,11,2,21,15,49
3170,17,CP000264.1/1252874-1252827,CCGCCGGGACGACCCGGCCAUGUACGGGUAGUUGUCAGGACGACCUGC,8,7,17,16,48
3171,17,CP000089.1/88477-88521,CUUCCGGGACGACCCGGAGGCAAAAGAAUCCGGCGGGACGACCCG,11,3,16,15,45
3172,17,CP000749.1/1273916-1273962,AUGUGGGGACGACCUCACCGCUCUAAUUAAUAAUGAGGACGACCUCA,14,10,11,12,47
3173,17,CP000151.1/2708127-2708083,GCCCGGGGACGACCCCGGGUCAUUCGCUUCAACGGGGACGGCCCC,6,5,16,18,45
3174,17,BA000045.2/3187382-3187335,CGGUGGGGACGACCCCACCCUUCGCAAAGUUUCGCGGGGACGACCCCG,8,6,16,18,48
3175,17,CP000468.1/4784334-4784380,UUUGCAGGACGACCUGCAAACGCGUCUUUUCACCGGGGACGGCCCCA,9,9,13,16,47
3176,17,CP000627.1/1043227-1043274,AAGUGAGGACGACCUCACCGCUCCAUCUUUUCUUCGGGGACGACCCCA,10,10,11,17,48
3177,17,CP000137.1/143273-143224,CGACCGGGACGGCCCGGUCGCUUCCCUGGGGCACAGCCGGGACGACCUGG,6,5,20,19,50
3178,17,AE015451.1/1897147-1897096,CGGUGAGGACGACCUCACGACGCACCGCGUGACCACUCCGGGGACGGCCCCA,10,4,17,21,52
3179,17,BX950851.1/2171199-2171246,CGCGAUGGACGACCAUCAUGCGGAUCGCAUUUUGGCGGGACGACCUGC,9,9,16,14,48
3180,17,CP000712.1/4533467-4533518,CUGUGAGGACGACCUCACGACGCACCGCGUGACCAUUCCGGGGACGGCCCCA,10,6,16,20,52
3181,17,CP000301.1/5064909-5064861,CGGCCGGGACGACCCGGCCGAACAAGGAGCAUGAGCCGGGACGGCCCGG,10,1,21,17,49
3182,17,AL954747.1/2389357-2389307,GAUUGAGGACGACCUCAUCUUCGGGACAAUCUACUAUCCGGGACGACCUGG,12,11,14,14,51
3183,17,CP000086.1/1166409-1166455,GCCCGGGGACGACCCCGGGCCGUCGAUGUCCAACGGGGACGACCCCA,8,3,17,19,47
3184,17,BX571660.1/26855-26903,CCCCUAGGACGACCUAGAGGGUGACUUCACCGAUGAUGGGACGACCCAA,13,7,14,15,49
3185,17,CP000438.1/3579539-3579491,GAAGCGGGACGACCCGUUUUCCCUCUUUCAUUGCGCGGGGACGACCCUG,7,11,15,16,49
3186,17,DQ472473.1/1294-1250,UUUGCAGGACGACCUGCAAACGCUUCUUUCACCGGGGACGGCCCC,8,9,12,16,45
3187,17,CP000469.1/1970735-1970783,GCUUAGGGACGACCCUAAAUACGCCGAUAUCAAUUUGGGGACGACCCCG,13,9,13,14,49
3188,17,BX571872.1/300724-300678,UAUCCGGGACGACCUGGAUAUACUGCCGUUUUCUGGGGACGACUCCA,9,12,13,13,47
3189,17,CP000781.1/4652689-4652739,GGACGCGGACGGCCGCGUGCCCUUGCGUAUCGAGCGGCGGGGACGACCUCG,6,6,22,17,51
3190,17,CP000463.1/1374094-1374142,CGGCCGGGACGACCCGGCCGACCAGGGAGCAUGAGCCGGGACGACCCGG,9,1,21,18,49
3191,17,CP000301.1/3222813-3222860,CCAAGAGGACGACCUCCCAAUCACCCAAAUGACGCAGGGACGACCCUG,15,4,11,18,48
3192,17,CP000091.1/1606547-1606501,GCCGCGGGACGACCCGUGGCCGAUACGCAACCGGCAGGACGACCUGC,9,3,17,18,47
3193,17,CP000744.1/3522595-3522547,GAAGCGGGACGACCCGUUUUCCUUCUUUCAUUGCGCGGGGACGACCCUG,7,12,15,15,49
3194,17,CP000697.1/2991257-2991208,GCCGGGGGACGACCCCACGGCCGGGACGAUCGCCCGCGAGGACGGCCUCG,7,2,21,20,50
3195,17,CP000282.1/1459875-1459918,UGUUUAGGACGACCUAAGCAGGCUCUCAAUGCGGGACGACCCGC,10,8,13,13,44
3196,17,BA000032.2/787493-787539,AAGUGAGGACGACCUCACCGCUCUAUCUUUUCUCGGGGACGACCCCA,10,10,11,16,47
3197,17,CP000758.1/2644355-2644400,CGGGAAGGACGGCCUUCCCGCUUCUUCAACGAACGGGACGGCCCGU,8,7,15,16,46
3198,17,CP000230.1/336937-336985,AGGCGGGGACGACCCCGCUGGAGGUGUUUUUCAGGCGGGGACGACCCCG,7,7,21,14,49
3199,17,CP000458.1/2537252-2537208,GCCCGGGGACGACCCCGGGCCAUUCGCUUCAACGGGGACGGCCCC,6,4,16,19,45
3200,17,BX572597.1/162305-162257,CGGCCGGGACGACCCGGCCGCACAGGGAGCAUGAGCCGGGACGACCCGG,9,1,21,18,49
3201,17,AP007255.1/1410478-1410525,GGGCCGGGACGACCCGCCCCUUUUCCCCUCACCUCCGGGACGGCCCGG,4,6,15,23,48
3202,17,CT573326.1/1469842-1469791,CUGUGAGGACGACCUCACGACGCAGUGCGUGAUCGCUACGGGGACGGCCCCA,10,7,18,17,52
3203,17,CP000038.1/4603316-4603362,UUUGCAGGACGACCUGCAAACGCCUCUUUUCACCGGGGAUGGCCCCA,9,10,12,16,47
3204,17,AE017180.1/755444-755400,CGGCGGGGACGACUCCGCCGCCCGAACAUCCACGGGGACGACCCC,8,2,15,20,45
3205,17,CP000753.1/3410159-3410111,GCUUAGGGACGACCCUAAAUACGCCUAAUCUAACAUGGGGACGACCCCU,14,9,11,15,49
3206,17,AAFY01000765.1/857-899,CUCGCAAGACGACUUGCGAGAUGUAAGCAAUCGGGACGGCCCG,11,6,14,12,43
3207,17,CP000115.1/2219778-2219829,GCGGAAGGACGACCUUUCGUAUCCCACACAACCACGCGCGGGGACGGCCCUG,11,6,16,19,52
3208,17,CP000388.1/1686454-1686408,AAAUGAGGACGACCUCAUCCCUCGCGCUUUUCUCUGGGACGACCCAG,10,10,11,16,47
3209,17,BX640439.1/167183-167227,GCGCCGGGACGACCCGGCGCGUGUACUGGCCUGAGGACGACCUCG,6,5,18,16,45
3210,17,CP000283.1/2440543-2440591,CGGCCGGGACGACCCGGCCGAACAGGGAGCAUGAGCCGGGACGACCCGG,10,1,21,17,49
3211,17,X69949.1/348-394,UUUGCAGGACGACCUGCAAACGCCUCUUUUCACCGGGGACGGCCCCA,9,9,12,17,47
3212,17,CP000720.1/4139495-4139449,UGGCUGGGACGACCCAGUUACGCAUCUGUUUUUCGGGGACGGCCCCG,6,11,16,14,47
3213,17,CP000440.1/2556910-2556866,GCCCGGGGACGACCCCGGGUCAUUCGAUUCAACGGGGACGGCCCC,7,5,16,17,45
3214,17,CP000026.1/4331173-4331217,GUUACAGGACGACCUGUAAACGCUAUUCUCACCGGGGACGGCCCC,10,8,12,15,45
3215,17,BA000012.4/3864269-3864318,GCGCGGGGACGACCCCGCGCCUCCCCAAGAAUUCGGUCGGGACGACCCGC,8,4,17,21,50
3216,17,CP000826.1/463043-463087,UAAACGGGACGACCUGUUUACGCAUCUGUAUCCGGGGACGACCCC,10,9,12,14,45
3217,17,AE007869.2/1627110-1627159,GCGCGAGGACGACCUCGGCCAAAUCGGCGACAGCAUGCGGGACGGCCCGG,10,3,20,17,50
3218,17,CP001044.1/953099-953146,UGCCGUGGACGACCUCGGCAUGCAUGACCACGUGGCGGGACGACCCGC,8,6,17,17,48
3219,17,CP000304.1/2181100-2181054,AACCACGGACGGCCGUGGCACUGAUGAAUAAAGGCGGGACGGCCCGC,12,4,17,14,47
3220,17,CP000680.1/1523071-1523024,CACCACGGACGACCGUGGCACAUGACGAAUGACGGCGGGACGGCCCGC,11,3,17,17,48
3221,17,CP000790.1/1077239-1077193,AAGUGAGGACGACCUCACCGCUCUUAUCACUAUCGGGGACGACCCCA,12,8,11,16,47
3222,17,AM747720.1/2630566-2630522,GCCCGGGGACGACCCCGGGUCAUUCGCUUCAACGGGGACGGCCCC,6,5,16,18,45
3223,17,CP000094.2/1515933-1515886,CGUCGGGGACGACCCCGGCGCUCAUCGAAAAACUGCGGGACGGCCCGC,9,4,17,18,48
3224,17,CP000094.2/1858450-1858398,ACGCGGGGACGACCCUGCGGCUCAAUCGAGUUUUCAAUCUGGGGACGGCCCCG,9,9,18,17,53
3225,18,BAAW01001404.1/567-484,AAUAAAUCUGGAAGUAAUGAUAAAUUCUCUUUAUUUGGGCACUUUGAGGAUUUUGAACUAGUAGUGCAACCCGCCAACAAUUAA,29,27,15,13,84
3226,18,AAWL01000006.1/67971-67888,ACUGCAAUGGGUGUGAUGAAGUCCGGACAGUAAUGUGGGCACUUAGUCCGGACCGAGCAAGUAGUGCAACCGACCAGAUGCAAA,25,15,26,18,84
3227,18,AP009049.1/1160074-1160160,CAAAUUGAGGGGAACGAUGAGGUACACACUUUAAUUUGGGCAUCCUUGUGUGUAUUGGAGUUAGUGAUGCAACCGACCCUGUAUUCA,23,26,23,15,87
3228,18,AM180355.1/3826693-3826610,AAUAUUUUAGAAACUGAGAAGUAUAUCUUAUUAUUGGGCAUCUGGAGAUAUAUGGAGUUAGUGGUGCAACCGGCUAUGAAUAUA,28,28,20,8,84
3229,18,BA000004.3/387918-388001,AAUCAAUAGGGAAGCAACGAAGCAUAGCCUUUAUAUGGACACUUGGGUUAUGUGGAGCUACUAGUGUAACCGGCCCUCCUUUAA,25,22,20,17,84
3230,18,AE015927.1/474745-474827,AUUUUAAGAGGAAAUUUUGAACUAUAUACUUAUUUGGGCACUUUGUAUAUAGGGAGUUAGUAGUGCAACCGACCUUGAUUAAU,26,31,17,9,83
3231,18,BA000016.3/197260-197343,AAAUGUUAUAGAAACGUUGAUGUAUAUUCUGUAUUUGGGCAUCUGGAAUAUGCUGAGUUAGUGAUGCAACCGACUAUAUUUAUA,26,31,18,9,84
3232,18,AE000513.1/1919839-1919755,CUGUCGAAGAGACGCGAUGAAUCCCGCCCUGUAAUUCGGGCACCUCGGACGGGAGGAGCAAGUGGUGCGACCGGCUUUUCGUUGG,16,17,30,22,85
3233,18,CP000724.1/3560727-3560645,AAAAAUGUAGAGCAAAUGAACUGCAGGUAUACAUGGACGCCUUAAACUGCAGGGAUGUAGUGGCGUAACCGACUAACAAUAUU,31,18,20,14,83
3234,18,ACOM01000005.1/2090470-2090387,CAUGUAGUUGGAAACGAAGAAUAGUUCUCUCAAUCUGGGCACCUUGGGAACUAGGAGUUAGUGGUGCAACCCGCCAGCAAAUUA,25,20,22,17,84
3235,18,CP000246.1/171340-171423,AAAUGUUAUAGAAACGUUGAUGUAUAUUCUGUAUUUGGGCAUCUGGAAUAUGCUGAGUUAGUGAUGCAACCGACUAUAUUUAUA,26,31,18,9,84
3236,18,AM180355.1/3306767-3306682,AAAUAUUAUAGAGAUGUUGAAGUAUAUUCUAUUAUUGGGCACCUUAUGGAUAUACUGAGUCAGUGGUGCAACCGGCUAUGAAUAUA,28,29,19,10,86
3237,18,CP000721.1/1272636-1272718,UGUAUAUAAGGAAACUGUGAUUCGAAUAUUUACUUGGGCACUUUAUAUUCGAUGAGUUAAUAGUGCAACCGACCUUUUUAUUA,25,32,15,11,83
3238,18,CP000721.1/2550212-2550295,AUUACAAUUGGAAGCUAUGAAGAAUUCUUUCUAAGUGGGCACUUUAAGAGUUUGGAGCUAGUUGUGCAACCGACCAAUUAAGAU,27,26,19,12,84
3239,18,AACY020292692.1/343-428,GAGGCGUCCGGAGGCGAUGACCCGCUGAUCCCCAUUUGGGCAUCAAGGGACGCGGCGAGCCAGUGAUGCAACCGGCCGGACGGCUA,17,11,32,26,86
3240,18,AE001437.1/648479-648561,UAUUUGUUUGGAAACAAUGAUGAAUUUCUUUAAAUUGGGCACUUGAGAAAUUUUGAGUUAGUAGUGCAACCGACCAACGAUUA,27,29,17,10,83
3241,18,AJ965256.1/1260708-1260792,AAAUUAAGGGGAAGCGUUGAGCCGCUACCCAUAUGUGGUUCACUCGGAUAGCGGGGAGCUAAUAGUGAAACCGGCCCUUUAGGGG,22,18,28,17,85
3242,18,AAFX01078109.1/475-391,UCACCCUUCAGAGGCUUAGAUGCCUACCCCGCAACUUGGGCGCUUGGGGUACGCGGAGCCAGUAGCGCAACCGGCCGAGGGCUUC,15,15,27,28,85
3243,18,CP000359.1/298588-298670,UUCUUGUUCCGGGGCGAAGAGGCGUGUGGUGUAUCCGGGCACCUGCCACACGCGGAGCCAGUGGUGCGACCGACGAACCGUGA,14,15,31,23,83
3244,18,AE001437.1/3752962-3752879,UUAAGCGUUGGAGACUGUGAAGAAUUUCUUGUAUUUGGGCACCUUAGAAAUUUGGAGUUAGUGGUGCAACCUGCCAACAAUAAU,24,27,21,12,84
3245,18,CP000721.1/2207052-2207135,ACAAAGAUUGGGAACUAUGAAGAAUUCUCUGUAUUUGGGCAUCUUGAGAAUUUAGAGUUAAUGAUGCAACCCACCAAUCAAAAC,31,23,16,14,84
3246,18,AE000513.1/692045-692129,AAGUGGUUUUGAAGCAGGGAAGCAUCUGACGCAUUCGGGCGCCUUGUCAGAUGUGGAGCGAGUGGCGCGACCGGCAAAGCUGUGG,18,17,33,17,85
3247,18,ABDX01000006.1/72290-72207,AAAUGUUAUAGAAACGUUGAUGUAUAUUCUGUAUUUGGGCAUCUGGAAUAUGCUGAGUUAGUGAUGCAACCGACUAUAUUUAUA,26,31,18,9,84
3248,18,AACY020292692.1/175-258,UCGCGAUUCGAGGGCGAUGACGCUCGUUCUGCAACAUGGGCGCUUGGAACGAGCCGAGCCAGUAGCGCAACCGAUCGGUCGACG,17,14,29,24,84
3249,18,AACY023761929.1/1009-1091,AUAAUUUGGUGGGCGUUGAUGUGCCCUUUGUAUCUGGUCGCUUGAGGGGUACGGAGCCAAUAGCGAAACCGCCGCCGUCAUAG,16,22,27,18,83
3250,18,CP000312.1/175590-175673,AUAUGUUAUAGAAACGUUGAUGUAUAUUCUGUAUUUGGGCAUCUGGAAUAUGCUGAGUUAGUGAUGCAACCGACUAUAUUUAUA,25,32,18,9,84
3251,18,AP009389.1/2908378-2908465,GAGAUAGUGUGAAGCAGUGAUCUUGCAGCUAAUAUGGUCACUUUUUACGGCUGCAAGUGAGCUAAUAGUGAAACCGGCACACUGAUGC,25,23,24,16,88
3252,18,CP000923.1/1535517-1535600,AUUUUAUAAAGAGUAGAUGAAGUGAGGCUAUAUGUGGGCACUUUAUGCCUCACGGAUACAGUGGUGCAACCGGCUUUAUGUCGG,22,25,24,13,84
3253,18,ABFD02000011.1/154500-154415,AAAUAUUAUAGAGAUGUUGAAGUAUAUUCUAUUAUUGGGCACCUUAUGGAUAUACUGAGUCAGUGGUGCAACCGGCUAUGAAUAUA,28,29,19,10,86
3254,18,AAOX01000007.1/31274-31356,AAGAAUAUAGAACACUGUGAUGAGCGGUUUUUAUUUGCACUUUAAACCGCUUGGAGUGACUAGUGCAGCCGGCCAAUGAUCUA,24,24,20,15,83
3255,18,AM180355.1/3801149-3801064,CCUAUUUAUAGAAACUGUGAAGUAUAUCUUAAACCUGGGCACUUAAAAGAUAUAUGGAGUUAGUAGUGCAACCUGCUAUAAAUAUA,32,27,15,12,86
3256,18,CP001098.1/2206138-2206055,UAUUGAAUGGGAAGCUAUGAACUCUUCUUUGUACGUGGUCACUUGAAGGAGAGGGAGCUAGUAGUGAAACCGCCCCGACCGGGG,21,20,27,16,84
3257,18,CP000382.1/1875256-1875172,UUUUUAAAAGGAGACAUUUGAACUAUAUACUUUAUUUGGGCACUUUGUAUAUAGGGAGUCAUUAGUGCAACCGACCUUAUUUUAU,25,34,15,11,85
3258,18,ABHE02000039.1/57574-57489,UAAUAAAAUAGAAACGUUGAUUUAUGUUCUGUAAUGUGGGCACCUUAGAGCAUAUUGAGUUAGUGGUGCAACCGGCUAUGAAAUUG,27,28,21,10,86
3259,18,ABHD02000026.1/148456-148371,AAAUAUUAUAGAGAUGUUGAAGUAUAUUCUAUUAUUGGGCACCUUAUGGAUAUACUGAGUCAGUGGUGCAACCGGCUAUGAAUAUA,28,29,19,10,86
3260,18,AM180355.1/4105882-4105797,UAAUAAAAUAGAAACGUUGAUUUAUGUUCUGUAAUGUGGGCACCUUGGAGCAUAUUGAGUUAGUGGUGCAACCGGCUAUGAAAUUG,26,28,22,10,86
3261,18,AAFX01024083.1/557-455,CACCACUGUGGACGCUUUGAUCCGGUGUCUUGAUUUGGUCGCUUAACGUCUGGAACUUUUGACGAGGGCGCCGGGGAGCGAGUAGCGAAACCGGCCACUGGUA,19,25,34,25,103
3262,18,ABDU01000054.2/14999-15082,AAAUGUUAUAGAAACGUUGAUGUAUAUUCUGUAUUUGGGCAUCUGGAAUAUGCUGAGUUAGUGAUGCAACCGACUAUAUUUAUA,26,31,18,9,84
3263,18,CP000721.1/3552610-3552527,AGAACAAUUGGAAGCGAUGAAAAAUUCUCUAUAUCUGGGCACUUUGAGAAUUUGGAGCUAGUUGUGCAACCGACCAAUUAAAAC,30,22,18,14,84
3264,18,ABHG02000025.1/45887-45804,AAUAUUUUAGAAACUGAGAAGUAUAUCUUAUUAUUGGGCAUCUGGAGAUAUAUGGAGUUAGUGGUGCAACCGGCUAUGAAUAUA,28,28,20,8,84
3265,18,AAFX01082705.1/413-329,AUCGAUUUCGGAUGCCUUGAUCCGACCGCUGAAUGUGGGCACUUAGGCGGCCGGGGAGCAGGUAGUGCAACCGACCGUUCCGCAC,16,17,28,24,85
3266,18,CP000721.1/4868650-4868568,UGUCAUAAGGAAACUUUGAUCCAUAUAUUUUAAUUGGGCACUUUAUAUAUGGUGAGUUAGUAGUGCAACCGACCUUUAUAUUU,24,33,15,11,83
3267,18,CP000721.1/4369760-4369677,AUAGUAAUUGAGAGCUAUGAAGAAUUCUUUUUAUGUGGAUAUUUUAAGAAUUUCGAGCUAUCUGUGCAGUCGACCAAUUUAAAC,27,31,16,10,84
3268,18,CP001078.1/3290558-3290475,UAUAAAGUUGGAGAUUAUGAAUAGUUCUCUUUAUUUGGGCACCUUGAGAACUAGGAAUCAGUGGUGCACCCGGCCAACAAAUUA,26,25,19,14,84
3269,18,CP001116.1/102374-102291,AUAACGGCACGAAGCAAUGAAAUGUUCGAUGUAACCGGGCACCUAUCGAACAUGGAGCUAGUGGUGCGACCGACGUUUCAUACG,25,17,23,19,84
3270,18,ABSO01005747.1/296-213,GUCAAUAUCGGACGCGCGGAUGCCUCGCCUGAAAUGGGCACUUAGGGUGAGGCGGAGCGAGUAGUGCAACCGACCGACCCCAGU,19,13,29,23,84
3271,18,ABVK02000002.1/96520-96604,AGGCACCUCGGAGGCGACGAAGCCUGUCCUGCAAUCUGGGCGCCUGGGACAGGUGGAGCCAGUGGCGCAACCGGCCGAGGGCGGG,15,9,36,25,85
3272,18,CP001276.1/419946-420032,CGACACCCCGGAGGCGAAGAAGCGCUGCCUGAGCGUUGGGCGCCAGUGGGCAGCGUGGAGCCAGUGGCGCACCCGGCCGGGAUAUCC,15,9,35,28,87
3273,18,CP002042.1/3024809-3024724,GGGGGGUUCGGAGGCGACGAACUGUGUCACCCAAUAUGGGCACCAAGGGGCACAGGGAGCUAGUGGUGCAACCGGCCGAACACCGC,20,10,33,23,86
3274,18,CP001791.1/1643284-1643367,ACGACAAUUGGAUGCUGAGAAGAAAUGGGUACUAUCUGGGCACUUAACCAUUUUGGAGCUGCUAGUGCAACCGGCCGGAGACAU,24,19,24,17,84
3275,18,CP001720.1/3973350-3973434,GAGUUUCUUGGGAACUAUGACAUCAACUCUUUAUCUGGGCAUCUUAGAGUUGAUUGAGUUAGUGAUGCAACCGACCUUGAAGAAA,24,27,20,14,85
3276,18,CP001743.1/2770688-2770773,ACCAAGUUCGGAGGUGAUGAUCCGUGAUUCCCAAUCUGGGCACCAAGGGAAACGGGGAGCCAGUGGUGCAACCGGCCGAACCCAAA,24,12,27,23,86
3277,18,CP001824.1/1154935-1155018,GUGAGCGCGGAGGCGAUGACGCGCGGGCUGUAAUUUGGGCACCUCGCCCGCGCCGAGCCUGGGGUGCAACCGGCCGGCUAAGAC,13,11,34,26,84
3278,18,CP001825.1/388010-388096,AAUUAGCGUAGAGGCGACGAAGUCCGCUUACCUAUAUGGGCACCAUGGGAGCGGAUGGAGCCACUGGUGCAACCGGCUACUGAGAAG,23,15,29,20,87
3279,19,CP000578.1/343169-343120,CAACCGUCACAACGGCUUCCUGGCGUGACGGGGUUAACCCCAACGGAGCA,12,7,14,17,50
3280,19,CP000377.1/211359-211407,AUGCCGCCACAACGGCUUCCUGGCGUGGCGGAUCUCAUCCAAUGGAGCA,10,9,14,16,49
3281,19,AACY020589009.1/251-203,ACGUCGUCACAACGGCUUCCUGGCGUGACGAUACACAUCUAAUGGAGCA,13,10,12,14,49
3282,19,AACY023759949.1/393-346,UAUUGCACGCAACGGCUUCCUGACGCGUGAGUUGUAAUUAUCGGAGCA,11,13,13,11,48
3283,19,AACY020526688.1/2154-2202,CUCCUGUCACAACGGCUUCCUGGCGUGGCGGGCAACAUCCAAUGGAGCA,10,9,14,16,49
3284,19,CP000032.1/9372-9422,GACCUGCCACAACGGCUUCCUGGCGUGGCGAGGGAAACCUUCAAUGGAGCA,12,8,16,15,51
3285,19,CP000144.1/688624-688575,CAACCGUCACAACGGCUUCCUGGCGUGACGGGGUUAACCCCAACGGAGCA,12,7,14,17,50
3286,19,AACY020245805.1/1080-1127,UCCUACACGCAACGGCUUCCUGACGCGUGAGGUGUAAUCAUUGGAGCA,11,11,13,13,48
3287,19,AACY021643013.1/428-383,UGGCACGCAACGGCUUCCUGACGCGUGAGAUUGAAUUAUUGGAGCA,11,11,14,10,46
3288,19,ABSK01000009.1/52599-52551,UUUUAUCCACAACGGCUUCCUGAAGUGGAUCGACAUUUAAACUGGAGCA,14,14,10,11,49
3289,19,ABIE01000005.1/70619-70571,UUACUGCCACAACGGCUUCCUGGCGUGGCAGGCUAAACCCAACGGAGCA,12,8,13,16,49
3290,19,AACY020522644.1/2673-2625,AUCUCGCCACAACGGCUUCCUGACGUGGCGGCAGAACCCUAAUGGAGCA,12,8,13,16,49
3291,19,AACY022220959.1/246-198,GUGCUGUCACAACGGCUUCCUGGCGUGGCGGCGAAAACCUAAUGGAGCA,11,9,16,13,49
3292,19,AACY023829178.1/189-238,GCGCUGCCACAACGGCUUCCUGGCGUGGCGGUCUGACAGUCAAUGGAGCA,9,9,17,15,50
3293,19,AAFY01026626.1/203-251,GAAUUGCUACAACGGCUUCCUGACGUGGCGAUCUAUAUGAACUGGAGCA,13,12,13,11,49
3294,19,AACY023873338.1/90-135,UAGCACGCAACGGCUUCCUGACGCGUGAGCUUUAAUUAUCGGAGCA,11,11,12,12,46
3295,19,AACY021789724.1/224-271,UGAUGCACGCAACGGCUUCCUGACGCGUGAGAUUAAAUUAUUGGAGCA,13,12,13,10,48
3296,19,AATR01000003.1/91067-91114,UAAGGCUUACAACGGCUACCUGAAGUAAGUUGACAUAAAAACGGAGCA,19,9,11,9,48
3297,19,ABXS01000051.1/24818-24865,AAUCUGCCACAACGGCUUCCUGACGUGGCUAUUUAAUCUAUUGGAGCA,12,14,10,12,48
3298,19,AACY022370156.1/216-170,UCCUAGCUGCAACGGCUUCCUGGCGCAGCUUACAUUUUAUUGGAGCA,9,14,11,13,47
3299,19,CP000264.1/678143-678190,ACUCCUCCACAACGGCUUCCUGACGUGGGGGAUUAUUUGAAUGGAGCA,11,12,13,12,48
3300,19,AACY020081998.1/989-1034,AGACACGCAACGGCUUCCUGACGCGUGAAAUUAAAUUAUUGGAGCA,15,10,11,10,46
3301,19,CP000662.1/776419-776468,CAACCGUCACAACGGCUUCCUGGCGUGGCGGGGAUAACCCCAACGGAGCA,12,6,15,17,50
3302,19,AACY020253271.1/246-293,AAUUGCACGCAACGGCUUCCUGACGCGUGAGUUUUAAUUAUCGGAGCA,12,13,12,11,48
3303,19,ABXE01000008.1/209807-209759,AGACUGCCACAACGGCUUCCUGACGUGGUGGAAAAAUCUUACUGGAGCA,14,10,13,12,49
3304,19,CP000489.1/1874599-1874647,UGACCGCCACAACGGCUUCCUGGCGUGGCGGCGUCAUUUCAACGGAGCA,9,9,15,16,49
3305,19,ABCR01000003.1/393478-393430,AACCCGUCACAACGGCUUCCUGGCGUGACGGCUGACAUACAAUGGAGCA,13,8,13,15,49
3306,19,AACY020145469.1/1022-977,UGGCACGCAACGGCUUCCUGACGCGUGAGAUAAAAUUAUUGGAGCA,13,10,13,10,46
3307,19,AACY022262901.1/198-151,ACAUGUACGCAACGGCUUCCUGGCGCGUGAACCGUAAUUAUUGGAGCA,12,11,13,12,48
3308,19,AACY020064664.1/1378-1332,UCCUAGCUGCAACGGCUUCCUGGCGCAGCUUACAUUUUAUUGGAGCA,9,14,11,13,47
3309,19,AACY022514310.1/232-279,AAUGUUCUACAACGGCUUCCUGACGUAGGGCAAUUCUUUUUUGGAGCA,11,16,11,10,48
3310,19,ABXF01000008.1/119484-119533,UACCUGCCACAACGGCUUCCUGGCGUGGCGGGCUGAACCUCAAUGGAGCA,10,9,15,16,50
3311,19,AACY022603193.1/622-575,UGAAACUUAUAACGGCUACCUGAAGUAAGUUUUUUUAUAAACGGAGCA,17,15,9,7,48
3312,19,AACY020255086.1/785-738,UAUUGCACGCAACGGCUUCCUGACGCGUGAGUUUUAAUUAUCGGAGCA,11,14,12,11,48
3313,19,CP000362.1/3781791-3781742,AGCGAACCACAACGGCUUCCUGACGUGGUUCUUCAUUGGCGAUUGGAGCG,10,12,15,13,50
3314,19,AACY020308077.1/1017-1066,GCGCUGCCACAACGGCUUCCUGGCGUGGCGGUCUGACAGUCAAUGGAGCA,9,9,17,15,50
3315,19,ABIF01000007.1/192066-192114,UUACUGCCACAACGGCUUCCUGGCGUGGCAGGCUAAACCCAACGGAGCA,12,8,13,16,49
3316,19,AAYC01000001.1/142050-142098,UACCUGUCACAACGGCUUCCUGGCGUGACGAGGUGACCUCAGUGGAGCA,10,10,15,14,49
3317,19,AAFZ01022139.1/317-268,AUGCCGCCCCAACGGCUUCCUGACGGGGCGGAUUCACUUUAAAUGGAGCA,11,10,14,15,50
3318,19,ABID01000011.1/17084-17036,AGAGCAUCACAACGGCUUCCUGACGUGGUGCGUAAUUUUUAUUGGAGCA,12,14,13,10,49
3319,19,AACY020223500.1/3303-3256,UAUUGCACGCAACGGCUUCCUGACGCGUGAGUUUUAAUUAUCGGAGCA,11,14,12,11,48
3320,19,AACY021040428.1/508-461,UAUUGCACGCAACGGCUUCCUGACGCGUGAGUUUUAAUUAUCGGAGCA,11,14,12,11,48
3321,19,CP000830.1/1046963-1046915,CCGACGCUGCAACGGCUUCCUGGCGCAGCGGUCGCUAUUCAAUGGAGCA,9,9,15,16,49
3322,19,AACY020533904.1/2663-2615,GCGACCCCACAACGGCUUCCUGGCGUGGGGACACACACAUAAUGGAGCA,13,6,14,16,49
3323,19,ABXM01000011.1/241752-241702,UUACUGCCACAACGGCUUCCUGGCGUGGCAGGCUGAACCCCCAACGGAGCA,11,8,14,18,51
3324,19,AAYA01000008.1/121966-121918,ACCCCGUCACAACGGCUUCCUGGCGUGACGGAGAAACCCGAAUGGAGCA,13,6,14,16,49
3325,19,AAYB01000002.1/503668-503715,AUUCUGUCACAACGGCUUCCUGACGUGGCAGAGAUUUUUAAUGGAGCA,12,14,12,10,48
3326,19,AATQ01000051.1/20133-20085,UCCCCGUCACAACGGCUUCCUGGCGUGACGGCUGGUACCCAAUGGAGCA,9,9,14,17,49
3327,19,AAXZ01000012.1/36217-36265,UGUCCCCCUCAACGGCUUCCUGACGAGGCGGGCUUAACAAAACGGAGCA,12,8,13,16,49
3328,19,AACY020525991.1/1534-1483,CCGCUGUCACAACGGCUUCCUGGCGUGGCGGCUAAACCAUUUUAUCGGAGCA,10,12,14,16,52
3329,19,ABSH01000031.1/84911-84863,ACUCGUCCGCAACGGCUUCCUGACGCGGAUCGACAUUUAAACUGGAGCA,12,10,12,15,49
3330,19,AACY021083615.1/454-500,CCGUAGCUGCAACGGCUUCCUGGCGCAGCUUACAUUUUAUUGGAGCA,9,13,12,13,47
3331,19,CP002623.1/543970-544019,AGCGAACCACAACGGCUUCCUGACGUGGUUCUUCAUUGGCGAUUGGAGCG,10,12,15,13,50
3332,20,AAFX01048275.1/188-258,CAUUAGCUGAGGAGCGCUGCAACUCCGGUUUACGGAACCAGGCUCAGCAAAUGAAACGGCGCUCGUUCCAA,19,13,19,20,71
3333,20,AAFX01122445.1/162-87,GCUUCGAGGAGCGCUGCGACUUGCGUGGUUUGCAAGCCAGGCUCGGAGCAUUCGACAGGAACGGCGCUCACCCACU,14,14,25,23,76
3334,20,AASZ01000145.1/12763-12838,CCUGUGUGCGAGGAGCGCUGCGACAGCUUAACUGCCAGGCUCGCCCACUGGAUCAAUGCAACGGCGCUCGUAAAUA,17,14,22,23,76
3335,20,AASZ01001430.1/3908-3830,CACCGAGGAGCGUUGCAACGGGACAAGGUCCCGCCAGGCUCGGUGAGGGCUCCAUAAGUUUCAACGGCGCUUACUCUGA,17,14,25,23,79
3336,20,AASZ01004975.1/320-450,CCUCCCACCGAGGAGCGCUGCAACCCCAUUAUUAAAUCGGCACCUGCGGUCGGGUUUCGACCACAGGUGCCGAUUUAGUCGCGGGGCCAGGCUCGGUGAGGAGGUAUCUUCAACGACGGCGCUCACUCUGA,25,26,39,41,131
3337,20,AATN01000007.1/45143-45222,ACUGAGGAGCGUUGCGACAGGUUUUCCUGCCAGGCUCAGUAGAUUGAAGGACAAUUUAAAUACAACGGCGCUCAGUCAUC,22,19,21,18,80
3338,20,AATN01000007.1/46422-46509,GCCUGAGGAGCGCUGCAACGGUUAGCAGAUAUUAACUCGCUAACCGCUAGGCUCAGGCAAUCAUUUAGAUUAACUGCGCUCAUUCAAU,24,22,20,22,88
3339,20,AATN01006348.1/58-129,AAUCCGAGGAGCGCUGCAAGGCUGUCGUCCCACAGUUUCAGGCUCGGAUUCAUCAAACGGCGCUCAUCCCAC,16,14,18,24,72
3340,20,AATO01000357.1/409-538,CCCGCCGAGGGGCGCUGCGACCAUGGACCUGCGGCCCGAGCCGCGAAGCCGCGCACACGUCCGUGCGCGCCUGCGAUCCCUGGCCAGGCUCGGCAGGGCGUUCCUUCAGCGACAACGGCGCCCGGACCAA,19,13,45,53,130
3341,20,AATO01002448.1/1018-1089,AAUCCGAGGGGCGCUGCAGGGCUGUCGUUCGACAGUUUCAGGCUCGGAUUUCUCAAACGGCGCUCAUCCAAC,14,16,21,21,72
3342,20,CP000555.1/3494432-3494509,ACUUUCGAGGAGCGUUGCAACUCCCGCCCGGGAGCCAGGCUCGAAAGUCAUCCCCCGAUGCAACGGCGCUCACCCGCA,16,11,21,30,78
3343,20,AE017282.2/144280-144199,GCGCCGAGGAGCGCUGCGACGGCCCGUCGAGGGCCGCCAGGCUCGGCGGGGACAAUCGGUUUUCCAACGGCGCUCUGUUUAU,11,14,31,26,82
3344,20,CP000453.1/2565212-2565295,CGCCCCGAGGAGCGCUGCAACAGGGCCGCCGGCCCUGCCAGGCUCGGGGAUGGCGCCCCAUCGUUCCAACGGCGCUCAGCGAAA,14,8,29,33,84
3345,20,AAOF01000009.1/53442-53352,CUCGCCGAGGAGCGCUGCAACAGGACACGUCUUGGAUUCCUGCCAGGCUCGGCGAUUAUCGGGACCUUUAAACCAACGGCGCUCGGUUCAG,18,18,27,28,91
3346,20,CP000352.1/177418-177491,CACUCCGAGGAGCGUUGCAACGGAUGGCCUCGCCUUCCGCCAGGCUCGGAAUGUUUCAACGGCGCUCGCAGUUC,12,15,22,25,74
3347,20,AACY020581805.1/324-399,UCUUCCGAGGAGCGUUGCAACCGCCACUUUAGCUUGGCGGCCAGGCUCGGAACCGUGACAACGGCGCUCACCCGCA,14,13,22,27,76
3348,20,AM406670.1/4083393-4083321,CCUGCCGAGGAGCGCUGCGACCCGAAAUCACGCCGGGCCAGGCUCGGCAACCGAACAACGGCGCUCGCAAACC,17,5,22,29,73
3349,20,CP000090.1/239471-239552,CACUCCGAGGAGCGUUGCAACGGAUCGUGGCGUAACAUGCCCUCCGCCAGGCUCGGACUGUCUUCAACGGCGCUCGCUGAUC,14,16,24,28,82
3350,20,CP000113.1/8035799-8035872,GACUUCGAGGAGCGCUGCGAGGCCGGACCCGGCCCCAGGCUCGAAGCGGAAUCACCCAACGGCGCUCACCUGUA,15,8,24,27,74
3351,20,CP000089.1/57505-57435,UCUGCCGAGGAGCGCUGCGACCCUUUAAUUCGGGGGCCAGGCUCGGCAAUGAUCAACGGCGCUCGCAAACC,14,12,22,23,71
3352,20,CP000116.1/2591667-2591597,GGUUCCGAGGAGCGCUGCGACGGUUCACCCGCCAGGCUCGGGACGCUUCCUUUCAACGGCGCUCACGUUUU,9,16,22,24,71
3353,20,CP000304.1/4264519-4264605,CCACCCGAGGGGCGCUGCAGCAGGUUCCAGAACCUGUCAGGCUCGGAUGGGGCGUUUCCUCGAACGCAUCAACGGCGCCCAUUCGCA,16,14,27,30,87
3354,20,AL646052.1/107656-107582,AUUCCGAGGAGCGUUGCAACGGACCGGCAUCCGCCCGGCCGCCAGGCUCGGAAGUUCAAACGGCGCUCGCACUAU,15,11,23,26,75
3355,20,CP000103.1/2909965-2909888,CAGACCGAGGAGCGCUGCAACGGGCAUUGUCCCGCGAGGCUCGGCAAGGAAGGAUCGCUACAACGGCGCUCGUUCAUU,17,12,26,23,78
3356,20,CP000316.1/4339043-4338971,CUUCCUGAGGAGCGUUGCAACCCACAUCACGUGGACCAGGCUCAGGACUUCAUUGCAACCACGCUCACCCGCA,17,13,16,27,73
3357,20,CR555306.1/1088385-1088448,UGCCGAGGAGCGCUGCGAGACUUCCGUCCCAGGCUCGGCCCUUCAAAAACUGCGCUCACCUUAA,13,12,16,23,64
3358,20,AM260479.1/256130-256245,CACUCCGAGGAGCGUUGCAACGGAUGGAGGCCUGCGAAGCACAUCGCGCGGCCGGCGGCACAGCCGCCCCAUGCCAUCCGCCAGGCUCGGACUGUCUUCAACGGCGCUCGCUGAUC,20,16,37,43,116
3359,20,CP000744.1/550599-550494,CCGUUCGAGGGGCGCUGCAGCAGGCCUAGGCCUGUCAGGCUCGAACGGAGCGCGCUCUCAGGCCGGCCUCGCCGGUCUGUCAACGCACCAACGGCGCCCAUUCGCA,16,15,35,40,106
3360,20,CP000539.1/650534-650615,CUUUCCGAGGAGCGUUGCAGCGUCCCCAGCACGGCGGGGCGCGAGGCUCGGAAGUCAUACCCAGCAACGACGCUCACCCACG,16,10,26,30,82
3361,20,CP000267.1/475493-475563,UCUUCCAAGGAGCGUUGCAGUCGGCCACAUGGCCGGUCAGGCUUGGAUGACCCCAACGACGCUCACCUGAU,14,14,20,23,71
3362,20,CT573326.1/5348242-5348337,CCGGCCGAGGGGCGCUGCAGCAGGUUCGUCCUGUCAGGCUCGGUCGGGGCGUUGUCCGCGCAGCGGACGCUCAACGCACAACGGCGCCCAUUCGCA,13,14,35,34,96
3363,20,AE015451.1/5667868-5667964,CUGUCCGAGGGGCGCUGCAGCAGGCUAGGCCUGUCAGGCUCGGAUGGGGCGUUGCUCGCUCCCGCGAGCGCUUAACGCACAACGGCGCCCAUUCGCA,14,16,34,33,97
3364,20,CP000680.1/478968-478877,CCGUCCGAGGGGCGCUGCAGCAGGUCGGUCGACACCGGUUUGUCAGGCUCGGAUGGGGCGUUAACCAUACGCAUCAACGGCGCCCAUUCGCA,16,16,31,29,92
3365,20,CP000450.1/2008790-2008713,UUGUACCGAGGAGCGCUGCAACGGUCUAUCUCGUGAGGCUCGGACAAAUGAACAACCCAACAACGGCGCUCUUUCACU,20,16,19,23,78
3366,20,CP000086.1/3610417-3610350,GUUUCCGAGGAGCGUUGCGACGGGCCCCGCCCGCCAGGCUCGGAAAUGGUCAACCGAGCGGUGUGUCU,10,12,25,21,68
3367,20,AE016853.1/5771306-5771415,CUGUCCGAGGGGCGCUGCAGCAGGUUUACCCUGUCAGGCUCGGAUGGGGCGUUGUUUGUCAGGUUGAUCACAGCCGGCAAGCCUUAAACGCACAACGGCGCCCAUUCGCA,20,23,35,32,110
3368,20,CP000076.1/6604864-6604970,CUGUCCGAGGGGCGCUGCAGCAGGCAUGACCUGUCAGGCUCGGAUGGGGCGUUGUUGGUACAGGGCUCCCUGUAUGGACACUAAACGCACAACGGCGCCCAUUCGCA,20,20,36,31,107
3369,20,CP000529.1/516171-516245,UCUCCUGAGGAGCGUUGCAACCCACGGCAUGUGGUCUAGGCUCAGGACUUCUAUUUGCAACCACGCUCACCCGCA,15,17,18,25,75
3370,20,DQ996270.1/1772-1706,UUUCCGAGGAGCGUUGCGACGGGCACCGGCCCGCCAGGCUCGGAAAUCUUCACCAGGCGGUGGCCCG,10,10,24,23,67
3371,20,CP000542.1/736268-736181,CGCUCCGAGGAGCGUUGCAGCGCCUCCCACCGGCAGGGCCGGCGGGGCGUGAGGCUCGGGCAUCAUCUGGCAACGACGCUCAUCCACA,14,11,31,32,88
3372,20,CP000075.1/499723-499613,CUGUCCGAGGGGCGCUGCAGCAGGUUUUCCCUGUCAGGCUCGGAUGGGGCGUUGUUUGCCAGGACGAUCCUCGACCGGCAAACCUUAAACGCACAACGGCGCCCAUUCGCA,20,22,34,35,111
3373,20,ABCT01000021.1/8794-8876,CCGUUCGAGGAGCGUUGCGACACACCCAUGCUUUUUUGGGGUGCUAGGCUCGAACAAGAAAUAAACAACGGCGCUCACGCUUC,20,18,22,23,83
3374,20,CP000884.1/6586554-6586470,CUCUCCGAGGAGCGUUGCAGCGGCCCCCACACAUCAGGCGUGGUCGCGAGGCUCGGAGUCAUACCUGCAACGACGCUCGCCCACG,15,12,26,32,85
3375,20,CP001068.1/3828986-3829069,CAUUCCGAGGAGCGUUGCAACGACCGGCCCAAGUUCAGACGGGGCGGCCGCCAGGCUCGGAAGUUCAAACGGCGCUCGCAGUAU,18,12,28,26,84
3376,20,CP000949.1/538083-537987,CUGUCCGAGGGGCGCUGCAGCAGGGUCAUCCUGUCAGGCUCGGAUGGGGCGUUGUCCGCUCCCGCGGACGCUCAACGCACAACGGCGCCCAUUCGCA,14,16,33,34,97
3377,20,CP001111.1/740018-739937,CUGCCGAGGGGCGCUGCGACCGGAUCCCUUGAGGCCGGCCAGGCUCGGCCAGGUGGUACUGCAACAACGGCGCCCGGCCAGA,13,9,31,29,82
3378,20,AAUJ02000001.1/4967434-4967338,CCAUCCGAGGAGCGUUGCAGCGUUCCCCAGCCAGCCAUGAGCUGGCCUGCGCGGGGCGUGAGGCUCGGAUUUCAUCCCGCAACGACGCUCGCCCACG,15,15,31,36,97
3379,20,CP001157.1/337304-337216,CCUUCCGAGGGGCGCUGCAGCAGGCCUGCCAACGGCCUGUCAGGCUCGGAAGGGGCGUUUUCCGAACGCAUCAACGGCGCCCAUUCGCA,15,14,29,31,89
3380,20,CP002271.1/7720690-7720757,CAACCUGAGGAGCGCUGCAACGGGGACUUCCCGCCAGGCUCAGGUUCAUGUAACGGCGCUCGCUGACU,13,12,21,22,68
3381,20,CU914168.1/185982-185906,CAUUCCGAGGAGCGUUGCAACGGACCGGCAUGCGCCCGGCCCGCCAGGCUCGGAAGUUCAAACGGCGCUCGCACUAU,15,11,24,27,77
3382,20,CP001715.1/470000-469928,CAAUCCGAGGAGCGCUGCAGGGCCGUCGAUCGACGGUUUCAGGCUCGGAUUCCUUAAACGGCGCUCAUCCGAC,14,14,22,23,73
3383,20,CP000094.2/5940642-5940740,CUGUCCGAGGGGCGCUGCAGCAGGUUCAACCUGUCAGGCUCGGAUGGGGCGUUGACCGGCUCAGGCCGGACACUAAACGCACAACGGCGCCCAUUCGCA,19,15,33,32,99
3384,21,U00006.1/98763-98567,CAGGCCAGAAGAGGCGCGUUGCCCAAGUAACGGUGUUGGAGGAGCCAGUCCUGUGAUAACACCUGAGGGGGUGCAUCGCCGAGGUGAUUGAACGGCUGGCCACGUUCAUCAUCGGCUACAGGGGCUGAAUCCCCUGGGUUGUCACCAGAAGCGUUCGCAGUCGGGCGUUUCGCAAGUGGUGGAGCACUUCUGGGUGA,39,40,70,48,197
3385,21,J03294.1/2297-2476,GGUGAAGAUAGAGGUGCGAACUUCAAGAGUAUGCCUUUGGAGAAAGAUGGAUUCUGUGAAAAAGGCUGAAAGGGGAGCGUCGCCGAAGCAAAUAAAACCCCAUCGGUAUUAUUUGCUGGCCGUGCAUUGAAUAAAUGUAAGGCUGUCAAGAAAUCAUUUUCUUGGAGGGCUAUCUCGUUG,54,46,52,28,180
3386,21,AF269536.1/680-500,AAUAGAGUUAGAGGUUGCAUUAUUAAUGACUAACUUAUCAGAAGUCGUAUGGGACAUGUGUUGAAUAAGUGAAAGGUAAUAAUGCCGAAAUGAUGUUAUUUCCAUAAAUUAGCAUUGUGAAGUUGGUUGAACAAUAAAAACAUCACAACCACGAAUGCUUUCUUCAAUAUUUAUUUGAAUU,66,60,34,21,181
3387,21,AF270308.1/2156-2331,AAUAGAGUUAGAGGUUGCAUUAUUAAUGACUAACUUAUCAGAAGUCGUAUGGGACAUGUGUUGAAUAAGUGAAAGGUAAUAAUGCCGAAAUGAUGUUAUUUCCAUAAAUUAGCAUUGUUGGGACAACUUUCGAAUAGAAGUUGUACUGUCACUUUAUGUGAUGUGCUACCUUAUAU,57,61,38,20,176
3388,21,M93419.1/332-511,AGUGAAGAUAGAGGUGCGAACUUCAUCAGUAAAAGCUUGGAGAAGAAUGAGCUUCAAUGAAAAGCUUUGAAAGGGAACGUUCGCCGAAGUGAAGAAAAACUCAUUUUUUUCUUUGCUGGUCCUGCAUUUAAGAGAUGCCGGAUUGUCAAGGCGGUGCCGCCUUGGAGAGCUAUCUCACUG,53,47,49,31,180
3389,21,AF306669.1/1019-1194,AUAUUUUGAUGAGGCGCAUCAAUCAUGAGUAAAGUUUAGAUUACUGUCUGCUAACAGCUAAAUUUGAAAGGGUGCGAUGCCGAAGCAAUUAUAAUAGCAGUUAUAAUUUGUUGGACUUUUUGGUUAAGAGCUGAGAGUUUGUCAUUAUUUAAAAAUAAUGGAGUGCAUCACUUGUA,56,61,39,20,176
3390,21,X00008.1/296-492,CAGGCCAGAAGAGGCGCGUUGCCCAAGUAACGGUGUUGGAGGAGCCAGUCCUGUGAUAACACCUGAGGGGGUGCAUCGCCGAGGUGAUUGAACGGCUGGCCACGUUCAUCAUCGGCUAAGGGGGCUGAAUCCCCUGGGUUGUCACCAGAAGCGUUCGCAGUCGGGCGUUUCGCAAGUGGUGGAGCACUUCUGGGUGA,39,40,71,47,197
3391,21,X15196.1/270-75,GCAGCCAGAAGAGGCGCGUUGCCAAGUAACGGUGUUGGAGGAGCCAGUCCUGUGAUAACACCUGAGGGGGUGCAUCGCCGAGGUGAUUGAACGGCUGGCCACGUUCAUCAUCGGCUACAGGGGCUGAAUCCCCUGGGUUGUCACCAGAAGCGUUCGCAGUCGGGCGUUUCGCAAGUGGUGGAGCACUUCUGGGUGA,39,40,70,47,196
3392,21,AL591976.1/186683-186486,UGGUGAGGUAGAGGUUGCGAGAUGCACUAGUAAUUUUUUCGAGGCGAAACAAAGACGCCGACGACAAAGAAUGAACAGGUUGAUCGCCGAAGUGACUAUUUUCUCUUUGUUUAGAAAUAGUUGUUGGGACAGUUUCCUAAAGGGGCUGGACUGCUAUAAGAAUUUGUCGAAAUUUCUUAUAGGUGUGCUAUCUGACAA,57,59,53,29,198
3393,21,AL596166.1/112469-112272,UGGUGAGGUAGAGGUUGCGAGAUGCACUAGUAAUUUUUUCGAGGCGAAACAAAGACGCCAAUGACAAAAAACGAACAGGUUAAUCGCCGAAGUGACUAUUUUUUCUUUGUAUCGAAAUAGUUGUUGGGACAGUUUCCUAAAGGAGCUGGACUGCUAUAAGAAUUUGUCGAAAUUUCUUAUAGGUGUGCUAUCUGACAA,61,59,49,29,198
3394,21,AAMR01000029.1/5147-5324,AUCGCACGUAGAGGCGCAAUUAUAAAAAGUAGUUUUCGUUGGGGUGAUGCCAAUGAGCGGGAAUGAAAGGUCUAAUUGCCGAAGUAAAUUGUAUAUCUAAGCAAUUUGCUGGGGUUGUGCUCAAUAGGUACAACACUGCCAUAGUCUUAAUUUUAAACUAUGGAGCGCUACUGUAGGG,53,51,47,27,178
3395,21,CP000002.3/2878377-2878198,GGUGAAGAUAGAGGUGCGAACUUCAAGAGUAGGCUUGAUGAGGAAGAUGGAUUCCGAUGAAGAAAGCCGAAAGGGGAGCGUCGCCGAAGCGGGGAAAAAUCCACUCGUUUUUCCUGCUGGCUUUACAUUGAAUAAAUGUGAGGCUGUCAAGAAAUCAUUUCUUGGAGAGCUAUCUCGUUG,52,44,55,29,180
3396,21,BX950851.1/4451556-4451748,CAAGCCAGAAGAGGCGCGUCGCCCAGGUAAGAUAUCGGAGGAACCGUAAUCCGCUGAUGAUAUCCGAGGGGGAGCGACGCCGAGAUGCGGUGAAAUUCGGCUUUCACCCUAUCGACUACAGAGGCUGAAUCCUCUGGGUUGUCACCGGAUUCGUCCUGAUGGACGUCCAGCAAGGUGGAGCGCUUCUGGGUGU,43,39,63,48,193
3397,21,EF419299.1/175-1,AAAAGAGUUAGAGGUUGCGUCUUUAAUUAGUAACACUUCAGAAGUUAUUAAGGAACGUGUGUUGAAAGUGUGGAAGGUAAAGAUGCCGAAAUGAAUGAUACCCUUAAUUAUCAUUUGUUGGGACAGUUAUCGAAUAGAAACUGUACUGUCACAAUUUGUGAUGUGCUACCGACGG,57,53,43,22,175
3398,21,CP000046.1/1759610-1759435,AAUUGAGUUAGAGGUUGCAUGUUUAAUUAGUAACUUGUCAGAAGUAUUUAUGGUACAUAAGUUGAACAAGUGAAAGGUAAAGAUGCCGAAAUAGAUAUAAACCAUAAAUUAUAUCUAUUGGGACAGUUUUCGAAUAGGAACUGUACUGUCACAGAAUGUGAUGUGCUACCUUAUAU,63,57,37,19,176
3399,21,BA000037.2/1373591-1373770,UAUCGACGUAGAGGCGCAAUGGUAAAGAGUAACUAUUAUUGGGGUGAUGCCAAUGAAUAAUAGUGAAAGGUAUCCAUUGCCGAAGUGAAUUGCAUAUCAAAGCAGUUUGCUGGGGUUGCAUCCGAAAGGAACAACACUGCCAUAGUAUUUAAUGUAUAACUAUGGAGCGCUACUGUAGGU,58,48,47,27,180
3400,21,CP000647.1/4829910-4829675,AUUGCCAGAAGAGGUGCGUUGCCCAGGUAACCGUAUUGGAGGAACCAGUCCGGGGAAGAUACGUGAGGGGGAGCAACGCCGAGGUGAAAGAGCGUCUGGUCACGCUCCUCGCCGGCCACAGGGGCUGAAUCCCCUGGGUUGUCACCAGAAACGUUCGCAGUCGGGCGUUUCAUACCCGAACACCUCAGCGCCCAAAGCGGUGAGUCGGGUCUACAAGGUGGAGCACUUCUGGGUGA,53,41,80,62,236
3401,21,BA000004.3/1819757-1819575,AGUGAGGAUAGAGGUGCAAAAACCAAGAGUACACAAUUGGAGGAGAAUGAGAUCCGUUGAGAAUUGUGGAAAGGGGAAUUUGCCGAAGCUGGAAGAAUCUCAUGUUCUGAAGGCUGGUUCUGUAUUAAAUAAAUACAGAACUGUCAUAUAGCGGAUGUUGCUAUAUGGAGGGCUAUCUCACGC,60,45,53,25,183
3402,21,ABCF01000065.1/4547-4725,AGUGGUGAUAGAGGUGCGGACUUUCAUCAGUAGAUGCUUCGAGGAGUAUGGGCUCUUAUGAAGGGUAUCGAAAGGGAAAUUCGCCGAAGUGGAAGCAGGCUCAUAUCUGUUUGCGCUGGUUCUGUGUUUAAGAGAUGCAGGAUUGUCAAGAUUAACAGUCUUGGAGAGCUAUCUCACGU,45,51,56,27,179
3403,21,AE017143.1/992934-993104,ACAAAUUGUAGAGGUGCAAAUCCGAUAAGUAUUUCUUCUGAGUGGAAAGCGAUGAAGGGGAAGGAAAGGCGUAUUUGCCGAAAUCAAUUAAGCGUCAUCUUAGUUGGUUGGGGUCGUUGCCGAAAGGGACGACACUGUCGUAAUUCAAUAUUACGGAGUGCUACUAUUAGG,51,46,49,25,171
3404,21,CP000002.3/3366091-3365915,UAGUGAGGUAGAGGUUGCGCGGAUGAUGAGUCGCAUGUGUGAGGCUGAUGGGGCCGAUGAUCAUAUGCAAAAGGCAUCAGCGCCGAAGCAUAAGGAAGCCAUUCAUUCUUUAUGCUGGGUCUGCAUUGAAUAAGUGCAGGACUGCCGCGGGUAUUCCCGCGGAGGGCUAUCCGGAGA,42,40,61,34,177
3405,21,CP000029.1/981298-981477,AGAUUUUGAUGAGGCGCAUCAAUCAUGAGUAAACUUUAGAUAAUUUGUCUGCUAACAAUUAUAGAGUUAAAAGGGUGAGAUGCCGAAAUGAUUCAUAAUAGCAGUUAUGAAUCGUUGGACUUAAUGGUUAAGAGCUAUAAGUUUGUCAUUAUUAUUAAAUAAUGGAGUGCAUCACUUGUA,62,61,38,19,180
3406,21,AAWP01000069.1/5541-5721,UAUUGCCGUAGAGGUGCAGUCUCGAAGAGUAGCUAUUAUUGGGGUGAUGCCAAUGAAUAAUAGUGGAAGGCGAGGAUUGCCGAAGUAGGUGGCCUAUCGAAGCCACUUGCUGGGGUUGUCUCUGAAAGGAACAACACUGCCAUAGUAUAUUUACAUUAAACUAUGGAGCGCUACUGUAGGG,50,47,54,30,181
3407,21,AAKK02000085.1/12844-12662,UGUUGCCGUAGAGGCGCGGUCUCGAAGAGUAGCUAUUAUUGGGGUGAUGCCAAUGAAUAAUAGUGGAAGGCGAAGAUUGCCGAAGUAAGUAACUCAUCAAAGUUACUUGCUGGGGUUGUAUCUGAAAGGAACAACACUGCCAUAGUAUAUAUUCACAUUAAACUAUGGAGCGCUACUGUAGGG,55,48,51,29,183
3408,21,CP000416.1/1669940-1669758,UCGAAUAGAAGAGGCGCGACCAACAAGAGUCGCUUUCCGGAGAUGGGUCACAUUGCUGAUGGAAGGUUAAAGGGGCGGUCGCCGAAAUUUACGCAUUUUGACCGGAUGCGUGGGUUGGGUCCUGGUUGAACAAGUCAGGGACUGUCGCAGUCAAAUAAUCGGCUGCGGGGCGCUUUCAACGAU,44,41,61,37,183
3409,21,AM263198.1/783761-783564,UGGUGAGGUAGAGGUUGCAAGAUUCACAAGUAAUUUUUUAGAAGCGAAACAAAGACGCUGAUGACAAAGAAUGAACAGGAUGAUUGCCGAAGUGACUAUUUUCUCUUUGUUUAGAAAUAGUUGUUGGGACAGUUUCCUAAAGGAGCUGGACUGCUAUAAGAAUUUGUCGAAAUUUCUUAUAGGUGUGCUAUCUGACAA,63,61,49,25,198
3410,21,AP006716.1/1558409-1558233,AGAAAUUGAUGAGGCGCAUCAAUCAUCAGUAUAUAUUAGAUAAACUGUCUGCAACAGCUAAUAUAGAAAGGGUGCGAUGCCGAAAUGAAUCAUAAUCGCAGCUAUGAUUUGUUGGACUUUGUGGUUAAGAGCUGAAAGUUUGUCAUUAUUAUUUAAUAAUGGAGUGCAUCACUUGUA,59,56,39,23,177
3411,21,ABDQ01000005.1/49327-49153,AACUAAGAUAGAGGUGCGAGAUUUAAGAGUAGUAUUAUGGAGUUAAGUGCUAAGAAGUAAUAAGAAAGGAAAUUUCGCCGAAGCUUAUAGAUAAUACUUUAAUGCUAUUUGCUGGGAUUACAUAAAAUAUAUGUAAGACUGUCACAAAUAAAGUUUGUGGAGAGCUAUUAUUUUA,67,55,38,15,175
3412,21,AE016827.1/1325416-1325239,UACACAUGUAGAGGUGCGAAUAUUAUAAGUAUUUUUCCAGAGUGGAUAACAAUGAAGGAAAUUGAAAGGAAUAUUUGCCGAAAUCAGUUAAGCGUCAUCUUAACUGGUUGGUAACGUCACCGAAAGGAACGUUACUGCCAUAGUCAUUUUUGAUUAACUAUGGAGCGCUACUCGUGGG,57,52,42,27,178
3413,21,CP000569.1/516240-516411,ACAAAUCGUAGAGGUGCAAAUCCGAUAAGUACUUUUUCUGAGUGGAGAACGAGGAGGAAAAAGGAAAGGCGUAUUUGCCGAAAUCAGUUAAGCGUCAUCUUAAUUGGUUGGGGUCGUUACCGAAAGGGACGACACUGUCGUAAUCCUUGUAUUACGGAGUGCUACUGCUAGG,51,44,49,28,172
3414,21,BA000031.2/1190723-1190903,UGUUGCCGUAGAGGCGCAGUCUCGAAGAGUAGCUAUUAUUGGGGUGAUGCCAAUGAAUAAUAGUGGAAGGCGAAGAUUGCCGAAGUAAGUCGUAUAUCAAAACGCCUUGCUGGGGUUGUAUCUGAAAGGAACAACACUGCCAUAGUAUAUUUACAUUAAACUAUGGAGCGCUACUGUAGGG,54,47,51,29,181
3415,21,CP000425.1/2337129-2337310,CACAUCGAUAGAGGUCGCAACUGAUAUGAAUCUACGCCGAGUUGGAGCACAACAAAGACGCGUAUUAGAGGGGGAGAAGUUGCCGAAAGAAUUUUGACGCUCAGCAAAGUUCUUGGGCUAGUGAGGAAAACUCACUAGACUGUCGCAAAUGGUUAAGAACCAUGCGGAGGGCUAUUCGUUCA,57,39,51,35,182
3416,21,AASA01000017.1/10332-10501,ACAAAUUGUAGAGGUGCGAAUUCAAUAAGUAUUUCUUCUGAGUGGAAAACGAUGAAGGGGAAGGAAAGGUGAAUUUGCCGAAAUCAAUUAAGCGUCAUCUUAAUUGGUUGGGGUCGUUGUCGAAAGAAACGACACUGUCGUAGUAAAUGCUACGGAGUGCUACUGUUAGG,54,46,48,22,170
3417,21,AP008934.1/1400599-1400421,AGGUUUUGAUGAGGCGCAUCAAUCAUUAGUAAAGAUUAGAAGAAUCUGACUGCUAGCAGCUAAUUUUGAAAGGGUGAGAUGCCGAAACGGUUAUAAUAGCAGCUUAUAACAUGUUGGACUUUAUGGUUAAGAGCUAAGAGUCUGUCAUUAUUUUAAGAUAAUGGAGUGCAUCACUUGUA,58,56,43,22,179
3418,21,AAOX01000015.1/22460-22639,AGUGAAGGUAGAGGUGCAAACUUCAUCAGUAAAAGCUUGGAGAAAGAUGAGUUUCCGUGAAAAGCUUUGAAAGGGAAUGUUUGCCGAAGAAAAGGAAGUCUCAUUUCUUUCUUUUCUGGUCCUGUAUUGAAUAAAUACUGGAUUGUCAAGACAGCGCCGUCUUGGAGAGCUAUCUCACUG,54,52,46,28,180
3419,21,AL009126.3/3421348-3421169,CAGUGAGGUAGAGGUUGCGCGGAUGAUGAGUCACACAUGCUAGGCUGACAGGGGCUGUUAAACAUGUGUAAAAGGCAUCAGCGCCGAAGUGUGGAGAAAGCCGAUCCUUCUCUAUGCUGGGACUGUAUCUGAAUAAGUGCAGGACUGCCGCGUGCUUUUUCGCGGAGGGCUAUCCGGAGA,43,41,60,36,180
3420,21,AE008691.1/719320-719498,CGCAUAAAUAGAGGAGCUGCCAAGCAUGUAUUUGGCGAGGUGUUAAGGAGAAGAACCUCCAAUACUCGCUGAAGAAGGUUUGGCUGCCGAAAGGGUGAGCUUGUUCUUGAGCUCAUCCUUGGUGGUAAACACAAAGUUUACCACUGUCAUGGGACCUCCCAUGAAGCGCUAUUUAUGCA,49,45,48,37,179
3421,21,AE004439.1/1026545-1026371,UACUUGUGUAGAGGAGCGAUCACUAUAAGUAUUUUUUCUGAGUGGAUAACGAAGAGGAAAAAGGAAAGGAGUGACCGCCGAAAUCAAUUGAAAGUCAUUUUGAUUGGUUGGUGGCGUAUUCGAAAGGAACGUCAUUGUCAUAGUCUUUUUUAAACUAUGGAGCGCUACUGGUUGG,52,53,48,22,175
3422,21,CP000436.1/843556-843727,UACAUAUGUAGAGGUGCGGCUGUUAUAAGUAAUUUUUUGAGUGGAUAACGAUGAAAAAAAUGAAAGGAAUAGUUGCCGAAAUCAAUUAAAAGUCAUUUUAAUUGGUUGGGGGCGUAUUCGAAAGAAACGUCACUGUCAUAGUAUUUAUCCACUAUGGAGCGCUACUGGUUAG,57,53,42,20,172
3423,21,CP001186.1/1355449-1355630,CUCAAAGGUAGAGGCCGCGAUAGGAAAGAGUAAGCUAUGGGAGAUUUAAUGGAAUCUGUGAUCAUAGGUUGAAAGGGACUAUUGCCGAAAUAUAAGAAUAACCAUCUUAUUCAUAUAUUGGGACUACAUUGAAUAAAUGUAGUACUGUCAUAAGAUUUAUUUUAUGGAGAGCUAUUUGGAGA,64,54,44,20,182
3424,21,AE005176.1/2276232-2276414,CACAUCGAUAGAGGUCGCAACUGAUAUGAAUCUACGCCGAGUUGGAGCACAACAAAGACGCGUAUUUAGAGGAGGAGAGGUUGCCGAAAGAAUUUUGUUGCUCAGCAAGGUUCUUGGGCUAGUGAGAAAAACUCACUAGACUGUCGCAAAUGGUUAAUAACCAUGCGGAGGGCUAUUCGUUCA,56,43,50,34,183
3425,21,CP000923.1/1076332-1076143,AGGUGAGGUAGAGGCGCGGGUUAUCAAGAGUAGUAUACCAGAGGUAUUUAAGGGCCGAUGAAGGUAUAUGAAAGGGAUGCUCGCCGAAGCGCGUAAAUUCCUUAAAGUUUACGCAGCUGGGCCUAUGCCGAAUAGGUAUAGGACUGUCACUGGAGGUUUCCCGAGCCUUCAGUGAAGAGCUAUCUCGCUA,51,45,59,35,190
3426,21,AE008691.1/1930427-1930616,AGGUGAGGUAGAGGCGCGGGUCAUCAAGAGUAACAUGCCAGAGGUGUUAAGGGCCGAUGAAGGUGUGUGAAAGGGGUGCCCGCCGAAGCGCGUAAACUUCCUUAAGGUUUACGCAGCUGGGCCUAUGCCGAACAGGUAUAGGACUGUCACUGAAGGCUCCCCAGGCCUUCAGUGGAGAGCUAUCUCGCUA,46,38,64,42,190
3427,21,CP000826.1/4955718-4955911,CAAGCCAGAAGAGGUGCGUCGCCCAGGUAGAGUGUCAGAGGAGCCGUUGUCCAAUGACGGCGCUUGAGGGGGAGCGACGCCGAGGUAAGGUGAUGUGCGGCAUUCAUCGUAUCGACUACAGGGGCUGAAUCCCCUGAGUUGUCACCAGGGAUUGUCCGUAGGGGCAAUCAGCAAGGUGGGGCGCUUCUGGGUGU,40,38,73,43,194
3428,21,AL935263.2/928916-929097,AUCGAAAGAAGAGGAUGCGGUUAACAAUAGUAGCCGGCUGGAAGUGGGUCACCACUUAUGAAGGUCAGUGAACGGGGCAACCGCCGAAAUCGAUGGAUCAGUGACCGAUUCAUCCGUUGGGCCUUGGUUGAAUAAAUCAUGGACUGUCGCAGCUAGAAUAGUUGCGGGGCGCUAUCGACGAU,50,39,57,36,182
3429,21,AALE02000022.1/49827-50019,UAAGCCAGAAGAGGUGCGUCGCCCAGGUAAAGUGUCAGAGGAGCCGUGAUCCGCUGAAGACAUUCGAGGGGGAGCGACGCCGAGACACGGUGAUUUCGGCCAUCAGCGUGUCGACUGCAGGGGCUGAAUCCCCUGGGUUGUCACCAGUGCCGUUCCUUUAGGGCGGUCAACAAGGUGGAGCGCUUCUGGGUGU,39,38,69,47,193
3430,21,FQ670178.1/927246-927070,UACAAAAGUAGAGGCGCAAUUAUUAUAAGUAUUUUUUCAGAGUGGAUAACGAAGAAGAAAAAAGAAAGGAAUAGUUGCCGAAAUCAAAUAAAAGUCGUUUUGUUUGGUUGGUGGCGUGCUCGAAAGGGGCGACACUGUCAUAGUUUUUCUGAUUAACUAUGGAGUGCUACGGUUGUU,58,53,46,20,177
3431,22,AL766849.1/65640-65772,AGACGGACUUCUGGAGAGACCUAUAAGUAGCAACAUCUUUGUAUUGACACCAAGAUGUGCUCUAGGCGCCGAAGGGGCAAGAAGAGUAAAACAACUCCUCCAAUCUCUCAGGCAAAAGGACAGAAGCUAAAAG,48,24,32,29,133
3432,22,AL766849.1/65560-65639,UGACGUCAUUCAGGAGAAGAAAGUUAGACUUUCGCCGAAGGAAUUACACUCUCAGGUGUCUUAAGACAGGACUGAUUGAC,25,20,20,15,80
3433,22,CR522870.1/1448610-1448703,AUGAACAUAGCAGGAGAGAUUUUUCCCAUGGCAGUACGGAUGGGGAAGGCACCGAAGAAGUAAAUCUUUCAGGUCAAAGGACUGCUAUGGGACG,30,19,29,16,94
3434,22,CR522870.1/1448704-1448793,AGCCUCUGGAGAGUCUCAUUAUGGGCACCGAAGGAGCAAGCCAGCGUGUAGCUGGUGAACCUCUCAGGUACAAGGGACAGAGUGUAGCAG,24,16,30,20,90
3435,22,BX842577.1/344356-344453,CGCUCUAGUGCGGGAGAGUUCUGUGGCUGCCAGCUACGGACGCCGAAGGAGCAAUACCUCUCCGUCAACCUCUCAGGCACCCGGACCGCGCGAGACUA,20,16,29,33,98
3436,22,BX842577.1/344457-344587,UGCCUCUGGAAAGCGGUGGCGACCCCUGGCGGUCCUCACCCGCCGAUGGGGAAAGGCGAUUCACCUGACGGUGGACAGAGUCGCCGAAUCUCUCAGGCGCCUGGCGUGCAGGUGAAGACAGAGGGAGAGGG,26,19,50,36,131
3437,22,AL939108.1/255539-255444,UGACCCCGCGCGGGAGAGUCCUCCGGACAUCACCGGAGGCGCCGAAGGAGCAAAUCCUCCCCGGAAUCUCUCAGGCUCACGUACCGCACGGACGAG,21,11,29,35,96
3438,22,AL939108.1/255442-255325,UCACUCUGGAAAGCAGGGCGGGUGUCGACGGCUUCCGCUCUCACCGACGGUGAAAGCCGGGCAGAGCUCCAGGGCUCGCCCGGUGAAGCUCUCAGGUUGAGAUGACAGAGGGGGAGGC,23,18,45,32,118
3439,22,AE000516.2/79275-79185,UGACGCGAUGUGGGAGAACCUCCAUGUCGAGGCGCCGUAGGAGCAAUCUCCUCCCCGAGAAUCUCUCAGGCCCAAGCACCACACCGCCGAG,21,13,25,32,91
3440,22,AE017355.1/2242861-2242742,GGACGAAUCUCUGGAGAGACUCCCUCUCGCUUUAAAUAGCGUAGAGGAAAACGAGCACCGAAGGAGCAAAUCCGCUACUAUAGCGGAUAAUCUCUCAGGUAAAAGGACAGAGACAAGCGA,42,20,31,27,120
3441,22,AE017355.1/2242962-2242862,AUGAACCAUUCAGGAGAAGGUCUAUUGAUCUACCGACGGGGCAAAAAGUUGUUAACCGACUUUGAAACUCUCAGGUCUUGUUUACAAGUAGAACUGCAUGG,31,27,24,19,101
3442,22,AL596168.1/161626-161717,GUGAAUGUAAACAGAGAGACUGUGAAAAGCAGCGCCGACGGGGAAAGCAUAAGUUAUGUGAAACUCUCAGGCAAAAGGAUGUUUACGGGACG,33,16,29,14,92
3443,22,BX640445.1/160210-160126,ACGUGCAGUUCGGGAGAGACCGUCCAGCGGACGGCGCCGACGGAGCAACCACCCCGGAAACUCUCAGGCAAAAGGACCGACCUGC,22,7,27,29,85
3444,22,BX640445.1/160122-160016,AACAUCUGGAGAGUGGCGCGCGGUACGGCGCCCACCGAAGGGGAUCCCUGGCGCGUUUGCAGCGGCGCACGGGUGAAGCUCUCAGGUAAAUGGACAGAUGGGGUUGC,21,17,42,27,107
3445,22,D84432.1/169999-170100,AUGACAGCAAGGGGAGAGACCUGACCGAAAACCUCGGGAUACAGGCGCCGAAGGAGCAAACUGCGGAGUGAAUCUCUCAGGCAAAAGAACUCUUGCUCGACG,33,13,31,25,102
3446,22,BX640439.1/206443-206535,ACGCAUGUCGCGGGAGAGAGCGGCCGAUUGCGGCUGCCGCCGAAGGCGCAAUUCGCCCGGAAUCGCUCAGGUAACCCAUACCGCGACUGCAUC,19,13,30,31,93
3447,22,AL591978.1/212840-212931,GUGAAUGUAAGCAGAGAGACUGCGAAAAGCAGCGCCGACGGGGAAAGCAUAUAUUAUGUGAAACUCUCAGGCAAAAGGAUGUUUACGGGACG,32,16,29,15,92
3448,22,CR543861.1/1990167-1990077,AUGAUUAUUGCAGGAGAGAUAUUCUUGCAAAGGAUACGCCGAAGGAGCAACGACCCCGGAAACUCUCAGGCAGAAGGACUGUAAUAAUCGA,32,17,24,18,91
3449,22,CR543861.1/1990073-1989965,AUAAUCUGGAGAGAAGUAUUUCAAAAAUACUCACCGAAGGGGAUGGUACGUAGAUUUAUGGAAAUCUAUAGCUACCGAAGCUCUCAGGUACCCUGACAGAUGGGGCAAC,37,25,27,20,109
3450,22,CR378670.1/15794-15904,AGCCUCUGGAGAGACCCGUUAAAUCGGGCGCCGAAGGAGCAAGCUUUCCUUUUUGCUGUUUUAACAUGCAUGGAAAGUGAAACUCUCAGGCAAAAGGACAGAGGAGAUAAG,34,24,31,22,111
3451,22,AJ312125.1/453-315,AGACGAUACUCUGGAGAGACCAUAUAAGGCACCGAAGGAGCAAAUUUAAUUGAGAUCUUUAUAUAAAUAAAAAAGCUCAUCCCUUUUUUAGAUCAAGCGAUUAAAUGAAUCUCUCAGGUAAAAGGACAGAGAACUGAAU,56,35,26,22,139
3452,22,AJ312125.1/523-454,AUGAAGGUGGCAGGAGAGACCCAUGAGGGGCGCCGAAGAAGUAAAGCUUUCAGGCUUAGGACUGUCAUCA,21,12,24,13,70
3453,22,AL939123.1/278145-278052,UGAAUCCGCGCGGGAGAGUCCCCGGCCGCGCCGGGGCGCCGAAGGAGCAAGUCCCUCCCUUGAAUCUCUCAGGCACCGUUACCGCGCGGGCGAG,15,12,33,34,94
3454,22,AL939123.1/278050-277936,CACAUCUGAAAAGCGGACCGCCCCCGACGGCGGUCCCACCCAAGGUGCAAGCCCUGAUCGCCGUACUCCGGUGGCCGUGGCGAACCUCUCAGGUUCCGAUGACAGAUGGGGAGGA,24,16,36,39,115
3455,22,AJ301559.2/6878-7012,UUCGACAACUCUGGAAAGUGGUGGGAGCACCCACCCGCCCAAGGGGAAAGGUGCCGGUGCGCGCAUGUCAGCGCGCCGUGUUCUACCGAAUCUCUCAGGCGCACGCGUCAGCGAGCACACGACAGAGGGGGAGGA,30,18,47,40,135
3456,22,AJ301559.2/6784-6876,CGCCUGCGCGGGAGAGUUCCGAGGCAUCCAGUCUCGGACGCCGAAGGAGCAAUACCUCCCCGUCAAUCUCUCAGGCACACGGACGCGUGUGGG,18,14,30,31,93
3457,22,BX572605.1/160670-160756,CUAAGUCGCGUCGGGAGAGAUCGGCCGCAAGGCCGGCGCCGAAGGAGCAACCGCCCCGGAAACUCUCAGGCAAACGGACCGCGCGGC,20,6,31,30,87
3458,22,BX572605.1/160757-160849,CGACUGACAUCUGGAAAGAGACCCUGCCGGGCGAUCCCGGGACGGGUCCGCCGACGGGAUAAUGCUCUCAGGCACAGCGACAGAUGGGGCUCG,20,12,33,28,93
3459,22,AE016822.1/1714518-1714420,GAGGCCGAUGCGGGAGAGCUGCGGGGGAGAACCCGCCCGCGGCACCGAAGGAGCAAUCCUCCCCGACAAUCUCUCAGGUACGCGUACCGCAUCGGACUG,21,11,34,33,99
3460,22,BX897699.1/1435970-1435876,UUUUGCGGGAGAGUGCAGGCUGCAAGUUUUUGGGUCUGCCGCCGAAGGGGAAAAUAGCCCGUAAUCUCUCAGGCUCUAAGGACCGUAAAAGAAGA,25,21,30,19,95
3461,22,BX897699.1/1435871-1435783,CAGAUCUGGAAAGUCGGGAGGGGCCGCGCCGAAGGUGUAAGCGAAAACUUUUUUCGCGAGUCUCUCAGGUUUGUAACAGAGGGGUGCAG,21,19,32,17,89
3462,22,BX950851.1/2645129-2645034,UUGAAGCCAACUGGAGAGAGGUUGCGAUGCAACCCACCGAAGGGGCAAGCAGCUCUGCUGCGUAAACUCUCAGGUAAAGCGGACAGAGGGAGUGGC,27,14,33,22,96
3463,22,BX950851.1/2645260-2645133,CCGCUCCUCGCAGGAGAGAGGGCGUGUACUCCAGCAUACUUCAAGCUACAUGUACGUUGGCAUAAAGUAUAACGCUCCGCCGAAGGCGCAAACUCCCAUAAUCGCUCAGGCUACCCUAACUGCGAAUU,34,26,29,39,128
3464,22,AE008691.1/313165-313055,AUGAAGAUAGCGAGAGAUUAUCUUCCAUAAAUGGAAGAUAGCCGAAGGGGAAAUACAAAGGCCCGCCAAGCCUUUGUAGAAGCUCUCAGGCGGCAGGAUCGCUAUCGGAUA,37,21,31,22,111
3465,22,AE008691.1/1826306-1826220,AUAUCCCGGAAAGCCUCUAAAGAGGCACCGAAGGAGCAAUUCUUCUAUAAAGAAGAAUCUCUCAGGUAAACAGACGGGGGAAUAAAA,35,15,20,17,87
3466,22,AE008923.1/1392465-1392356,CAACUCUGGAGAGACCGGCCGAUGCCGGCGCCGAAGGGGCACGAAACGCAGGCAGGCCACGCGCCAGGCCGCGUUUUUAAACUCUCAGGCAAAAGGACAGAGGGGCGCGA,28,10,39,33,110
3467,22,AL591688.1/1674990-1674906,CGACCUCGUUGGGAGAAACCGGUUCGAUCCGGUGCCGAAGGAGCAACCGCCCCGGAAACUCUCAGGCCAAAGGACCAGCAAGGUG,22,10,27,26,85
3468,22,AE014292.2/713320-713218,UAAGACAACUCUGGAAAGUCGGGGGCAACUCCGCGCCGAAGGUGUAAGUAUGGCUUUAUAUAUAGCCAUGCGAGUCUCUCAGGCCUGAGACAGAGGGGCACGA,28,20,32,23,103
3469,22,AE004439.1/116056-116172,AACCCUUGGAGAGAGCCGUUAUAUUAAAAAGAGAUAAAACGGCCGCCGAAGGCGCAAAAAGAGCGGUUAAUUUUUCCGUUUUUUCAAACGCUCAGGCAAAAGGACAGGGGCAACAAG,42,22,30,23,117
3470,22,AE008691.1/1826408-1826312,AUGAAGAAUGCGGGAGAGACCCUAACCGGGCGCCGAAGGAGCAAGCGGGUAUAUGGCCUGUAUACUCGUGAAACUCUCAGGCAAAAGGACCGCAUUC,29,15,30,23,97
3471,22,BX842572.1/79202-79095,CAACUCUGGAGACAGGGACGGUCGCACCGACCGUGCCUGACCGAAGGUGUAGAGCGGCGCCAUGAUGCGACGCCGCAGACUCUCAGGUUUCAGGACAGAGCGGGGAGG,24,14,40,30,108
3472,22,AE008922.1/1299977-1299896,GUAACACGGUGGGAGAAGCGGCACUGCCGCUGCCGAAGGCGCAACAGCCCGUAAUCGCUCAGGCCCGAUACCAUCUUCAACA,21,11,23,27,82
3473,22,CP000919.1/381215-381303,GGACGGAACUCUGGAGAGACCGUAAAGGCACCGAAGGGGCAAGGCAGGCAACUGCUCAAACUCUCAGGUAAAAGGACAGAGCUAGGAUA,31,10,29,19,89
3474,22,CP000262.1/1070832-1070913,UGAUGUCAUGCAGGAGAAGAAUUUAUUUUCGCCGAAGGAGUUAUACUCUCAGGUGUUCAGUUUUUGAACGGGACUGUUUGAU,20,29,22,11,82
3475,23,AACY023629992.1/266-216,AUCGUUCAUCCUUAAGGGGACGGAAGUAGUCGCAAGACGAAGGAACGCAUU,16,10,15,10,51
3476,23,AACY021446275.1/546-496,AACGUUCAACCUUUUAGGUCGGAAGUAGGUAUGACACCGAAGGAACGCAUC,16,11,13,11,51
3477,23,AACY020096225.1/379-325,AUCGUUCAAUCUGUUAAGACAGAUCGGAAGUAGGAUUAAGCCGAAGGAACGCGGA,19,11,16,9,55
3478,23,AACY020374393.1/1155-1100,AUCGUUCAAUUUGCCUAAGGCAAAUCGGAAGUAGGUUAAAACCGAAGGAACGCGGA,20,11,15,10,56
3479,23,AACY022479074.1/704-652,AUCGUUCAACUCAUUUAGAGUCGGAAGUAGGCAUUGUGCCGAAGGAACGCAUG,15,13,15,10,53
3480,23,AACY023448407.1/161-213,AUCGUUCAUCUCGAAAGAGACGGAAGUAGGUAAUGAUACCGAAGGAACGCAUC,19,10,14,10,53
3481,23,AACY020454040.1/772-835,UACGUUCAUCUCAACACAUUGUUGGGACGCAAGUAGUCUGAGAAAGCAGAUGAAGGAACGGGAA,22,13,18,11,64
3482,23,AACY023910677.1/99-149,AUCGUUCAUCUCUUAGGAGACGGAAGUAGGGUAAAACCGAAGGAACGCCGC,16,9,15,11,51
3483,23,AACY023256552.1/1488-1436,CACGUUCAUCUUUUAAUUAAGACGGAAGUAGACGAAAGUCGAAGGAACGCAUG,19,12,13,9,53
3484,23,AACY020889107.1/472-419,AUCGUUCAUCCUCUUAGAGGACGGAAGUAGGUAAUGAUACCGAAGGAACGCAUC,17,12,14,11,54
3485,23,AADV02000064.1/2221-2140,AUCGUUCAUCUCUACAUUGCCAUAAACAAAGACAAUUAAGAGACGGAAGUAGGCUGUGAAUAAGUUGCCGAAGGAACGCUUU,29,20,18,15,82
3486,23,AACY024098432.1/677-625,AUCGUUCAUCUUCGAAAGAAGACGGAAGUAGACGAAAGUUGAAGGAACGCGCC,19,9,15,10,53
3487,23,CP001291.1/2301537-2301596,AUCGUUCAUCCUUCUAGUUUUGGAGGACGGAAGUAGGGAAAAAUCCCGAAGGAACGCGCU,17,14,17,12,60
3488,23,AACY023583366.1/744-690,CACGUUCAUCACCUUUUAGGGUGACGGAAGUAGACGAAAGUCGAAGGAACGCAUG,17,11,16,11,55
3489,23,AACY020126282.1/48-101,AUCGUUCAACUUCAUUGCGAAGUCGGAAGUAAGCGAAAGCUGAAGGAACGCAAC,19,10,14,11,54
3490,23,AACY021286276.1/276-222,CUCGUUCAUCUUCGCAAGAAGACGGAAGUAGGUAAUGGUACCGAAGGAACGCAUC,17,11,15,12,55
3491,23,AACY020065980.1/2452-2400,UUCGUUCAUCCCGAAAGGGACGGAAGUAGGUGAUAAUACCGAAGGAACGCAUC,17,10,15,11,53
3492,23,CP001344.1/2330090-2330186,AUCGUUCAUCUCUCCAAUUAAUCCGACUUUGACAACCGGGAUGGACCUCUUACAGGUGGGAGAGACGGAAGUAAGGAUAAUCCUGAAGGAACGCGCC,28,21,25,23,97
3493,23,AACY020697594.1/342-285,AUCGUUCACCUCAUAAAUUGAGUGAGACGGAAGUAGGUUAAAACCGAAGGAACGCAGU,21,12,15,10,58
3494,23,AACY023615516.1/805-855,AUCGUUCAUCUCUUAGGAGACGGAAGUAGGUGAAAACCGAAGGAACGCGCC,16,9,15,11,51
3495,23,AACY021920004.1/496-547,AUCGUUCAACCCUUAAUGGGUCGGAAGUAGGCAUCAGCUGAAGGAACGCGCA,15,10,15,12,52
3496,23,AACY022706645.1/449-509,UACGUUCAUCCUAAUUUAAUCAAAUUAGGACGGAAGUAGUCGUGAGACGAAGGAACGCAUU,21,16,14,10,61
3497,23,AACY020280405.1/1415-1365,UACGUUCAACCUUUAUGGUCGGAAGUAAGCUUGAAGCUGAAGGAACGCAUU,15,14,13,9,51
3498,23,AACY020273812.1/1347-1407,AUCGUUCAAUUCUCAUUAAUUUUUGAGGAUCGGAAGUAGGUUUAUACCGAAGGAACGCGGA,18,19,15,9,61
3499,23,AACY020439894.1/2209-2267,AUCGUUCAUCUCAUUUAAUGAGUGAGACGGAAGUAGGUUGAAAGCCGAAGGAACGCUGU,18,15,17,9,59
3500,23,AACY023581058.1/940-990,AUCGUUCAACCCAUUUGGGUCGGAAGUAAGCUGCAGCUGAAGGAACGCGAA,15,10,15,11,51
3501,23,AACY021104451.1/221-174,UACGUUCAUCCUCAGGGACGGAAGUAGCACAAAGCGAAGGAACGCACU,16,7,13,12,48
3502,23,AACY022220894.1/505-453,UUCGUUCAUCUCGUAAGAGACGGAAGUAGGUAAUGAUACCGAAGGAACGCGCU,16,12,15,10,53
3503,23,AACY023651030.1/1094-1040,UACGUUCAUCAUGUUUAAGCAUGACGGAAGUAGGCGAAAGCUGAAGGAACGCAUG,18,12,16,9,55
3504,23,AACY022943789.1/314-366,AUCGUUCAACUCUUUUUGAGUCGGAAGUAAGCAUUGUGCUGACGGAACGCAUG,13,16,14,10,53
3505,23,CP001291.1/4627294-4627352,AUCGUUCAUCUCUAUUCAAGCAGAGACGGAAGUAGGGAAAGUUCCCGAAGGAACGCGCC,18,11,16,14,59
3506,23,AACY023585828.1/575-523,AUCGUUCAUCUCGAAUGAGACGGAAGUAGGUAAUGAUGCCGAAGGAACGCACC,17,10,15,11,53
3507,23,AACY021334105.1/438-378,AUCGUUCAAUUUAAAUGGAAACAUUUAGAUCGGAAGUAGACAUUAGUCGAAGGAACGCAUG,23,16,14,8,61
3508,23,AACY022841699.1/33-83,AUCGUUCAUCUCUUAGGAGACGGAAGUAGGUGAAAACCGAAGGAACGCGCC,16,9,15,11,51
3509,23,AACY020273812.1/1271-1334,AUCGUUCAUCUUUAAAAAUUUAUUUUUUAAAGACGGAAGUAGACGAAAGUCGAAGGAACGCAUG,24,19,13,8,64
3510,23,AACY023563711.1/719-665,AUCGUUCAUCCUUACUUGUAAGGACGGAAGUAGACGAAAGUUGAAGGAACGCGCC,17,12,15,11,55
3511,23,AACY020369453.1/479-531,AUCGUUCAACUUCUUAGGAAGUCGGAAGUAGGUGAAAACCGAAGGAACGCGCC,17,10,15,11,53
3512,23,AACY021448544.1/508-458,UUCGUUCAUCUAUUCACAGACGGAAGUAGGAAUUAACCGAAGGAACGCAUC,17,12,11,11,51
3513,23,AACY021624958.1/932-883,UACGUUCAACCUUAUGGUCGGAAGUAAGCUUGUAGCUGAAGGAACGCAAA,16,12,13,9,50
3514,23,AACY021990430.1/189-136,AUCGUUCAAUCUGCUUAGGCAGAUCGGAAGUAGGGUAAACCGAAGGAACGCGGA,17,10,17,10,54
3515,23,AACY023596340.1/925-870,AUCGUUCAAUUUGCCUAAGGCAAAUCGGAAGUAGGUUAAAACCGAAGGAACGCGGA,20,11,15,10,56
3516,23,AACY020635629.1/100-48,AUCGUUCAACUCUUUUAGAGUCGGAAGUAGGCAUUGUGCCGAAGGAACGCAUG,14,14,15,10,53
3517,23,AACY021091523.1/279-332,AUCGUUCAAUCUGCUAUAGCAGAUCGGAAGUAGGUAAAACCGAAGGAACGCGGA,19,10,15,10,54
3518,23,AACY023101112.1/473-526,AUCGUUCAAUCUGCUUAGGCAGAUCGGAAGUAGGUAAAACUGAAGGAACGCGGA,18,11,16,9,54
3519,23,AACY021808171.1/254-201,AUCGUUCAAUCUGUAAUUACAGAUCGGAAGUAGGUUAAACCGAAGGAACGCGGA,19,12,14,9,54
3520,23,AACY021997040.1/811-758,AUCGUUCAACUUCAAAAUGAAGUCGGAAGUAAGCGAAAGCUGAAGGAACGCAAC,22,9,13,10,54
3521,23,AACY020413443.1/1222-1165,AUCGUUCAUUCACUUAAUUGUGAACGGAAGUAAGUGUAGUACGCUGAAGGAACGCAUC,18,16,14,10,58
3522,23,AACY021167380.1/201-255,AUCGUUCAAUCUGUAUUAACAGAUCGGAAGUAGGCUAAAGCUGAAGGAACGCGGA,19,12,15,9,55
3523,23,AACY022945028.1/276-335,AUCGUUCAUCCUUUGUGAAAGGACGGAAGUAGGUAAAAAAUCAAACCGAAGGAACGCAUC,23,12,14,11,60
3524,23,AACY023404441.1/943-992,AACGUUCAACCUUAUGGUCGGAAGUAAGCUUGUAGCUGAAGGAACGUAUU,15,14,13,8,50
3525,23,AACY022102949.1/942-890,AUCGUUCAACUCUUUUAGAGUCGGAAGUAGGCAUUGUGCCGAAGGAACGCAUG,14,14,15,10,53
3526,23,AACY023054784.1/777-837,AACGUUCAUCUUAGUUUAUUCAAAUUAGGACGGAAGUAGUCGUAAGACGAAGGAACGCAUU,21,17,14,9,61
3527,23,AACY021804470.1/751-808,AUCGUUCAACCUCUUUUAAGAAGAGGUCGGAAGUAGGUUUUUACCGAAGGAACGCGGA,17,15,16,10,58
3528,23,AACY023632309.1/56-6,ACCGUUCAACUCUUCGGAGUCGGAAGUAAGCGAAAGCUGAAGGAACGCGCU,15,9,15,12,51
3529,23,AACY021531642.1/147-98,AUCGUUCAUCUCCCUAGGGAGACGCAAAAGUCUGACUGAAGGAACGGAAA,17,9,13,11,50
3530,23,ABLZ01115713.1/5-56,CACGUUCAUCCCUAUUGGGACGGAAGUAGGCAUAGUGCCGAAGGAACGCAUU,14,11,15,12,52
3531,23,AACY020353363.1/977-1031,AUCGUUCAAUUUGCAGUUUGCAAAUCGGAAGUAGGUUAAACCGAAGGAACGCGGA,18,13,15,9,55
3532,23,AACY020151967.1/2109-2053,AUCGUUCAAUUUGCUGAAAAGUAAAUCGGAAGUAGGGUAAAACUGAAGGAACGCGGA,22,12,16,7,57
3533,23,AACY020469105.1/599-649,ACCGUUCAACUCUUAUGAGUCGGAAGUAAGCGAAAGCUGAAGGAACGCACC,17,9,13,12,51
3534,23,AACY020013751.1/1778-1725,AUCGUUCAUCCUUUCUUGGGACGGAAGUAGGUAAUAGUACUGAAGGAACGCAUC,15,15,14,10,54
3535,23,AACY020353363.1/909-964,UACGUUCAUCAUUCUUUUUGAAUGACGGAAGUAGACGAAAGUCGAAGGAACGCAUG,18,15,14,9,56
3536,23,AACY022420381.1/85-30,AUCGUUCAAUCUGUAAAUUACAGAUCGAAAGUAAGCUAAAGCUGAAGGAACGCGGA,22,12,13,9,56
3537,23,AACY022800866.1/545-492,AUCGUUCAUCCUUUUAGAGGACGGAAGUAGGUAAUGAUACCGAAGGAACGCAUC,17,13,14,10,54
3538,23,AACY022227654.1/290-337,UACGUUCAUCCCACUGGGACGGAAGUAGCACAAGCGAAGGAACGCACU,15,7,13,13,48
3539,23,AACY023856333.1/582-634,AUCGUUCAACUCUUUUAGAGUCGGAAGUAGGCAUUGUGCCGAAGGAACGCAUG,14,14,15,10,53
3540,23,AACY020556514.1/1195-1142,AACGUUCAUCCUUUCUUGGGACGGAAGUAGGUAAUAAUACUGAAGGAACGCAUC,17,14,13,10,54
3541,23,AACY023256552.1/1428-1374,AUCGUUCAAUUCUUGUUAAAGAAUCGGAAGUAGGGGUGACCCAAAGGAACGCGGA,18,12,16,9,55
3542,23,AACY020369125.1/2096-1954,AACGUUCAUCUUAUUUUUAUAAUAAGACGGAAGUAGGAAGAUAGGAAAACCUCUUUCUUUUUCAAAGAAAGGCAAGCAAGUACCGCUUAGGUUUAAUUAUCAUAGGCGGGAACGAGACCGAAUAUCUGCCGAAGGAACGCGUU,49,38,32,24,143
3543,23,AACY020365577.1/386-334,AACGUUCAUCUUUAAUAAAAGACGGAAGUAGGUUAAAACCGAAGGAACGCGCC,21,10,12,10,53
3544,23,AACY023635669.1/546-599,AUCGUUCAAUCUGCAAUAGCAGAUCGGAAGUAGGUAAAACCGAAGGAACGCGGA,20,9,15,10,54
3545,23,AACY023048471.1/328-273,AUCGUUCAACCUAUUAUUAUAGGUCGGAAGUAAGCCAAAAGCUGAAGGAACGCGCA,20,12,13,11,56
3546,23,AACY023856333.1/647-701,AUCGUUCAACCUAUUUUAUAGGUCGGAAGUAAGCCAUAAGCUGAAGGAACGCGCA,18,13,13,11,55
3547,23,AACY021814745.1/474-524,AUCGUUCAACUCUUCGGAGUCGGAAGUAAGCGAAAGCUGAAGGAACGCGCU,15,10,15,11,51
3548,23,AACY023928750.1/299-245,AUCGUUCAAUCUACUAUGUAGAUCGGAAGUAAGCUUCUUGCUGAAGGAACGCGCA,16,15,13,11,55
3549,23,AACY020152915.1/1984-1930,AUCGUUCAAUCUGAAUAUUCAGAUCGGAAGUAGGUUAAUACUGAAGGAACGCGGA,19,14,14,8,55
3550,23,AACY022486863.1/771-716,UACGUUCAUCACUCUUUAAGGGUGACGGAAGUAGACGAAAGUCGAAGGAACGCAUG,18,12,16,10,56
3551,23,AACY020348126.1/16-72,AUCGUUCAACCUAUUUUAAAUAGGUCGGAAGUAAGCCUAAAGCUGAAGGAACGCGCA,20,13,13,11,57
3552,23,AACY020392098.1/1276-1328,AUCGUUCAACUUCUUAGGAAGUCGGAAGUAGGUAUAAACCGAAGGAACGCGCC,17,11,14,11,53
3553,23,AACY020466052.1/1039-901,AUCGUUCAUUCAAUGCUCUUUUUUAGUGCAUUGAACGGAAGUAGGAAGAUAGGAAAACCUCUUUCUGCACGAUGUGUAGAAAGGCUAGCUAGUACCUUUUAUAGGGAACGAGACCGAAUAUCUACCGAAGGAACGCGUU,42,39,33,25,139
3554,23,AACY020497055.1/1213-1265,AUCGUUCAUCUUCGUAAGAAGACGGAAGUAGGUGAAAGCUGAAGGAACGCGAC,18,10,16,9,53
3555,23,AACY020142594.1/4369-4319,AUCGUUCAUCUCUUAGGAGACGGAAGUAGGUGAAAACCGAAGGAACGCCGC,16,9,15,11,51
3556,23,AACY023123681.1/544-598,AUCGUUCAAUUUGCAGUUUGCAAAUCGGAAGUAGGUUAAACCGAAGGAACGCGGA,18,13,15,9,55
3557,23,AACY020399442.1/4403-4350,UACGUUCAUCCUUAACAGGACGGAAGUAGGCACAUAAUGCCGAAGGAACGCAUU,18,11,13,12,54
3558,23,AACY021760230.1/315-257,AUCGUUCAAUUUAAGAUUUUCUUAAAUCGGAAGUAGGUCUUGGACCGAAGGAACGCAUG,18,18,14,9,59
3559,23,AACY020228028.1/1238-1290,AUCGUUCAUCUUCGUAAGAAGACGGAAGUAGACGAAAGUUGAAGGAACGCGCC,18,10,15,10,53
3560,23,AACY020059928.1/1227-1277,ACCGUUCAACUCAUAUGAGUCGGAAGUAAGCAAAAGCUGAAGGAACGCACC,19,8,12,12,51
3561,23,AACY021837236.1/468-417,AUCGUUCAACUCUUUUAGAGUCGGAAGUAAGCGAAAGCUGAAGGAACGCAAC,18,11,13,10,52
3562,23,AACY020557518.1/854-804,AUCGUUCAUCCCUAGUGGGACGGAAGUAAGUGAAUACUGAAGGAACGCGGC,15,10,16,10,51
3563,23,AACY020508420.1/937-987,AACGUUCAACCAUUAUGGUCGGAAGUAGGUUUGAAACCGAAGGAACGCAUU,17,12,13,9,51
3564,23,AACY023216978.1/797-746,AUCGUUCAUCCCUUAGGGGGACGGAAGUAGUCGCAAGACGAAGGAACGCAUU,15,10,16,11,52
3565,23,AACY020592216.1/308-243,GUCGUUCAUCCGGUGAUUGAUUCACUGGACGCAAGUAAGCCGUUAUUGUUGCUGAAGGAACGGGAA,16,18,20,12,66
3566,23,AACY023651030.1/1027-974,AUCGUUCAAUCUGCUUAAGCAGAUCGGAAGUAGGUUAAACCGAAGGAACGCGGA,18,11,15,10,54
3567,23,AACY021278176.1/388-442,UACGUUCAUCCAGUAUUGGACGGAAGUAGUCAAACAAGUGACGAAGGAACGCCGA,19,10,15,11,55
3568,23,AACY020135087.1/1559-1611,AUCGUUCAUCUCGAAAGAGACGGAAGUAGGUAAUGAUACCGAAGGAACGCGUU,18,11,15,9,53
3569,23,AACY023868432.1/218-272,AUCGUUCAAUCUGUAUUAACAGAUCGGAAGUAGGCUAAAGCUGAAGGAACGCGGA,19,12,15,9,55
3570,23,AACY021041201.1/645-697,AUCGUUCAACUCUUUUAGAGUCGGAAGUAGGCAUUGUGCCGAAGGAACGCAUG,14,14,15,10,53
3571,23,AACY023668649.1/575-624,AUCGUUCAACCCUUAGGGUCGGAAGUAAGCUAGAGCUGAAGGAACGCGCA,15,9,15,11,50
3572,23,AACY020564829.1/2327-2380,AUCGUUCAACUUCAUUACGAAGUCGGAAGUAAGCGGAAGCUGAAGGAACGCAAC,19,10,14,11,54
3573,23,AACY022828902.1/661-611,AACGUUUAUCCUGAAACGGACGGAAGUAGGCGAAUGCUGAAGAAACGCACU,18,9,14,10,51
3574,23,AACY023484124.1/850-800,AUCGUUCAUCUCUUAGGAGACGGAAGUAGGUGAAAACCGAAGGAACGCGCC,16,9,15,11,51
3575,23,AACY020763994.1/168-217,UACGUUCAUCAUAUAGACGGAAGUACCCAAUCUUGGGGAAGGAACGCACU,16,11,12,11,50
3576,23,AACY020766012.1/704-649,AUCGUUCAUUUUGAAUAAUUCAAAACGGAAGUAAACGAAAGUUGAAGGAACGCAUG,23,14,12,7,56
3577,23,CP001344.1/4727152-4727068,AUCGUUCAUCUCCAACCGUGACUGACUGUCCAAUUGACCUCAGUCCUGGAGACGGAAGUAGGGAGUCAUCCCGAAGGAACGCGCC,21,17,22,25,85
3578,23,AACY021757996.1/786-841,UACGUUCAUCACUCUUUUAGGGUGACGGAAGUAGACGAAAGUCGAAGGAACGCAUG,17,13,16,10,56
3579,23,AACY020558260.1/221-140,AUCGUUCAUCUUUUGCACUAACUUAAUGCAAAAGACGGAAGUAGGAAGAUAGGAAAACCUCUUUCUUCCCAAGGGAGGAAAG,29,20,18,15,82
3580,23,AACY021551130.1/700-647,AACGUUCAUCUUUUAAUAAAAGACGGAAGUAGGUUAGAACCGAAGGAACGCAUU,21,13,12,8,54
3581,23,AACY020223595.1/743-690,AUCGUUCAACUUCAAAUUGAAGUCGGAAGUAAGCGUAAGCUGAAGGAACGCAAC,20,11,13,10,54
3582,23,AACY023718955.1/294-346,UACGUUCAUCAUGUUUACAUGACGGAAGUAGACGAAAGUCGAAGGAACGCAUG,18,12,14,9,53
3583,23,AACY021171418.1/103-54,AUCGUUCAACCAUUAAGGUCGGAAGUAGGCAAUCGCUGAAGGAACGCACC,16,9,13,12,50
3584,23,AACY022563169.1/306-361,AUCGUUCAUUUUGAAUAAUUCAAAACGGAAGUAAACGUAAGUUGAAGGAACGCAUG,22,15,12,7,56
3585,23,AACY023693896.1/653-707,AUCGUUCAACUCUUAAUGAGUCGGAAGUAGGCAAAAAUAGCUGAAGGAACGCGGA,20,11,15,9,55
3586,23,AACY020596620.1/75-130,CACGUUCAUCACUCUUUUGGGGUGACGGAAGUAGACGAAAGUCGAAGGAACGCAUG,16,12,17,11,56
3587,23,AACY022997040.1/716-663,AUCGUUCAAUCUGCUUAGGCAGAUCGGAAGUAGGGAAAACUGAAGGAACGCGGA,18,10,17,9,54
3588,23,AACY021138991.1/467-522,UACGUUCAUCACUCUUUUAGAGUGACGGAAGUAGAUGAAAGUCGAAGGAACGCAUG,18,14,15,9,56
3589,23,AACY020334651.1/828-778,AUCGUUCAACUCUUCGGAGUCGGAAGUAAGCGAAAGCUGAAGGAACGCGCU,15,10,15,11,51
3590,23,AACY020329574.1/76-132,AUCGUUCAUCUUUAUGAGAAUAAAGACGGAAGUAGACGAAAGUUGAAGGAACGCGCC,21,12,15,9,57
3591,23,AACY022008610.1/340-287,AUCGUUCAUCCUCUUAGAGGACGGAAGUAGGUAAUGAUACCGAAGGAACGCAUC,17,12,14,11,54
3592,23,AACY023527417.1/187-137,AUCGUUCAUCUCUUUGGAGACGGAAGUAGGUGAAAACCGAAGGAACGCGCC,15,10,15,11,51
3593,23,AACY023939311.1/121-171,AUCGUUCAACCCCUUUGGGUCGGAAGUAAGCAAAAGCUGAAGGAACGCACG,16,9,14,12,51
3594,23,AACY021281822.1/314-365,UUCGUUCAUCUAUCUAGACGGAAGUAAGGCUUUUAGCCUGAAGGAACGCAUU,14,16,12,10,52
3595,23,AACY021146080.1/302-254,AACGUUCACCCGUAAGGGCGGAAGUAAGCGAUCGCUGAAGGAACGCACC,15,6,15,13,49
3596,23,AACY022082177.1/731-784,UACGUUCAUCAUGUUUUACAUGACGGAAGUAGGCAAAAGCCGAAGGAACGCAUG,18,12,14,10,54
3597,23,AACY022976997.1/276-329,AUCGUUCAAUCUGUGAAAACAGAUCGGAAGUAGGUUAAACCGAAGGAACGCGGA,20,10,15,9,54
3598,23,AACY022061262.1/212-268,AUCGUUCAAUCCUUGUUUAGGAGGAUCGGAAGUAGGGGUGACCCAAAGGAACGCGGA,16,12,19,10,57
3599,23,AACY022625265.1/384-331,AUCGUUCAUCUCGAAAGAGACGGAAGUAGGUAAUGGUUACCGAAGGAACGCACC,18,10,15,11,54
3600,23,AACY020240095.1/3750-3802,UUCGUUCAUCCCGAAAGGGACGGAAGUAGGUGAUAAUACCGAAGGAACGCAUC,17,10,15,11,53
3601,23,AACY023143063.1/136-83,AACGUUCAUCUUUUAAUAAAAGACGGAAGUAGGUUAGAACCGAAGGAACGCAUU,21,13,12,8,54
3602,23,AACY022082177.1/797-850,AUCGUUCAAUCUGUGAGAGCAGAUCGGAAGUAGGUUAUACCGAAGGAACGCGGA,17,11,17,9,54
3603,23,AACY022976997.1/210-263,UACGUUCAUCAUGUUUGACAUGACGGAAGUAGGCGAAAGCUGAAGGAACGCAUG,17,12,16,9,54
3604,23,AACY021190992.1/188-242,AUCGUUCAAUUUGCAGCUUGCAAAUCGGAAGUAGGUAUACCCGAAGGAACGCGGA,17,12,15,11,55
3605,23,AACY023150189.1/558-508,AUCGUUCAUCUCUUUGGAGACGGAAGUAGGUGAAAACCGAAGGAACGCCGC,15,10,15,11,51
3606,23,AACY023048471.1/393-341,AUCGUUCAACUCUUUUAGAGUCGGAAGUAGGCAUUGUGCCGAAGGAACGCAUG,14,14,15,10,53
3607,23,AACY020315878.1/979-931,UACGUUCAGGCAUCAGGCCCGGAAGUAGCAUACAGCGAAGGAACGCACC,15,6,14,14,49
3608,23,AACY023594769.1/609-662,AUCGUUCAUCCUUUCAUAGGACGGAAGUAAGUAAUGAUACUGAAGGAACGCAUC,18,14,12,10,54
3609,23,AACY023527417.1/239-189,AUCGUUCAACUCUUCGGAGUCGGAAGUAAGCGAAAGCUGAAGGAACGCGCU,15,10,15,11,51
3610,23,AACY020287182.1/522-470,UUCGUUCAUCCCGCAAGGGACGGAAGUAGGUGAUAAUACCGAAGGAACGCAUC,16,10,15,12,53
3611,23,AACY020330816.1/316-370,AUCGUUCAUCCUUACAUGUAAGGACGGAAGUAGACGAAAGUUGAAGGAACGCGCC,18,11,15,11,55
3612,23,AACY021720846.1/116-59,AUCGUUCAAUCUGUGUGUAAACAGAUCGGAAGUAGGCUAAUAGUCGAAGGAACGCGGA,19,13,17,9,58
3613,23,BX548175.1/1564016-1564091,AACGUUGAGCUAGGUCAUCGCAUCGUCGUUGAUCCAUCAGCCGGAAGUAGCCCUCCGCAAGGCGAAGCAACGCUCC,18,14,20,24,76
3614,23,AACY023503840.1/1160-1212,AUCGUUCAACUCUUUUAGAGUCGGAAGUAGGCAUUGUGCCGAAGGAACGCAUG,14,14,15,10,53
3615,23,AACY020200469.1/970-918,UUCGUUCAUCUCGAAAGAGACGGAAGUAGGUGAUAAUACCGAAGGAACGCAUC,18,11,14,10,53
3616,23,ABYK01000008.1/24464-24568,AUCGUUCAUCUCCCCCACCCGUUAACUCAACUGGCCGUUUGUCCAGUUAUUGGUUAACGUUCUGAGGAAGACGGAAGUAGGGACCCAUGCCCGAAGGAACGCGCC,24,24,26,31,105
3617,23,AACY023485267.1/460-513,AUCGUUUAUCCUGAAACGGACGGAAGUAAACCAUCAAGGUUGAAGAAACGCUCU,19,12,12,11,54
3618,23,AACY020428904.1/56-108,AUCGUUCAACUUCUUAGGAAGUCGGAAGUAGGUGAAAACCGAAGGAACGCGCC,17,10,15,11,53
3619,23,AACY020290039.1/916-970,AUCGUUCAUCCUAUUCUUGGGACGGAAGUAAGUAAUAAUACUGAAGGAACGCAUC,18,15,12,10,55
3620,23,AACY021614818.1/456-399,AUCGUUCAUUCACUUAAUUGUGAACGGAAGUAAGUGUAGUACGCUGAAGGAACGCAUC,18,16,14,10,58
3621,23,AACY023219984.1/1097-1045,AUCGUUCAUCUUUAAAGAGACGGAAGUAGGUAAUGAUACCGAAGGAACGCAUC,19,12,13,9,53
3622,23,AACY020517659.1/979-1031,AUCGUUCAUCCUUUCACAGGACGGAAGUAGUCUAAAUGACGAAGGAACGCAUU,17,13,12,11,53
3623,23,AACY023867165.1/1312-1259,CACGUUCAUCAUGUUUAACAUGACGGAAGUAGGUGAAAGCUGAAGGAACGCAUG,18,12,15,9,54
3624,23,AACY020414671.1/2603-2498,GUCGUUUAUCUCAUAAGUAUCUUCCAGUAUCUCCUUAAAGCGCAUAGCAAUAAUUGGUUCAAAACCAUUGUGAGACGCAAGUAAGCGGAAGCUGAAGAAACGGAGU,35,28,23,20,106
3625,23,AACY023206567.1/1414-1476,UACGUUCAUCUCAACACAUCGUUGAGACGCAAGUAAGCAAGUUAAGUGCUGAAGGAACGGGAA,22,13,16,12,63
3626,23,AACY020250855.1/439-389,AUCGUUCAACUCUUCGGAGUCGGAAGUAAGCGAAAGCUGAAGGAACGCGCU,15,10,15,11,51
3627,23,AACY023733388.1/1260-1316,AUCGUUCAAUCUAUUUAUAAUAGAUCGGAAGUAAGCAUCAAGCUGAAGGAACGCAGA,22,14,12,9,57
3628,23,AACY023629456.1/59-114,AUCGUUCAAUUUGCCUAAGGCAAAUCGGAAGUAGGUUAAAACCGAAGGAACGCGGA,20,11,15,10,56
3629,23,AACY020284050.1/747-799,UUCGUUCAUCCCGAAAGGGACGGAAGUAGGUGAUAAUACCGAAGGAACGCAUC,17,10,15,11,53
3630,23,AACY022607344.1/286-339,AUCGUUCAUCCUUUCUUGGGACGGAAGUAGGUAAUAGUACUGAAGGAACGCAUC,15,15,14,10,54
3631,23,AACY023647930.1/323-375,AUCGUUCAACUCUUUUAGAGUCGGAAGUAGGCAUUGUGCUGAAGGAACGCAUG,14,15,15,9,53
3632,23,AACY020385429.1/505-455,AUCGUUCAACUCUUCGGAGUCGGAAGUAAGCGAAAGCUGAAGGAACGCGCU,15,10,15,11,51
3633,23,AACY020505512.1/1073-1023,AUCGUUCAUCUCUUAGGAGACGGAAGUAGGUGAGAACCGAAGGAACGCGCC,15,9,16,11,51
3634,23,AACY020066766.1/2162-2111,AACGUUCAUCCAUAUAGGACGGAAGUAGACUACUCAGUCGAAGGAACGCAUU,18,11,12,11,52
3635,23,AACY023850522.1/1345-1290,AUCGUUCAAUUUGCCAAAGGCAAAUCGGAAGUAGGUUAAAACCGAAGGAACGCGGA,21,10,15,10,56
3636,23,AACY023076791.1/480-417,UUCGUUCAUUCACUCUAAAUGUAGCAGUGAACGGAAGUAGUCAAUUGUGACGAAGGAACGCAUC,20,17,15,12,64
3637,23,AACY020962165.1/175-117,AUCGUUCAAUUUAAAUUUAUUUAAAUCGGAAGUAGAUCUAACGAUCGAAGGAACGCAUG,22,18,11,8,59
3638,23,AACY023195267.1/1363-1313,CACGUUCAUCCUAAGGGACGGAAGUAGGCUGAAAAGCUGAAGGAACGCACC,17,7,15,12,51
3639,23,AACY020473249.1/101-156,AACGUUCAAUCUAUUUAAAGUAGAUCGGAAGUAAGCUUAUGCUGAAGGAACGCGGU,19,15,14,8,56
3640,23,AACY021577843.1/473-532,AUCGUUCAAUUUAAGGUUAUCUUAAAUCGGAAGUAAGUCUUUUGACUGAAGGAACGCAUG,19,20,13,8,60
3641,23,AACY020990484.1/907-856,AUCGUUCAACUCUUUAAGAGUCGGAAGUAAGCGAAAGCUGAAGGAACGCAAC,19,10,13,10,52
3642,23,AACY023110175.1/103-47,AUCGUUCAUCUUUAUGUAAAUAAAGACGGAAGUAGACGAAAGUUGAAGGAACGCGCC,21,13,14,9,57
3643,23,AACY020223595.1/812-762,AUCGUUCAUCUCUUAGGAGACGGAAGUAGGUGAAAACCGAAGGAACGCGUC,16,10,15,10,51
3644,23,AACY023734044.1/988-934,AUCGUUCAUCCUAUUCUUGGGACGGAAGUAAGUAAUGACACUGAAGGAACGCAUC,17,14,13,11,55
3645,23,AACY020318127.1/532-580,AACGUUCACCCGAAAGGGCGGAAGUAGGCGGUCGCUGAAGGAACGCACC,14,5,17,13,49
3646,23,AACY020134078.1/141-91,AUCGUUCAACUCUUCGGAGUCGGAAGUAAGCGAAAGCUGAAGGAACGCAAC,17,9,14,11,51
3647,23,AACY023364796.1/691-744,UACGUUCAUCAUGUUUUACAUGACGGAAGUAGACGAAAGUCGAAGGAACGCAUG,18,13,14,9,54
3648,23,AACY021674813.1/801-750,UACGUUCAUCCUAAUAGGACGGAAGUAAGCAAUAAAGCUGAAGGAACGCACC,20,9,12,11,52
3649,23,AACY021012785.1/619-669,AUCGUUCAACUCUUCGGAGUCGGAAGUAAGCGAAAGCUGAAGGAACGCAAA,18,9,14,10,51
3650,23,AACY020117051.1/1198-1249,AACGUUCAACCUUUUUUGGUCGGAAGUAGGUUUGAAACCGAAGGAACGCAUC,15,14,13,10,52
3651,23,CP000806.1/2393902-2393983,GUCGUUCAUCUCUACAUUGUUAGGAAAAAACGCAGUGAAGGGACGGAAGUAGGCUUGCAAUCUAGAGCCGAAGGAACGCUCA,26,17,23,16,82
3652,23,AACY024067319.1/594-648,AUCGUUCAAUCUGUAUGAACAGAUCGGAAGUAGGUUAAACCCGAAGGAACGCGGA,19,11,15,10,55
3653,23,AACY020880957.1/394-444,AACGUUUAUCCUGAAACGGACGGAAGUAGGCGAAUGCUGAAGAAACGCACU,18,9,14,10,51
3654,23,AACY021182484.1/448-394,AUCGUUCAACUCAUUGUGAGUCGGAAGUAAGUACAUAGUACUGAAGGAACGCAUG,18,14,14,9,55
3655,23,AACY020450414.1/979-851,CACGUUCAUCUGGCACGAGUAAAAGUAGGUCAGACGGAAGUAGGCAGAUAAAAAUACAUCUCUUCAAAAAGAGAGGUUCGCAUCAAGCGUCCGCUUGUUGCAUUAAACAAUCUACCGAAGGAACGCAUU,45,28,29,27,129
3656,23,AACY021091523.1/213-266,UACGUUCAUCAUGUUUUACAUGACGGAAGUAAGCGAAAGCUGAAGGAACGCAUG,18,13,14,9,54
3657,23,AACY022263612.1/518-567,CUCGUUCAUCCUAAAAGGACGGAAGUAGGCUUUUGCCGAAGGAACGCACC,14,10,13,13,50
3658,23,AACY023535011.1/418-359,AUCGUUCAAUUUAAGAGAUAUCUUAAAUCGGAAGUAAGUCAUUGACUGAAGGAACGCAUG,22,17,13,8,60
3659,23,AACY022460121.1/377-327,UUCGUUCAUCUAUUCACAGACGGAAGUAGGAAUUAACCGAAGGAACGCAUC,17,12,11,11,51
3660,23,AACY023620377.1/162-110,AUCGUUCAUCUUCGUAAGAAGACGGAAGUAGGUGAAAACUGAAGGAACGCGAC,19,10,15,9,53
3661,23,AACY022008610.1/398-344,AUCGUUCAUCCCAUUCUUGGGACGGAAGUAGUCAAUUUAGACGAAGGAACGCAUU,16,15,13,11,55
3662,23,AACY022710041.1/208-77,AUCGUUCAUUCCUUGCUACAUUUUGAUGCAAGGAACGGAAGUAGGAAGAUAGGAAAACCUCUUUCUUUUUAAAGAAAGGCAAGCAAGUACCGAUAAGGGAACGAGACCGAAUAUCUACCGAAGGAACGCGUU,46,31,31,24,132
3663,23,AACY020280406.1/573-635,AUCGUUCAUCUCACUUAAUGGAGGCGGAAGUAGGUAACGGGAGAAUUAAUAAAGGAACGCAAC,23,13,17,10,63
3664,23,AACY020000274.1/383-329,AUCGUUUAUCCUGAAACGGACGGAAGUAAACCAUUUAAGGUUGAAGAAACGCUCU,19,14,12,10,55
3665,23,AACY020074155.1/1580-1526,AUCGUUCAAUCUGCUUAGGCAGAUCGGAAGUAGGUGAAAGCCGAAGGAACGCGGA,17,10,18,10,55
3666,23,AACY023900896.1/472-527,UACGUUCAUCACUCUUUUAGAGUGACGGAAGUAGACGAAAGUCGAAGGAACGCAUG,18,13,15,10,56
3667,23,AACY023039004.1/333-281,AUCGUUCAACUUCUUAGGAAGUCGGAAGUAAGCGAAAGCUGAAGGAACGCGCC,17,10,15,11,53
3668,23,AACY020443845.1/3289-3345,AUCGUUCAACCUAUUUUAUAUAGGUCGGAAGUAAGCGAUAAGCUGAAGGAACGCGCA,19,14,14,10,57
3669,23,AACY020507360.1/1227-1177,AUCGUUCAUCCAAUUACGGACGGAAGUAGGCAGCAGCCGAAGGAACGCGCU,15,8,15,13,51
3670,23,AACY020557797.1/2401-2458,AUCGUUCAUUCACUUAAUUGUGAACGGAAGUAAGUGUAGUACGCUGAAGGAACGCAUC,18,16,14,10,58
3671,23,AACY021541586.1/301-246,AUCGUUCAUUUUGAAUAUUUCAAAACGGAAGUAAACGAAAGUUGAAGGAACGCAUG,22,15,12,7,56
3672,23,AACY020387692.1/419-478,AUCGUUCAUCUCAUUUGCUGAAUGAGACGGAAGUAGGUUAGAGGACCGAAGGAACGCAGU,18,14,18,10,60
3673,23,AACY020065980.1/2516-2453,AUCGUUCAUUCACUCUAAAUGUAGCAGUGAACGGAAGUAGUCAAUUGUGACGAAGGAACGCAUC,21,16,15,12,64
3674,23,AACY020116233.1/50-104,AUCGUUCAAUUUGCAGCUUGCAAAUCGGAAGUAGGUAUACCCGAAGGAACGCGGA,17,12,15,11,55
3675,23,AACY023162460.1/756-811,AUCGUUCAUUUUGAGUAUCUCAAAACGGAAGUAAGCGAAAGUUGAAGGAACGCAUG,20,14,14,8,56
3676,23,AACY020034953.1/1566-1629,UACGUUCAUUCACUCUAAAUGUAGCAGUGAACGGAAGUAGUCAAUUGUGACGAAGGAACGCAUC,21,16,15,12,64
3677,23,AACY023099954.1/186-238,AUCGUUCAUCUUCGAGAGAAGACGGAAGUAGGUGAAAGCUGAAGGAACGCGAC,18,9,17,9,53
3678,23,AACY022839264.1/329-384,AUCGUUCAAUCUAACUAGUUUAGAUCGGAAGUAGGCCACAGCUGAAGGAACGCGCA,18,12,14,12,56
3679,23,AACY023895541.1/302-248,AUCGUUCAUCCCCUUAUUGGGACGGAAGUAGUCAAUUUAGACGAAGGAACGCAUU,16,15,13,11,55
3680,23,AACY020564601.1/2625-2575,AUCGUUCAACUCUUCGGAGUCGGAAGUAAGCGAAAGCUGAAGGAACGCAAA,18,9,14,10,51
3681,23,AACY023615516.1/753-803,AUCGUUCAACUCUUCGGAGUCGGAAGUAAGCGAAAGCUGAAGGAACGCGCU,15,10,15,11,51
3682,23,AACY020151967.1/68-14,AUCGUUCAAUUUGCAUUUUGCAAAUCGGAAGUAGGUAUGCCCGAAGGAACGCGGA,16,14,15,10,55
3683,23,AACY023939311.1/55-108,AUCGUUCAACUCUUAUUUGAGUCGGAAGUAGACAGUUUGUCGAAGGAACGCAUG,15,16,14,9,54
3684,23,AACY023721140.1/113-50,AUCGUUCAUUCACUCUAAAUGUAGCAGUGAACGGAAGUAGUCAAUUGUGAUGAAGGAACGCAUC,21,17,15,11,64
3685,23,AACY022240520.1/660-720,AACGUUCAUCCUAGUUUAUUCAAAUUAGGACGGAAGUAGUCGCAAGACGAAGGAACGCAUU,21,15,14,11,61
3686,23,AACY020507668.1/980-1038,AUCGUUCAAUCUAUUAUAAAUAAUAGAUCGGAAGUAAGCUUAAGCUGAAGGAACGCAGA,24,15,12,8,59
3687,23,AACY020443307.1/1821-1873,AUCGUUCAUCUCUGAAAAGAGACGGAAGUAAGUGAAAGCUGAAGGAACGCGCC,19,9,15,10,53
3688,23,AACY023563711.1/646-594,AUCGUUCAUCUUCGAAAGAAGACGGAAGUAGGUGAAAACUGAAGGAACGCGAC,20,9,15,9,53
3689,23,AACY020284050.1/683-746,AUCGUUCAUUCACUCUAAAUGUAGCAGUGAACGGAAGUAGUCAAUUGUGACGAAGGAACGCAUC,21,16,15,12,64
3690,23,AACY020264949.1/673-617,AUCGUUCAACCUAUCUAAAGUAGGUCGGAAGUAAGCUAACUGCUGAAGGAACGCGCA,19,12,14,12,57
3691,23,AACY022786883.1/600-481,UACGUUCAUUUUGCGGUCAGCCGCAAAACGGAAGUAGGAGGAUAAUCAAUAUUUCCUUGUGGUAAGGGAAUUCAGCAUCCCGGACGGGAUCAAUUGAGAUAUCUACCGAAGGAACGCGUU,35,30,32,23,120
3692,23,AACY020047278.1/646-693,UACGUUCAUCCUACGGGACGGAAGUAGCACUAAGCGAAGGAACGCACU,15,8,13,12,48
3693,23,AACY020324288.1/1156-1104,AUCGUUCAUCUUCGAAAGAAGACGGAAGUAGGUGAAAACUGAAGGAACGCGAC,20,9,15,9,53
3694,23,AACY022331149.1/333-275,AUCGUUCAUCUCAUUUGAUAUGAGACGGAAGUAAGUUUUCUUAACUGAAGGAACGCUGU,17,20,13,9,59
3695,23,AACY022023721.1/254-304,AUCGUUCAACUCUUCGGAGUCGGAAGUAAGCGAAAGCUGAAGGAACGCAAC,17,9,14,11,51
3696,23,AACY022403129.1/191-246,AUCGUUCAAUUUGUCUUGAGGCAAAUCGGAAGUAGGUUAAACCGAAGGAACGCGGA,18,13,16,9,56
3697,23,AACY023949594.1/699-644,UACGUUCAUCAUUCUCUUUGAAUGACGGAAGUAGACGAAAGUCGAAGGAACGCAUG,18,14,14,10,56
3698,23,AACY023410640.1/1099-1154,AUCGUUCAUUUUGAAUAAUUCGAAACGGAAGUAAACGAAAGUUGAAGGAACGCAUG,22,14,13,7,56
3699,23,AACY021620531.1/481-431,AACGUUCAACUCAUUAGAGUCGGAAGUAGGCGAAUGCCGAAGGAACGCACC,17,8,14,12,51
3700,23,AACY022716167.1/549-491,AUCGUUCAUCCUUAUUUUGGGACGGAAGUAGGUAAAAAAUCAAACCGAAGGAACGCAUC,21,14,13,11,59
3701,23,AACY023545052.1/325-271,CACGUUCAUCACUUUAUACGGUGACGGAAGUAGACGAAAGUCGAAGGAACGCAUG,18,11,15,11,55
3702,23,AACY022726119.1/235-287,AUCGUUCAACUUCUUAGGAAGUCGGAAGUAGGUAUAAACCGAAGGAACGCGCC,17,11,14,11,53
3703,23,AACY020742811.1/338-286,AUCGUUCAUCUCGUAAGAGACGGAAGUAGGUAAUGAUGCCGAAGGAACGCACC,17,10,15,11,53
3704,23,AACY023408594.1/650-704,AUCGUUCAAUCUGUAUUUACAGAUCGGAAGUAAGCCAAAGCUGAAGGAACGCGGA,19,12,14,10,55
3705,23,AACY020507668.1/916-967,AUCGUUCAACUCGAAAGAGUCGGAAGUAGGCGUAAAGCCGAAGGAACGCAUG,18,8,16,10,52
3706,23,AACY022751187.1/436-488,AUCGUUCAACUUCUUAGGAAGUCGGAAGUAGGUGAAAACCGAAGGAACGCGCC,17,10,15,11,53
3707,23,AACY021276613.1/459-397,AUCGUUCAUCUUUAGAAAUUUAUUUUUAAAGACGGAAGUAGACGAAAGUUGAAGGAACGCAUG,23,19,14,7,63
3708,23,AACY021294965.1/804-854,AUCGUUCAACCCUUUUGGGUCGGAAGUAAGCUUCAGCUGAAGGAACGCGAA,14,12,14,11,51
3709,23,AACY022841699.1/102-155,AUCGUUCAACUUCAAUACGAAGUCGGAAGUAAGCGAAAGCUGAAGGAACGCAAC,21,9,13,11,54
3710,23,AACY022496080.1/546-596,AACGUUUAUCCUGAAACGGACGGAAGUAGGCGAAUGCUGAAGAAACGCACU,18,9,14,10,51
3711,23,AACY020502525.1/286-234,AUCGUUCAUCUUCGAAAGAAGACGGAAGUAGGUGAAAACUGAAGGAACGCGAC,20,9,15,9,53
3712,23,AACY021868731.1/93-143,AUCGUUCAACUCUUCGGAGUCGGAAGUAAGCGAAAGCUGAAGGAACGCAAA,18,9,14,10,51
3713,23,AACY020783410.1/858-804,AUCGUUCAAUUUGCAGUUUGCAAAUCGGAAGUAGGUUAAACCGAAGGAACGCGGA,18,13,15,9,55
3714,23,AACY022295381.1/480-426,AUCGUUCAAUUUGCAGCUUGCAAAUCGGAAGUAGGUAUACCCGAAGGAACGCGGA,17,12,15,11,55
3715,23,AACY022614279.1/125-171,GUCGUUCAUCCAUAAGGACGGAAGUAGGGAAACCGAAGGAACGCAUC,16,7,14,10,47
3716,23,AACY023750866.1/339-287,AUCGUUCAUCUCGCGAGAGACGGAAGUAGGUAAUGGUACCGAAGGAACGCAUC,16,10,16,11,53
3717,23,AACY023374828.1/921-977,UGCGUUGAUCCUUUUGUAGGACGCAAGUAACUCUCUAGGAGAGUGAAGCAACGGGAA,16,14,17,10,57
3718,23,AACY023410640.1/1166-1220,AUCGUUCAAUCUGUAUUAACAGAUCGGAAGUAGGCUAAAGCUGAAGGAACGCGGA,19,12,15,9,55
3719,23,AACY020289447.1/869-815,UACGUUCAUCACCUUACAGGGUGACGGAAGUAGACGAAAGUCGAAGGAACGCAUG,18,10,16,11,55
3720,23,AACY023401421.1/1357-1303,AUCGUUCAAUUUGCAGUUUGCAAAUCGGAAGUAGGUUAAACCGAAGGAACGCGGA,18,13,15,9,55
3721,23,AACY020424567.1/1235-1287,AUCGUUCAUCUUCGAGAGAAGACGGAAGUAGACGAAAGUUGAAGGAACGCGCC,18,9,16,10,53
3722,23,AACY020505512.1/1004-951,AUCGUUCAACUUCACUACGAAGUCGGAAGUAAGCGAAAGCUGAAGGAACGCAAC,20,9,13,12,54
3723,23,AACY020078007.1/1062-1010,AUCGUUCAUCCCUUUUUUGGGACGGAAGUAGACAAAUGUCGAAGGAACGCAUG,15,14,14,10,53
3724,23,AACY023536350.1/519-464,AUCGUUCAAUCUGAAUUAAUUCAGAUCGGAAGUAGGUAAAACCGAAGGAACGCGGA,21,12,14,9,56
3725,23,AACY021884274.1/460-511,AUCGUUCAACUCUUUUAGAGUCGGAAGUAAGCGAAAGCUGAAGGAACGCAAC,18,11,13,10,52
3726,23,AACY020428429.1/939-889,AUCGUUCAUCUCUUAGGAGACGGAAGUAGGUGAAAACCGAAGGAACGCGCC,16,9,15,11,51
3727,23,AACY020330959.1/663-618,AUCGUUCAUCCCAAUGGGACGCAAGUAAGCCGACUCGGAACGGAUU,13,9,12,12,46
3728,23,AACY020214857.1/1668-1621,UACGUUCAUCCCACAGGGACGGAAGUAGCGAAAGCGAAGGAACGCACU,16,6,14,12,48
3729,23,AACY020210502.1/370-316,AUCGUUCAAUUUGCAGCUCGCAAAUCGGAAGUAGGUAUACCCGAAGGAACGCGGA,17,11,15,12,55
3730,23,AACY023987148.1/226-171,AUCGUUCAUUUUGAAUAAUUCAAAACGGAAGUAAACGAAAGUUGAAGGAACGCAUG,23,14,12,7,56
3731,23,AACY020400000.1/898-951,AUCGUUCAACUUCAUUACGAAGUCGGAAGUAAGCGAAAGCUGAAGGAACGCAAC,20,10,13,11,54
3732,23,AACY021255706.1/321-272,ACCGUUUAACUCGAAAGAGUCGGAAGUAGGGAAAACCGAAGAAACGCACU,20,7,13,10,50
3733,23,AACY020228028.1/1309-1361,AUCGUUCAUCUUCGUAAGAAGACGGAAGUAGGUGAAAGCUGAAGGAACGCGAC,18,10,16,9,53
3734,23,AACY021884274.1/388-440,AUCGUUCAACUUCUCAGGAAGUCGGAAGUAGGUGAAAACCGAAGGAACGCGCC,17,9,15,12,53
3735,23,AACY021486302.1/170-226,AUCGUUCAACUUACUCAUUUGUAAGUCGGAAGUAAGCGAAAGCUGAAGGAACGCAUG,19,14,14,10,57
3736,23,AACY022479074.1/639-585,AUCGUUCAACCUAUUUUAUAGGUCGGAAGUAAGCCUAAAGCUGAAGGAACGCGCA,18,13,13,11,55
3737,23,AACY021939941.1/248-307,AUCGUUCAAUUUAGGAUUUUCCUAGAUCGGAAGUAAGUCGAAAGGCUGAAGGAACGCAUG,19,16,16,9,60
3738,23,AACY020016022.1/137-85,AUCGUUCAUCUCGAAAGAGACGGAAGUAGGUAAUGAUACCGAAGGAACGCAUC,19,10,14,10,53
3739,23,CP000828.1/2595141-2595223,AUCGUUCAUCCCUUAACUCGUCUUUAACUCUAUUCUUAGUAGUCAAGGGACGGAAGUAGAGCCUUCGCUCGAAGGAACGCGCC,20,23,18,22,83
3740,23,AAUA01000001.1/657594-657669,AACGUUGAGCUCGGUCGACCUUUCGCGUCGACCCGCAAGCCGGAAGUAGCCCAUCCGCAAGGCGAAGCAACGCUCC,17,11,21,27,76
3741,23,AACY021624876.1/183-229,AACGUUCAUCCCGAAAGGGACGCAAGUAAGCCGACACGGAACGGAUU,16,6,13,12,47
3742,23,AACY020065288.1/1626-1680,AUCGUUCAUCCUUUUCUUGGGACGGAAGUAGGUAAUAAUACUGAAGGAACGCAUC,16,16,13,10,55
3743,23,AACY023867165.1/1246-1192,AUCGUUCAAUCUGCAGAAGCAGAUCGGAAGUAGGUAUUAACCGAAGGAACGCGGA,19,10,16,10,55
3744,23,AACY021037897.1/96-150,UGCGUUGAUCCUUUUGUUAGGACGCAAGUAAGGCUGAGGCCUGAAGCAACGGGAC,13,13,18,11,55
3745,23,AACY024097173.1/330-381,AUCGUUCAACUCUUUUAGAGUCGGAAGUAAGCGAAAGCUGAAGGAACGCAAC,18,11,13,10,52
3746,23,AACY020216610.1/530-480,ACCGUUCAACUCUUCGGAGUCGGAAGUAAGCGAAAGCUGAAGGAACGCGCU,15,9,15,12,51
3747,23,AACY020884354.1/284-231,AUCGUUCAACUCACUAAGAGUCGGAAGUACCCAUUAUAGGGGAAGGAACGCACU,18,11,13,12,54
3748,23,AACY023733388.1/1195-1247,AUCGUUCAACUCGAAAGAGUCGGAAGUAAGCUAAAUGGCUGAAGGAACGCAUG,19,10,15,9,53
3749,23,AACY020389036.1/1135-1187,AUCGUUCAACUCUUUUAGAGUCGGAAGUAGGCAUUGUGCCGAAGGAACGCAUG,14,14,15,10,53
3750,23,AACY021390959.1/865-918,UUCGUUCAUCUCUUCGAGAGACGGAAGUAGGUAAUGAUACCGAAGGAACGCACU,16,13,14,11,54
3751,23,AACY023981442.1/894-840,AUCGUUCAUCCUUUUCUUGGGACGGAAGUAAGUAAUAAUACUGAAGGAACGCAUC,17,16,12,10,55
3752,23,AACY020315100.1/860-808,AUCGUUCAUCUUCGUAAGAAGACGGAAGUAGGUGAAAGCUGAAGGAACGCGAC,18,10,16,9,53
3753,23,CP000806.1/2707245-2707170,AUCGUUCAUCCUUUCCAGCAGACAUUCAUCAACAAUGGAGGGACGGAAGUAAGGAUUUUUCCUGAAGGAACGCGCC,22,18,18,18,76
3754,23,AACY021585159.1/62-3,AUCGUUCAUCUCAUUUAAGGCAGUGGGACGGAAGUAAGUAAAACACUGAAGGAACGCGUG,20,13,17,10,60
3755,23,AACY021097822.1/333-388,CACGUUCAUCACUCUUUUAGAGUGACGGAAGUAGACGAAAGUCGAAGGAACGCAUG,18,12,15,11,56
3756,23,AACY020505432.1/55-105,AUCGUUCAACUCUUCGGAGUCGGAAGUAAGCGAAAGCUGAAGGAACGCGCU,15,10,15,11,51
3757,23,AACY023164810.1/326-379,AUCGUUCAACCUUUUUUAAAGGUCGGAAGUAAGCACUAGCUGAAGGAACGCGCA,17,13,13,11,54
3758,23,AACY020986353.1/419-367,AUCGUUCAACUCUUAUGAGUCGGAAGUAGGCAAAUAUGCUGAAGGAACGCAUG,17,13,14,9,53
3759,23,AACY021524998.1/714-771,AUCGUUCAUUCACUUAAUUGUGAACGGAAGUAAGUGUAGUACGCUGAAGGAACGCAUC,18,16,14,10,58
3760,23,AACY023516001.1/608-548,AUCGUUCAAUUUAAGGUUUUACUUAAAUCGGAAGUAAGUCUUUUGACUGAAGGAACGCAUG,19,21,13,8,61
3761,23,AACY021958614.1/234-287,UGCGUUGAACCUUUUGUAGGUCGCAAGUAAGCCAGAGGGCUGAAGCAACGGGAA,15,11,18,10,54
3762,23,AACY024111564.1/274-220,AUCGUUCAAUUUGCAACUUGCAAAUCGGAAGUAGGUAUACCCGAAGGAACGCGGA,18,12,14,11,55
3763,23,AACY023299976.1/711-659,AUCGUUCAUCUUUGAAAUAAGACGGAAGUAAGCGUAUGCUGAAGGAACGCACC,18,12,13,10,53
3764,23,AACY023282293.1/702-755,AUCGUUCAAUAUGCAUAUGCAUAUCGGAAGUAGGUUAAACCGAAGGAACGCGGA,19,12,14,9,54
3765,23,AACY023606304.1/83-30,AUCGUUCAUCUCGAAAAGAGACGGAAGUAGGUAAUGAUGCCGAAGGAACGCACC,19,9,15,11,54
3766,23,AACY023683577.1/382-436,AUCGUUCAAUCUGCAGAAGCAGAUCGGAAGUAGGUUUUUACCGAAGGAACGCGGA,17,12,16,10,55
3767,23,AACY022336911.1/581-639,AUCGUUCAAUCUAAGUAUUUCUUAGAUCGGAAGUAGGUCUGUGACUGAAGGAACGCAUG,17,18,15,9,59
3768,23,ABRV01000019.1/87833-87915,UUCGUUCAUCUCGAUCCCCUCAAGGUAGUAGUUCGAGACGGAAGUAAGGACAGCAGUUCCCGCUGACCCUGAAGGAACGCGUU,20,19,22,22,83
3769,23,AACY024085939.1/719-772,UACGUUCAUCAUGUUUUACAUGACGGAAGUAGGCGAAAGCUGAAGGAACGCAUG,17,13,15,9,54
3770,23,AACY022515796.1/623-568,UACGUUCAUCAUUCUUAUUGAAUGACGGAAGUAGACGAAAGUCGAAGGAACGCAUG,19,14,14,9,56
3771,23,AACY020050352.1/2916-2863,AUCGUUCAUCUUCUAAUAGAAGACGGAAGUAAGCGAAAGCUGAAGGAACGCGUG,19,11,15,9,54
3772,23,AACY022726119.1/307-358,AUCGUUCAACUCUUUUAGAGUCGGAAGUAAGCGAAAGCUGAAGGAACGCAAC,18,11,13,10,52
3773,23,AACY023503565.1/582-531,AUCGUUCAACUCUUUUAGAGUCGGAAGUAAGCGAAAGCUGAAGGAACGCAAU,18,12,13,9,52
3774,23,AACY020338589.1/314-367,AUCGUUCAACUUUAAUAGGAAGUCGGAAGUAAGCGAAAGCUGAAGGAACGCAAC,21,10,14,9,54
3775,23,AACY021423025.1/251-305,UACGUUCAUCACUUUAAUUAGUGACGGAAGUAGACAAUAGUCGAAGGAACGCAUG,19,14,13,9,55
3776,23,AACY022951168.1/216-163,AUCGUUCAUCUUCUUAUGGAAGACGGAAGUAAGCGAAAGCUGAAGGAACGCGUG,17,12,16,9,54
3777,23,AACY020142594.1/4421-4371,AUCGUUCAACUCUUCGGAGUCGGAAGUAAGCGAAAGCUGAAGGAACGCAAA,18,9,14,10,51
3778,23,AACY020938992.1/607-661,AUCGUUCAAUCUGUUAAUUCAGAUCGGAAGUAAGUUCAAACUGAAGGAACGCGGA,19,14,13,9,55
3779,23,AACY020830136.1/544-598,AUCGUUCAAUCUGUUUAUGCAGAUCGGAAGUAGGUUAAUACUGAAGGAACGCGGA,17,15,15,8,55
3780,23,AACY023165583.1/299-359,AUCGUUCAAUUUAGGAUUAUUCCUGAAUCGGAAGUAAGUCAAAAGACUGAAGGAACGCAUG,22,16,14,9,61
3781,23,AACY022210576.1/622-539,AUCGUUCACCCGAAAGGGCGGAAGUACCCUAUUUUCUGUACAUAAUUCUAUGCUGGAAAUAUGGGGUAGGGGAAGGAACGCACC,24,20,23,17,84
3782,23,AACY022161803.1/831-883,AUCGUUCAUCUUCGAAAGAAGACGGAAGUAGGUGAAAGCUGAAGGAACGCGAC,19,9,16,9,53
3783,23,AACY023750866.1/393-343,AUCGUUCAUCCUUAAGGGGACGGAAGUAGUCGCAAGACGAAGGAACGCAUU,16,10,15,10,51
3784,23,AACY022326751.1/308-254,CACGUUCAUCACCUAAUCGGGUGACGGAAGUAGACGAAAGUCGAAGGAACGCAUG,18,9,16,12,55
3785,23,AACY020223595.1/864-814,AUCGUUCAACUCUUCGGAGUCGGAAGUAAGCGAAAGCUGAAGGAACGCGCU,15,10,15,11,51
3786,23,AACY022183545.1/793-745,UUCGUUCAUCCUCGCAAGAGGACGCAAAAGCCGACUGAAGGAACGGGAA,16,7,14,12,49
3787,23,AACY020382879.1/340-288,AUCGUUCAACUUCUUAGGAAGUCGGAAGUAGGUGAAAACCGAAGGAACGCGCC,17,10,15,11,53
3788,23,AACY020215859.1/650-598,AUCGUUCAACUUCUUAGGAAGUCGGAAGUAGGUGAAAACCGAAGGAACGCGCC,17,10,15,11,53
3789,23,AACY020237494.1/318-391,AUCGUUGGGCUCGGGCCUGCUCUUACAGACCUCUUCAGCCGGAAGUAGCCACCCGCGUGGCGAAGCAACGCUCC,13,14,21,26,74
3790,23,AACY021990430.1/255-202,UACGUUCAUCAUGUUUAUCAUGACGGAAGUAGGUGAAAGCCGAAGGAACGCAUG,17,13,15,9,54
3791,23,AACY023245794.1/363-311,CACGUUCAUCUUUUAAUUAAGACGGAAGUAGAUGUAAGUCGAAGGAACGCAUG,18,14,13,8,53
3792,23,AACY022298437.1/866-814,AUCGUUCAACCCUGCAGUGGGUCGGAAGUAAGCUUCAGCUGAAGGAACGCGAU,14,11,16,12,53
3793,23,AACY021090368.1/351-270,AUCGUUCAUCUUUUGCACUAACUUAAUGCAAAAGACGGAAGUAGGAAGAUAGGAAAACCUCUUUCUUCCCAAGGGAGGAAAG,29,20,18,15,82
3794,23,AACY020369453.1/551-602,AUCGUUCAACUCUUUUAGAGUCGGAAGUAAGCGAAAGCUGAAGGAACGCAAC,18,11,13,10,52
3795,23,AACY023093815.1/433-490,AUCGUUCAUUCACUUAAUUGUGAACGGAAGUAAGUGUAGUACGCUGAAGGAACGCAUC,18,16,14,10,58
3796,23,AACY023138288.1/674-734,AUCGUUCAUCUCUUAGUUUUAGAGACGGAAGUAGACCUUAAAAAAGUCGAAGGAACGCAUG,21,16,14,10,61
3797,23,AACY020134078.1/210-160,AUCGUUCAUCUCUUAGGAGACGGAAGUAGGUGAAAACCGAAGGAACGCGCC,16,9,15,11,51
3798,23,AACY022751482.1/205-156,AUCGUUCAACCAUAUGGUCGGAAGUAGGUUUGACACCGAAGGAACGCAUC,15,11,13,11,50
3799,23,CP000240.1/2191743-2191662,AUCGUUCACCUCUGCAGUUGGCUCACCAGUGGCCUGGAGCUGUGCAGAGACGGAAGUAGGGGUCUUCCCGAAGGAACGCGCC,16,16,27,23,82
3800,23,AACY020564829.1/2206-2256,AUCGUUCAACUCUUCGGAGUCGGAAGUAAGCGAAAGCUGAAGGAACGCGCA,16,9,15,11,51
3801,23,AACY020555684.1/2430-2484,AUCGUUCAUCCUUACUUGUAAGGACGGAAGUAGACGAAAGUUGAAGGAACGCGCC,17,12,15,11,55
3802,23,AACY023638748.1/479-529,AUCGUUCAUCUCUUAGGAGACGGAAGUAGGUGAAAACCGAAGGAACGCGCC,16,9,15,11,51
3803,23,AACY022842103.1/630-686,AUCGUUCAAUCUAUUUUAUAUAGAUCGGAAGUAAGCACAAUGCUGAAGGAACGCGGA,20,15,13,9,57
3804,23,AACY021066889.1/690-635,UACGUUCAUCAUUCUUUUAGAGUGACGGAAGUAGACGAAAGUCGAAGGAACGCAUG,18,14,15,9,56
3805,23,CP000239.1/931758-931667,AUCGUUCAUCCUCUCGCCUGCUGUUUGGCUUAUCGUGGAGCAAGACGGCAGCCGGAGGACGGAAGUAGGGAGCUAUCCCGAAGGAACGCGCC,19,18,30,25,92
3806,23,AACY020212356.1/1530-1480,AUCGUUCAACCAUUAUGGUCGGAAGUAGGUUUGAAACCGAAGGAACGCAUC,16,12,13,10,51
3807,23,AACY020555885.1/2641-2591,AUCGUUCAACUCUUCGGAGUCGGAAGUAAGCGAAAGCUGAAGGAACGCGCU,15,10,15,11,51
3808,23,AACY023969055.1/754-807,AUCGUUCAUCUCGAAAGAGACGGAAGUAGGUAAUGGUUACCGAAGGAACGCACC,18,10,15,11,54
3809,23,AACY023520018.1/1297-1358,UACGUUCAUCUUAACUUAUAGACGGAAGUAGACUAUUGCAACGAUAGUUGAAGGAACGCAUU,21,18,13,10,62
3810,23,AACY021577843.1/545-598,UUCGUUCAACUCUUAAUAAGAGUCGGAAGUAGGCAACUGCCGAAGGAACGCUUA,17,13,13,11,54
3811,23,AACY023638748.1/427-477,AUCGUUCAACUCUUCGGAGUCGGAAGUAAGUGAAAGCUGAAGGAACGCGCU,15,11,15,10,51
3812,23,AACY023848865.1/1281-1326,AUCGUUCAUCCCAAUGGGACGCAAGUAAGCCGACUCGGAACGGAUU,13,9,12,12,46
3813,23,AACY023091009.1/203-149,AUCGUUCAAUUUGCAGUUUGCAAAUCGGAAGUAGGUAUACCCGAAGGAACGCGGA,17,13,15,10,55
3814,23,AACY021376510.1/251-199,AUCGUUCAUCUAUUCAUAUAGACGGAAGUAGGCAGACGCUGAAGGAACGCACU,17,12,13,11,53
3815,23,AACY021190992.1/121-175,CACGUUCAUCACCUUUUAGGGUGACGGAAGUAGACGAAAGUCGAAGGAACGCAUG,17,11,16,11,55
3816,23,AACY021541586.1/234-180,AUCGUUCAAUCUGUAUUAACAGAUCGGAAGUAGGCCGAAGCUGAAGGAACGCGGA,18,11,16,10,55
3817,23,AACY020416756.1/1664-1720,AUCGUUCAUCUUUAUGUAAAUAAAGACGGAAGUAGACGAAAGUUGAAGGAACGCGCC,21,13,14,9,57
3818,23,AACY022163341.1/297-351,AUCGUUCAAUCUGUAUUAACAGAUCGGAAGUAGGCUAAAGCUGAAGGAACGCGGA,19,12,15,9,55
3819,23,AACY021528051.1/874-824,AACGUUCAACCAUUGUGGUCGGAAGUAGGUUUGAAACCGAAGGAACGCAUC,16,11,14,10,51
3820,23,AACY022086925.1/534-588,CACGUUCAUCGCCCUAAAAAGCGACGGAAGUAAACGAAAGUUGAAGGAACGCAUG,21,8,14,12,55
3821,23,AACY020332580.1/786-655,AUCGUUCAUUCAGUGCCCUAUUUUAGUGCAUUGAACGGAAGUAGGAAAACCUGAAAACCUCUAUCUGAAAAGAUAGGUAAGCAAGUACCCGCUAGGGGAACGAGACCGAAAGUUUUACCGAAGGAACGCGUU,44,30,32,26,132
3822,23,AACY020027094.1/410-362,UACGUUCAGGCAUCAGCCCGGAAGUAGGAGUUAUCCGAAGGAACGCACC,14,8,14,13,49
3823,23,AACY024118785.1/615-567,AUCGUUCAUCCCAAAAGGACGGAAGUAGGCAAUGCCGAAGGAACGCACC,17,6,13,13,49
3824,23,AACY021251278.1/319-370,AUCGUUCAACUCGAAAGAGUCGGAAGUAGGCAUUUAGCCGAAGGAACGCAUG,17,10,15,10,52
3825,23,AACY023992491.1/721-776,UACGUUCAUCACUCUUUUAGAGUGACGGAAGUAGACGAAAGUCGAAGGAACGCAUG,18,13,15,10,56
3826,23,AACY022839954.1/548-490,CUCGUUCAUUCAGAAGAAAUUCUGAACGGAAGUAGGUAAUGACACCGAAGGAACGCAUC,21,12,14,12,59
3827,23,AACY023143293.1/261-206,AUCGUUCAAUUUGCCUUCAGGCAAAUCGGAAGUAGGUUAAACCGAAGGAACGCGGA,18,12,15,11,56
3828,23,AACY024097173.1/258-310,AUCGUUCAACUUCUUAGGAAGUCGGAAGUAGGUGAAAACCGAAGGAACGCACC,18,10,14,11,53
3829,23,AACY020212401.1/327-379,AUCGUUCAUCUUUGAAAAAAGACGGAAGUAGGCAAAAGCCGAAGGAACGCGAG,21,8,15,9,53
3830,23,AACY020542192.1/2127-2180,AUCGUUCAUCCUUUCAUAGGACGGAAGUAAGUAAUGAUACUGAAGGAACGCAUC,18,14,12,10,54
3831,23,AACY022220894.1/563-509,UUCGUUCAUCUAUCUAGACGGAAGUAGGAUUAAAAUUUAUCCGAAGGAACGCAUU,18,17,11,9,55
3832,23,AACY023143293.1/328-273,CACGUUCAUCACUCUUUUAGGGUGACGGAAGUAGACGAAAGUCGAAGGAACGCAUG,17,12,16,11,56
3833,23,AACY023214669.1/1588-1637,AACGUUCAUCCCACUGGGACGGAAGUAAGCAUAAGCUGAAGGAACGCUUC,16,9,13,12,50
3834,23,AACY020264949.1/738-686,AUCGUUCAACUCAGUUUGAGUCGGAAGUAGGCAUUGUGCCGAAGGAACGCAUG,14,13,16,10,53
3835,23,AACY023513220.1/642-593,AUCGUUCAUCCAUUACGGACGGAAGUAGGCAACAGCUGAAGGAACGCGCU,15,9,14,12,50
3836,23,AACY021623722.1/358-413,AUCGUUCAUUUUGAAUAAUUCAAAACGGAAGUAAACGAAAGUUGAAGGAACGCAUG,23,14,12,7,56
3837,23,AACY022860823.1/392-347,AUCGUUCAUCCCAAUGGGACGCAAGUAAGCCGACUCGGAACGGAUU,13,9,12,12,46
3838,23,AACY022594555.1/253-201,AUCGUUCAUCUCGAAAGAGACGGAAGUAGGUAAUGAUACCGAAGGAACGCAUC,19,10,14,10,53
3839,23,AACY023581040.1/405-452,AUCGUUGGACUAAAAGUCGGAAGUAAGCAAUCGCUGAAGCAACGCACU,17,9,12,10,48
3840,23,AACY020232172.1/1639-1584,AUCGUUCAAUUUGCCUAUGGCAAAUCGGAAGUAGGUUUAAACCGAAGGAACGCGGA,18,13,15,10,56
3841,23,AACY022138576.1/234-180,AUCGUUCAAUCUGUAUUAACAGAUCGGAAGUAGGCUAAAGCUGAAGGAACGCGGA,19,12,15,9,55
3842,23,AACY020157868.1/334-389,AUCGUUCAUUUUGAAUAAUUCGAAACGGAAGUAAACGAAAGUUGAAGGAACGCAUG,22,14,13,7,56
3843,23,AACY022800866.1/603-549,AUCGUUCAUCCCAUUAUUGGGACGGAAGUAGUCAAUUUAGACGAAGGAACGCAUU,17,15,13,10,55
3844,23,AACY020290181.1/1346-1409,AUCGUUCAUUCACUCUAAAUGUAGCAGUGAACGGAAGUAGUCAAUUGUGAUGAAGGAACGCAUC,21,17,15,11,64
3845,23,AACY023530723.1/1280-1330,AUCGUUCAACUCUUCGGAGUCGGAAGUAAGCGAAAGCUGAAGGAACGCGCU,15,10,15,11,51
3846,23,AACY021902385.1/65-5,UACGUUCAUCCCCUAACAUAGGGGACGCAAGUACUCUACGAAUGAGAGGAAGGAACGGGAA,21,10,17,13,61
3847,23,AACY024076916.1/215-268,AUCGUUCAAUCUGCUUAGGCAGAUCGGAAGUAGGGAAAACUGAAGGAACGCGGA,18,10,17,9,54
3848,23,AACY023583366.1/677-623,AUCGUUCAAUUUGCAGUUUGCAAAUCGGAAGUAGGUAUACCCGAAGGAACGCGGA,17,13,15,10,55
3849,23,AACY022023258.1/386-328,UCCGUUCAUCUAUAUUUAAAGAUAUAGACGGAAGUAGUCGUAAGGCGAAGGAACGCAUU,20,16,14,9,59
3850,23,AACY022849373.1/614-667,AUCGUUCAAUCUGCAAUAGCAGAUCGGAAGUAGGUAAAACCGAAGGAACGCGGA,20,9,15,10,54
3851,23,AACY023947774.1/543-595,UACGUUCAUCCUUAUGGGACGGAAGUAGGGGAUUAUCCCCGAAGGAACGCAUA,15,12,15,11,53
3852,23,AACY022907826.1/642-567,AACGUUGAGCUUGACAGGUGUUCCGCAUCUGUCGUUCAGCCGGAAGUAGCCCCUCCGCAAGGCGAAGCAACGCUCC,16,15,21,24,76
3853,23,AACY020530594.1/1891-1816,AACGUUGAGCUUGACAGGUGUUCCGCAUCUGUCGUUCAGCCGGAAGUAGCCCCUCCGCAAGGCGAAGCAACGCUCC,16,15,21,24,76
3854,23,AACY022001680.1/619-567,AUCGUUCAUCUCUCAAGAGACGGAAGUAGGUAAUGGUACCGAAGGAACGCAUC,17,11,14,11,53
3855,23,AACY020498371.1/1365-1313,AUCGUUCAUCUCGUAAAAGACGGAAGUAGGGAAUGAUGCCGAAGGAACGCACC,18,9,15,11,53
3856,23,AACY022086925.1/601-655,AUCGUUCAAUCUGCAAAAGCAGAUCGGAAGUAGGUUUUAACCGAAGGAACGCGGA,19,11,15,10,55
3857,23,AACY022486863.1/703-648,AUCGUUCAAUUUGCCUAAGGCAAAUCGGAAGUAGGUUAAAACCGAAGGAACGCGGA,20,11,15,10,56
3858,23,AACY021241723.1/233-283,ACCGUUCAACUCUUCGGAGUCGGAAGUAAGCGAAAGCUGAAGGAACGCGCU,15,9,15,12,51
3859,23,AACY020290181.1/1410-1462,UUCGUUCAUCCCGUAAGGGACGGAAGUAGGUGAUAAUACCGAAGGAACGCAUC,16,11,15,11,53
3860,23,AACY023364796.1/757-810,AUCGUUCAAUCUGUUAUUACAGAUCGGAAGUAGGUUAAACCGAAGGAACGCGGA,18,13,14,9,54
3861,23,AACY022670969.1/894-949,AUCGUUCAAUCCUUGUUUAAGAGGAUCGGAAGUAGGGCAACCCAAAGGAACGCGGA,18,11,16,11,56
3862,23,AACY022039567.1/365-417,CACGUUCAUCCCUACAGGGACGGAAGUAAGCCAUAGUGCUGAAGGAACGCAAU,17,9,14,13,53
3863,23,AACY023682620.1/511-569,AUCGUUCAAUUUAAAUUUAUUUAAAUCGGAAGUAGAUCUAACGAUCGAAGGAACGCAUG,22,18,11,8,59
3864,23,AACY023503840.1/1225-1280,AUCGUUCAACCUAUUAUUAUAGGUCGGAAGUAAGCCAAAAGCUGAAGGAACGCGCA,20,12,13,11,56
3865,23,CP000240.1/2902190-2902288,AUCGUUCAUCCUCUCGCGUGCUGGGCGGCUCGUUAAUGUAGGUAGAGCGACAUCACGGCCAGAGGACGGAAGUAGGGAGAUAUCCCGAAGGAACGCGCC,23,18,33,25,99
3866,23,AACY020428011.1/1689-1638,AUCGUUCAACUCUUUUAGAGUCGGAAGUAAGCGAAAGCUGAAGGAACGCAAC,18,11,13,10,52
3867,23,AACY020445308.1/1001-1059,GACGUUCAUUUUAGUAGCAAUACUAAAACGGAAGUAGACGAAAGUCGAAGGAACGCAUG,23,12,15,9,59
3868,23,AACY023928750.1/364-312,AUCGUUCAACUCAAUAUGAGUCGGAAGUAGGCAUUGUGCUGAAGGAACGCAUG,16,13,15,9,53
3869,23,AACY023408594.1/583-638,AUCGUUCAUUUUGAAUAAUUCAAAACGGAAGUAAACAUAAGUUGAAGGAACGCAUG,23,15,11,7,56
3870,23,AACY020986353.1/354-296,AUCGUUCAAUCUAAUUUAUAUUAGAUCGGAAGUAGGCAAAUAUGCUGAAGGAACGCAGA,22,16,13,8,59
3871,23,AACY024067319.1/527-581,UACGUUCAUCGCCUUAAAAAGCGACGGAAGUAGACGAAAGUCGAAGGAACGCAUG,20,9,15,11,55
3872,23,AACY020240685.1/377-327,AUCGUUCAACUCUUCGGAGUCGGAAGUAAGCGAAAGCUGAAGGAACGCGCU,15,10,15,11,51
3873,23,AACY023596340.1/993-938,CACGUUCAUCAUCCUUAUGGGGUGACGGAAGUAGACGAAAGUCGAAGGAACGCAUG,17,11,17,11,56
3874,23,AACY022061262.1/150-204,UACGUUCAUCUUUUUAAAUAAAGACGGAAGUAGACGAAAGUCGAAGGAACGCAUG,21,13,13,8,55
3875,23,AACY020795282.1/440-570,AUCGUUCAUUCAGUGCCCUUUUUUAGUGCAUUGAACGGAAGUAGGAAAACCUGAAAACCUCUAUCUGAAAAGAUAGGUAAGCAAGUACCCGUAAGGGGAACGAGACCGAAAGUUUACCGAAGGAACGCGUU,44,30,32,25,131
3876,23,AACY020563764.1/2605-2549,AUCGUUCAUCUUUAUGAAAAUAAAGACGGAAGUAGACGAAAGUUGAAGGAACGCGCC,22,12,14,9,57
3877,23,AACY023682620.1/582-634,AUCGUUCAACCUUUAAUUAGGUCGGAAGUAAGCAACAGCUGAAGGAACGCGCA,18,11,13,11,53
3878,23,AACY020419699.1/403-465,AUCGUUCAUCUUUAAAAAUUUAUUUUUAAGGACGGAAGUAGACGAAAGUUGAAGGAACGCAUG,23,19,14,7,63
3879,23,AACY020514091.1/890-942,AUCGUUCAUCUUCGAAAGAAGACGGAAGUAGGUGAAAACUGAAGGAACGCGAC,20,9,15,9,53
3880,23,AACY022736085.1/436-381,UUCGUUCAUCUUACCCUGUAAGACGGAAGUAGACAUUCUUGUCGAAGGAACGCAUA,16,16,12,12,56
3881,23,AACY020900317.1/189-142,AUCGUUCAUCCCCAAGGGGGACGCAAAUGCCGACUGAAGGAACGGGUC,13,7,15,13,48
3882,23,AACY021182484.1/381-326,AUCGUUCAAUCUAACUUGUUUAGAUCGGAAGUAAGCUAAAGCUGAAGGAACGCGCA,19,14,13,10,56
3883,23,AACY020388700.1/1617-1565,AUCGUUCAACUUCUUAGGAAGUCGGAAGUAGGUGAAAACCGAAGGAACGCGCC,17,10,15,11,53
3884,23,AACY022301935.1/380-330,AACGUUCAACCUUUAAGGUCGGAAGUAGGUUUGAAACCGAAGGAACGCAUC,17,11,13,10,51
3885,23,AACY023545356.1/501-555,AUCGUUCAAUUUGCCUUAGGCAAAUCGGAAGUAGGUAUACCCGAAGGAACGCGGA,17,12,15,11,55
3886,23,AACY021097822.1/401-456,AUCGUUCAAUCUGAAUUAAUUCAGAUCGGAAGUAGGUAAAACCGAAGGAACGCGGA,21,12,14,9,56
3887,23,AACY021601485.1/472-420,AUCGUUCAUCUAUUCAUAGACGGAAGUAGGUAAUACAACCGAAGGAACGCAUC,19,12,11,11,53
3888,23,AACY020402636.1/1170-1228,AUCGUUCAUCUCAUUUAAAAUGAGACGGAAGUAAGUUUUCUUAACUGAAGGAACGCUGU,19,19,12,9,59
3889,23,AACY023879838.1/286-227,AUCGUUCAAUUUAAGUUAGUCUUAAAUCGGAAGUAGGUCUUUUGACUGAAGGAACGCAUG,18,20,14,8,60
3890,23,AACY021868731.1/145-195,AUCGUUCAUCUCUUAGGAGACGGAAGUAGGUGAAAACCGAAGGAACGCCGC,16,9,15,11,51
3891,23,AACY023385492.1/1411-1460,UACGUUCAGCCUUAUGGUCGGAAGUAAGCUUGUAGCUGAAGGAACGCAAA,15,12,14,9,50
3892,23,AACY020236614.1/928-978,AUCGUUCAUCUCUUAGGAGACGGAAGUAGGUGAAAACCGAAGGAACGCGUC,16,10,15,10,51
3893,23,AACY022627048.1/204-153,AUCGUUCAACCCUUUUUGGGUCGGAAGUAAGCUUAAGCUGAAGGAACGCGAA,15,13,14,10,52
3894,23,AACY020389036.1/1200-1255,AUCGUUCAACCUAUUAUAAUAGGUCGGAAGUAAGCCAAAAGCUGAAGGAACGCGCA,21,11,13,11,56
3895,23,AACY020338589.1/193-243,AUCGUUCAACUCUUCGGAGUCGGAAGUAAGCGAAAGCUGAAGGAACGCGCU,15,10,15,11,51
3896,23,AACY024021276.1/438-490,AUCGUUCAUCUUCGAAAGAAGACGGAAGUAGGUGAAAACUGAAGGAACGCGAC,20,9,15,9,53
3897,23,AACY020382879.1/268-217,AUCGUUCAACUCUUUUAGAGUCGGAAGUAAGCGAAAGCUGAAGGAACGCAAC,18,11,13,10,52
3898,23,AACY020428429.1/991-941,AUCGUUCAACUCUUCGGAGUCGGAAGUAAGCGAAAGCUGAAGGAACGCGCU,15,10,15,11,51
3899,23,AACY020563270.1/1088-1036,AUCGUUCAUCUUCGAGAGAAGACGGAAGUAGGUGAAAGCUGAAGGAACGCGAC,18,9,17,9,53
3900,23,AACY022149997.1/171-120,AUCGUUCAACUCUUUUAGAGUCGGAAGUAAGCGAAAGCUGAAGGAACGCAAC,18,11,13,10,52
3901,23,AACY022563169.1/373-427,AUCGUUCAAUCUGUAUUAACAGAUCGGAAGUAAGCUAAAGCUGAAGGAACGCGGA,20,12,14,9,55
3902,23,AACY020514091.1/817-871,AUCGUUCAUCCUUACUUGUAAGGACGGAAGUAGACGAAAGUUGAAGGAACGCGCC,17,12,15,11,55
3903,23,AACY020414407.1/995-1052,AUCGUUCAUCUCAUUAAUUGAGUGAGACGGAAGUAGGUAAGAUCCGAAGGAACGCAGU,19,14,16,9,58
3904,23,AACY020160526.1/997-1046,AUCGUUCAUCCAUUACGGACGGAAGUAGGCAACAGCUGAAGGAACGCGCU,15,9,14,12,50
3905,23,AAVU01000006.1/147500-147393,AACGUUCAUCUCUCUGAUCUGGAGAACGCUGAUCUAGGUAUAGUCAGGAAAAUCAUCGAGAUAGGAGAGACGGAAGUAGGGAAAUCAUCAUUCCCGAAGGAACGCGCC,35,22,29,22,108
3906,23,AACY020424567.1/1306-1358,AUCGUUCAUCUUCGAGAGAAGACGGAAGUAGGUGAAAACUGAAGGAACGCGAC,19,9,16,9,53
3907,23,AACY020455148.1/219-271,AUCGUUCAUCCCUUUAGGGUCGGAAGUAUGCUAUAAUGCAGAAGGAACGCAUC,15,14,13,11,53
3908,23,AACY023165583.1/372-427,UUCGUUCAACCCUUAUAACAAGGGUCGGAAGUAGGCACCUGCCGAAGGAACGCUUU,15,13,14,14,56
3909,23,AACY023410968.1/256-309,AUCGUUCAUCUCGCUUAUUGAGACGGAAGUAAGUUUUAACUGAAGGAACGCAGA,17,15,13,9,54
3910,23,AACY022860373.1/42-94,AUCGUUCAUCUUCGAAAGAAGACGGAAGUAGGUGAAAACUGAAGGAACGCGAC,20,9,15,9,53
3911,23,AACY020263130.1/153-99,AUCGUUUAUCCUGAAACGGACGGAAGUAAACCACCAAUGGUUGAAGAAACGCUCU,19,12,12,12,55
3912,23,AACY023401421.1/1425-1370,UACGUUCAUCAUUCUUAUUGAAUGACGGAAGUAGACGAAAGUCGAAGGAACGCAUG,19,14,14,9,56
3913,23,AACY021112096.1/9-58,AUCGUUCAACCCAUAUGGGUCGGAAGUAAGCAUCGCUGAAGGAACGCGCA,15,9,14,12,50
3914,23,AACY020348046.1/34-87,AUCGUUCAACUUCAAUAAGAAGUCGGAAGUAAGCGAAAGCUGAAGGAACGCAAC,22,9,13,10,54
3915,23,AACY020091056.1/1924-1870,AUCGUUCAAUUUGCAGCUCGCAAAUCGGAAGUAGGUAUACCCGAAGGAACGCGGA,17,11,15,12,55
3916,23,AACY020830136.1/470-531,UACGUUCAUCGCUAGUUUAAAUAAUAAGCGACGGAAGUAGGCGAAAGCCGAAGGAACGCAUG,22,12,17,11,62
3917,23,AACY023551536.1/1020-1079,AUCGUUCAAUUUGAGACUUUUCUCAAAUCGGAAGUAGGUUUUUAACCGAAGGAACGCAUG,18,19,13,10,60
3918,23,AACY020287182.1/586-523,AUCGUUCAUUCACUCUAAAUGUAGCAGUGAACGGAAGUAGUCAAUUGUGACGAAGGAACGCAUC,21,16,15,12,64
3919,23,AACY022780679.1/330-280,AACGUUCAACCAUUAUGGUCGGAAGUAGGUUUGAAGCCGAAGGAACGCAUC,16,11,14,10,51
3920,23,AACY023603220.1/907-959,AUCGUUCAUCUUCGUAAGAAGACGGAAGUAGACGAAAGUUGAAGGAACGCGCC,18,10,15,10,53
3921,23,AACY020289447.1/802-747,AUCGUUCAAUUUGCAGUUUGCAAAUCGGAAGUAGGUUCAAACCGAAGGAACGCGGA,18,13,15,10,56
3922,23,AACY021258419.1/501-453,AUCGUUGGACUAUUAAGUCGGAAGUAGGCAUAAGCCGAAGCAACGCACC,16,9,13,11,49
3923,23,AACY021769560.1/20-70,AUCGUUCAUCCCUGUGGGGACGGAAGUAGUCGCAAGAUGAAGGAACGCAUU,14,11,16,10,51
3924,23,AACY022138576.1/301-246,AUCGUUCAUUUUGAAUAAUUCAAAACGGAAGUAAACGAAAGUUGAAGGAACGCAUG,23,14,12,7,56
3925,23,CP000806.1/1043231-1043292,AUCGUUCAUCUGUUGUCACCAACAGACGGAAGUAGGGAAUCAAUAUCCCGAAGGAACGCGCC,19,12,15,16,62
3926,23,AACY022253413.1/728-782,AUCGUUCAUCUUCUUAUAUGAAGACGGAAGUAGACGGAAGUCGAAGGAACGCAUG,18,13,15,9,55
3927,23,CP000828.1/3254265-3254355,AUCGUUCAUCUUGCAUCGCUUGUCUGUUUGAUUCCUGAUCAAAGGUGAGUCAGCAAGACGGAAGUAAGGCAUUUACCUGAAGGAACGCGCC,23,25,23,20,91
3928,23,AACY021294965.1/733-791,AUCGUUCAAUUUAAGAUUUUCUUAGAUCGGAAGUAGGUCUUUGACCGAAGGAACGCAUG,17,19,14,9,59
3929,23,AACY022276201.1/156-211,UACGUUGAUAGUCUGUUGACUACGCAAGUAAGCCAGAAGGGCUGAAGCAACGGGAA,18,11,17,10,56
3930,23,AACY022023258.1/327-273,AUCGUUCAUCUCAUUUGAGACGGAAGUAGGUAAUGGUUUACCGAAGGAACGCGUU,15,16,15,9,55
3931,23,AACY021726409.1/435-381,AACGUUCAAUCUAUAUUUUUAGAUCGGAAGUAAGCUUAUGCUGAAGGAACGCGGU,17,17,13,8,55
3932,23,AACY020889107.1/530-476,AUCGUUCAUCCCACUCAUGGGACGGAAGUAGUCAAUUUAGACGAAGGAACGCAUU,17,13,13,12,55
3933,23,AACY020481299.1/727-783,AUCGUUCAACCUAUUUUAUAUAGGUCGGAAGUAAGCGAUAAGCUGAAGGAACGCGCA,19,14,14,10,57
3934,23,AACY023929012.1/60-113,AUCGUUCAUCUAUUCAAAUAGACGGAAGUACCUAUCAAGGGGAAGGAACGCACU,19,12,12,11,54
3935,23,ABYK01000024.1/20386-20477,AUCGUUCAUCUCUUUUCGCUCUAAGGGUUUUCUAGCCCUAAUGUUCAGAGGAGGGGAGACGGAAGUAGGGAGUAAUCCCGAAGGAACGCGCC,22,23,27,20,92
3936,23,AACY020233904.1/1236-1180,AUCGUUCAACCUAUCUAAGAUAGGUCGGAAGUAAGCUAACUGCUGAAGGAACGCGCA,19,12,14,12,57
3937,23,AACY024065093.1/27-81,AUCGUUCAAUUUGCAGUUUGCAAAUUGGAAGUAGGUUAAACCGAAGGAACGCGGA,18,14,15,8,55
3938,23,AACY023528798.1/471-421,AACGUUUAUCCUGAAACGGACGGAAGUAGGCGAAUGCUGAAGAAACGCACU,18,9,14,10,51
3939,23,AACY020234329.1/321-269,AUCGUUCAUCUUCGAAAGAAGACGGAAGUAGGUGAAAACUGAAGGAACGCGAC,20,9,15,9,53
3940,23,AACY020481299.1/662-714,AUCGUUCAACUCUUUUAGAGUCGGAAGUAGGCAUUGUGCCGAAGGAACGCAUG,14,14,15,10,53
3941,23,AACY023165440.1/778-719,AUCGUUCAUCUCUUAGUUUUAGAGACGGAAGUAGACCUUAAAAAGUCGAAGGAACGCAUG,20,16,14,10,60
3942,23,AACY020416756.1/1739-1791,AUCGUUCAUCUUCGAGAGAAGACGGAAGUAGGUGAAAGCUGAAGGAACGCGAC,18,9,17,9,53
3943,23,AACY020091056.1/1992-1937,CACGUUCAUCACUCUUUUAGAGUGACGGAAGUAGACGAAAGUCGAAGGAACGCAUG,18,12,15,11,56
3944,23,AACY020078853.1/246-296,AUCGUUCAUCCUUAAGGGGACGGAAGUAAUCGUAAGAUGAAGGAACGCAUU,17,12,14,8,51
3945,23,AACY022252054.1/65-115,AUCGUUCAACCCUAAUGGGUCGGAAGUAAGCAGCCGCUGAAGGAACGCGCA,15,8,15,13,51
3946,23,ABRS01000006.1/124108-124201,AUCGUUCAUCUCUCUAGACAUCAGUCAGUUAGCAAUUAGCCGUGAAGGAUGAUUAGGGAGACGGAAGUAGGGGCAACUCCCGAAGGAACGCGCC,27,19,27,21,94
3947,23,AACY020564829.1/2258-2308,AUCGUUCAUCUCUUAGGAGACGGAAGUAGGUGAAAACCGAAGGAACGCGCC,16,9,15,11,51
3948,23,AACY023521111.1/1206-1153,AACGUUCAUCCCGUUAGGGGACGGAAGUAAGCAAUCAAGCUGAAGGAACGCACU,18,9,15,12,54
3949,23,AACY020445308.1/1072-1126,AUCGUUCAAUCUGUUAAAACAGAUCGGAAGUAAGGUAAAACUGAAGGAACGCGGA,22,11,14,8,55
3950,23,AACY022147633.1/208-257,AUCGUUCAUCCUAAAAGGACGGAAGUAAGCAUCAGCUGAAGGAACGCACC,18,8,12,12,50
3951,23,AACY020164575.1/1649-1600,GACGUUCAUCACAAAUGUGACGGAAGUACCAAUGAGGGAAGGAACGCACC,18,7,14,11,50
3952,23,AACY023148198.1/241-109,AUCGUUCAUUCCCUGCAUCAUUUUAAUGCAAGGAACGGAAGUAGGAAGAUAGGAAAACCUCUUUCUUUUUUAAAGAAAGGCAAGCAAGUACCGAUAAGGGAACGAGACCGAAUAUCUACCGAAGGAACGCGUU,47,31,30,25,133
3953,23,AACY021276613.1/384-324,AUCGUUCAAUUCUCAUAAAUAUUUGAGAAUCGGAAGUAGGUUUAUACCGAAGGAACGCGGA,21,17,14,9,61
3954,23,CP000393.1/4678876-4678823,AGCGUUCAUCUUCUCAGAAGACGGAAGUAAGGAAACAUCCUGAAGGAAUUUACC,19,12,12,11,54
3955,23,AACY021760230.1/244-194,AUCGUUCAACCCUUUUGGGUCGGAAGUAAGCUUCAGCUGAAGGAACGCAUA,14,13,13,11,51
3956,23,AACY022986758.1/530-584,AUCGUUCAACUCAUUGUGAGUCGGAAGUAGGUACAUUGUACUGAAGGAACGCAUG,16,15,15,9,55
3957,23,AACY023880517.1/846-898,AACGUUCAUCCUAAAAAGGACGGAAGUAGGCAUAUAUGCCGAAGGAACGCACC,20,8,13,12,53
3958,23,AACY020155181.1/1032-1082,UACGUUCAACCUUUAUGGUCGGAAGUAAGCUUGAAGCUGAAGGAACGCAAU,16,13,13,9,51
3959,23,AACY020394557.1/1190-1239,AUCGUUCAUCUCUUAGAGACGGAAGUAGGUGAAAACCGAAGGAACGCCAC,17,9,13,11,50
3960,23,AACY020509663.1/287-237,AUCGUUCAACUCUUCGGAGUCGGAAGUAAGCGAAAGCUGAAGGAACGCGCU,15,10,15,11,51
3961,23,AACY022521969.1/251-194,AUCGUUCAACCUAUAUAAGUAGGUCGGAAGUAAGCUAAUACUGCUGAAGGAACGCGCA,20,13,14,11,58
3962,23,AACY022420381.1/152-97,AUCGUUCAUUUUGAAUAAUUCAAAACGGAAGUAAACGAAAGUUGAAGGAACGCAAA,25,13,11,7,56
3963,23,AACY023484124.1/781-728,AUCGUUCAACUUCAAUAUGAAGUCGGAAGUAAGCGAAAGCUGAAGGAACGCAAC,21,10,13,10,54
3964,23,AACY020331357.1/1285-1339,AUCGUUCAUCCUUACAUGUAAGGACGGAAGUAGACGAAAGUUGAAGGAACGCGCC,18,11,15,11,55
3965,23,AACY021939941.1/320-374,UUCGUUCAACCCUAUUAAUGGGGUCGGAAGUAGGCAUCAGCCGAAGGAACGCCUU,14,13,15,13,55
3966,23,AACY022706645.1/510-562,AUCGUUCAUCUCGAAAGAGACGGAAGUAGGUAAUGAUACCGAAGGAACGCGUU,18,11,15,9,53
3967,23,AACY021898535.1/514-566,AUCGUUCAACUCAAUUUGAGUCGGAAGUAGGCAUUGUGCCGAAGGAACGCAUG,15,13,15,10,53
3968,23,AACY023535011.1/346-296,AUCGUUCAACCCAUGUGGGUCGGAAGUAAGCUUCAGCUGAAGGAACGCGAA,15,10,15,11,51
3969,23,AACY023461508.1/100-163,AUCGUUCAUUCACUCUAAAUGUAGCAGUGAACGGAAGUAGUCAAUUCUGACGAAGGAACGCAUC,21,16,14,13,64
3970,23,AACY023881567.1/1213-1266,UACGUUCAUCACCUUUUAGGUGACGGAAGUAGACGAAAGUCGAAGGAACGCAUG,17,12,15,10,54
3971,23,AACY023598562.1/165-113,AUCGUUCAACUCUUUUAGAGUCGGAAGUAGGCAUUGUGCCGAAGGAACGCAUG,14,14,15,10,53
3972,23,AACY020477826.1/1858-1912,CACGUUCAUCACCUGACUAGGUGACGGAAGUAGACGAAAGUCGAAGGAACGCAUG,18,9,16,12,55
3973,23,AACY022839954.1/609-552,UUCGUUCAUCUUAACUGACGGAAGUAGAAUACUGCAAGGGUAUUCGAAGGAACGCAUU,18,16,14,10,58
3974,23,AACY020232024.1/305-357,AUCGUUCAUCUUCGAAAGAAGACGGAAGUAGGUGAAAACUGAAGGAACGCGAC,20,9,15,9,53
3975,23,AACY023606132.1/112-169,AUCGUUCAACCUAUUUUUUAAUAGGUCGGAAGUAAGCCUAAAGCUGAAGGAACGCGCA,19,15,13,11,58
3976,23,AACY020055407.1/290-240,AUCGUUCAACUCGUAUGAGUCGGAAGUAAGCAGUUGCUGAAGGAACGCACC,15,11,14,11,51
3977,23,AACY021757996.1/853-908,AUCGUUCAAUUUGCCCUUAGGCAAAUCGGAAGUAGGUUAAACCGAAGGAACGCGGA,18,12,15,11,56
3978,23,AACY021167380.1/134-189,AUCGUUCAUUUUGAAUAAUUCAAAACGGAAGUAAACGAAAGUUGAAGGAACGCAUG,23,14,12,7,56
3979,23,AACY022740565.1/652-594,AUCGUUCAUCCUUAUUUGGGGACGGAAGUAGGUAAAAAAUCAAACCGAAGGAACGCAUC,21,13,14,11,59
3980,23,AACY021426488.1/166-116,AACGUUUAUCCUGAAACGGACGGAAGUAGGCGAAUGCUGAAGAAACGCACU,18,9,14,10,51
3981,23,AACY023549608.1/505-455,AUCGUUCAUCCCCUAUGGGACGGAAGUAGUCGCAAGACGAAGGAACGCAUU,15,10,14,12,51
3982,23,AACY022060924.1/83-20,AUCGUUCAUCUUUAAAAAUUUAUUUUUAAAGACGGGAAGUAGACGAAAGUUGAAGGAACGCAUG,24,19,14,7,64
3983,23,AACY023620377.1/235-181,AUCGUUCAUCCUUACUUGUAAGGACGGAAGUAGACGAAAGUUGAAGGAACGCGCC,17,12,15,11,55
3984,23,AACY020083435.1/1042-987,AUCGUUCAUCCUAACUUACAAGGACGGAAGUAGGCUUCAUGCUGAAGGAACGCGCU,16,13,14,13,56
3985,23,AACY022037212.1/593-675,AUCGUUCAUCUCUCAAAUGAGACGGAAGUAGUUGGAAUAAUUAUCCAACUCGGGGAGGAUAAUCUCCAACGAAGGAACGCACC,28,18,19,18,83
3986,23,AACY020462106.1/1348-1400,AACGUUCAUCUUUUUUUUAAAAGACGGAAGUAGCGAAAGCGAAGGAACGCACC,19,12,12,10,53
3987,23,AACY023653930.1/177-237,AUCGUUCAAUCUAAUUUUUUAUAAUUAGAUCGGAAGUAAGCAACAGCUGAAGGAACGCAUA,23,18,11,9,61
3988,23,AACY020039042.1/426-478,AUCGUUCAUCCUUUCACAGGACGGAAGUAGUCUAAAUGACGAAGGAACGCAUU,17,13,12,11,53
3989,23,AACY021947797.1/527-478,AUCGUUCAUCCUCUUAAAGAGGACGCAAGUAAGCCGACUCGGAACGGAAU,16,10,12,12,50
3990,23,AACY023645668.1/747-695,AUCGUUCAACUCAAUAGAGUCGGAAGUACCCAUCAUAGGGGAAGGAACGCACU,18,10,13,12,53
3991,23,AACY021378359.1/156-287,AUCGUUCAUUCAGUGCCCUGUUUUAGUGCAUUGAACGGAAGUAGGAAAACCUGAAAACCUCUAUCUGAAAAGAUAGGUAAGCAAGUACCCAUAAGGGGAACGAGACCGAAAGUUUUACCGAAGGAACGCGUU,45,30,32,25,132
3992,23,AACY023992491.1/789-844,AUCGUUCAAUUUGCUUAAAGCAAAUCGGAAGUAGGUUUAAACCGAAGGAACGCGGA,20,13,14,9,56
3993,23,AACY020425839.1/362-414,AUCGUUCAACUCUUUUAGAGUCGGAAGUAGGCAUUGUGCCGAAGGAACGCAUG,14,14,15,10,53
3994,23,AACY024076916.1/147-202,UACGUUCAUCAUGUUGUUAACAUGACGGAAGUAGGCGAAAGCCGAAGGAACGCAUG,18,12,16,10,56
3995,23,AACY020553108.1/6925-6975,AUCGUUCAACUCUUCGGAGUCGGAAGUAAGCGAAAGCUGAAGGAACGCAAA,18,9,14,10,51
3996,23,AACY021396263.1/609-663,AUCGUUCAAUUUGCAGUUUGCAAAUCGGAAGUAGGUUAAACCGAAGGAACGCGGA,18,13,15,9,55
3997,23,AACY020200469.1/1034-971,AACGUUCAUUCACUCUAAAUGUAGCAGUGAACGGAAGUAGUCAUUAGUGACGAAGGAACGCAUC,22,15,15,12,64
3998,23,AACY020070556.1/2396-2448,AUCGUUCAACUCUUUUAGAGUCGGAAGUAGGCAUUGUGCCGAAGGAACGCAUG,14,14,15,10,53
3999,23,AACY022986758.1/597-653,AUCGUUCAAUCUAAUUUUUAUUAGAUCGGAAGUAAGCAAAAGCUGAAGGAACGCGCA,21,15,12,9,57
4000,23,AACY020215859.1/578-527,AUCGUUCAACUCUUAUAGAGUCGGAAGUAAGCGAAAGCUGAAGGAACGCAAC,19,10,13,10,52
4001,23,AACY021486302.1/238-293,AUCGUUCAACUCACUUUUUGUGAGUCGGAAGUAAGCGAAAGCUGAAGGAACGCAUG,17,14,15,10,56
4002,23,AACY020152915.1/2051-1995,UUCGUUCAUUUUGAUAUUUUUCAAAACGGAAGUAAACGAAAGUUGAAGGAACGCAUG,20,18,12,7,57
4003,23,AACY022251786.1/888-827,UACGUUCAUCGCUAAUUUAAAUAAUAAGCGACGGAAGUAGGCGAAAGCCGAAGGAACGCAUG,23,12,16,11,62
4004,23,AACY024056113.1/420-366,AUCGUUCAAUUUGCAGUUUGCAAAUCGGAAGUAGGUUUAACCGAAGGAACGCGGA,17,14,15,9,55
4005,23,AACY020084674.1/1398-1344,UGCGUUGAACCUUUUGUAGGUCGCAAGUAACUCUGAAAGAGUGAAGCAACGGGAA,17,13,16,9,55
4006,23,AACY024013942.1/315-365,AUCGUUCAACCAGAUUUGGUCGGAAGUAGGCAAUCGCCGAAGGAACGCACC,15,9,14,13,51
4007,23,AACY023603220.1/978-1030,AUCGUUCAUCUUCGUAAGAAGACGGAAGUAGGUGAAAGCUGAAGGAACGCGAC,18,10,16,9,53
4008,23,AACY020437548.1/1443-1393,ACCGUUCAACUCUUCGGAGUCGGAAGUAAGCGAAAGCUGAAGGAACGCGCU,15,9,15,12,51
4009,23,AACY021012785.1/671-720,AUCGUUCAUCUCUUAUGAGACGGAAGUAGGUGAAAACCGAAGAACGCCGC,16,10,13,11,50
4010,23,AACY023164810.1/255-313,AUCGUUCAAUUUAAAUUUAUUUAAAUCGGAAGUAGAUCUAACGAUCGAAGGAACGCAUG,22,18,11,8,59
4011,23,AACY021092125.1/721-616,GUCGUUUAUCUCAUAAGUAUCUUCUAGUAUCUCCUUAUGGCGCAUAGCAAUAAUUGGUUCAAAACCAUUGUGAGACGCAAGUAAGCGGAAGCUGAAGAAACGGAGU,33,30,24,19,106
4012,23,AACY021818001.1/757-703,UACGUUCAUCUCUUUAUAAGAGACGCAAGUAAGGCAGAGCCUGAAGGAACGGGAA,19,11,15,10,55
4013,23,AACY020440890.1/936-994,AUCGUUCAUCCUUAUUUGGGGACGGAAGUAGGUAAAAAAUCAAACCGAAGGAACGCAUC,21,13,14,11,59
4014,23,AACY020563270.1/1163-1107,AUCGUUCAUCUUUAUGUAAAUAAAGACGGAAGUAGACGAAAGUUGAAGGAACGCGCC,21,13,14,9,57
4015,23,AACY021898535.1/579-635,AUCGUUCAACCUAUAUAAAGUAGGUCGGAAGUAAGCUAACUGCUGAAGGAACGCGCA,20,12,14,11,57
4016,23,AACY024089078.1/634-585,AUCGUUCAUCUAUUAUAGACGGAAGUAGGUAUACACCGAAGGAACGCACC,17,11,11,11,50
4017,23,AACY021929639.1/53-4,AUCGUUCAACCAUAAAGGUCGGAAGUAGGCAAUCGCUGAAGGAACGCACC,17,8,13,12,50
4018,23,AACY020498371.1/1424-1369,UACUUUCAUCCUUAAGGAUGGAAGUAAGUAUUAAUAUAAUACUGAAGGAACGCAUU,21,18,10,7,56
4019,23,AACY021141249.1/378-436,AUCGUUCAUCCUUGUUUGGGGACGGAAGUAGGUGAAAAAUCAAACCGAAGGAACGCAUC,19,13,16,11,59
4020,23,AACY020564601.1/2573-2523,AUCGUUCAUCUCUUAGGAGACGGAAGUAGGUGAAAACCGAAGGAACGCCGC,16,9,15,11,51
4021,23,AACY020443845.1/3224-3276,AUCGUUCAACUCUUUUAGAGUCGGAAGUAGGCAUUGUGCCGAAGGAACGCAUG,14,14,15,10,53
4022,23,AACY022408018.1/692-642,AUCGUUCAACUCUUCGAAGUCGGAAGUAAGCGAAAGCUGAAGGAACGCAAC,18,9,13,11,51
4023,23,AACY022847440.1/120-193,AUCGUUGGGCUAGGGCCUGCUCUUACGGACCUCUUCAGCCGGAAGUAGCCACCCGCGUGGCGAAGCAACGCUCC,13,14,22,25,74
4024,23,AACY022514364.1/625-680,UACGUUCAUCACUCUUUUAGGGUGACGGAAGUAGACGAAAGUCGAAGGAACGCAUG,17,13,16,10,56
4025,23,AACY022360960.1/632-684,AUCGUUCAUCUUCGAAAGAAGACGGAAGUAGACGAAAGUUGAAGGAACGCGCC,19,9,15,10,53
4026,23,AACY021666686.1/204-257,AUCGUUCAUCCUUUCUUGGGACGGAAGUAGGUAAUAGUACUGAAGGAACGCAUC,15,15,14,10,54
4027,23,AACY022555790.1/397-452,AUCGUUCAAUUUGCCUAAGGCAAAUCGGAAGUAGGUUAAAACCGAAGGAACGCGGA,20,11,15,10,56
4028,23,AACY021875306.1/437-490,AUCGUUCAUCCUUUCUUGGGACGGAAGUAGGUAAUAGUACUGAAGGAACGCAUC,15,15,14,10,54
4029,23,AACY022174958.1/859-801,AUCGUUCAUCCUUAUUUGGGGACGGAAGUAGGUAAAAAAUCAAACCGAAGGAACGCAUC,21,13,14,11,59
4030,23,AACY023050337.1/719-664,CUCGUUCAACCCUUAUAACAAGGGUCGGAAGUAGGCACCUGCCGAAGGAACGCUUU,15,12,14,15,56
4031,23,AACY023849639.1/1041-992,AACGUUCAUCCUACGGGACGGAAGUAGGCUUUAUGCUGAAGGAACGCACC,14,10,14,12,50
4032,23,AACY022243878.1/796-842,AUCGUUCAUCCUUAAGGACGGAAGUAGGCUAGCCGAAGGAACGCACU,14,9,13,11,47
4033,23,AACY020248472.1/2303-2362,AUCGUUCAUCCUUGUUAAAAGGACGGAAGUAGGUAAAAAAUCAAACCGAAGGAACGCAUC,24,12,13,11,60
4034,23,AACY020401044.1/5-65,UACGUUCAUCCUAAUUUAUUCAAAUUAGGACGGAAGUAGUCGAAAGACGAAGGAACGCAUU,22,16,13,10,61
4035,23,AACY021736986.1/182-231,AUCGUUCAACCAUAAAGGUCGGAAGUAGGCAAUCGCCGAAGGAACGCACC,17,7,13,13,50
4036,23,AACY024110709.1/433-508,AACGUUGAGCUUGACAGGUGUUCCGCAUCUGUCGUUCAGCCGGAAGUAGCCCCUCCGCAAGGCGAAGCAACGCUCC,16,15,21,24,76
4037,23,AACY020078853.1/300-352,AUCGUUCAUCUCGCAAGAGACGGAAGUAGGUAAUGAUGCCGAAGGAACGCAUC,17,10,15,11,53
4038,23,AACY023598562.1/100-45,AUCGUUCAACCUACUGUUGUAGGUCGGAAGUAAGCUAAAAGCUGAAGGAACGCGCA,18,12,15,11,56
4039,23,AACY023948258.1/60-133,GUCGUUCAUCUCUUUUAGAGAUCUCUUUAAAGGAGACGGAAGUAAGAGACAUAGUGUCCCUGAAGGAACGCGUG,21,20,20,13,74
4040,23,AACY020783410.1/926-871,UACGUUCAUCAUUCUUAUUGAAUGACGGAAGUAGACGAAUGUCGAAGGAACGCAUG,18,15,14,9,56
4041,23,AACY020502872.1/936-874,AUCGUUCAUCUCACUUAAUGGAGACGGAAGUAGGUAACGGGAGAAUUACUAAAGGAACGCAAC,23,13,16,11,63
4042,23,AACY020016022.1/192-141,AUCGUUCAUCCCUUAGGGGGACGGAAGUAGUCGCAAGACGAAGGAACGCAUU,15,10,16,11,52
4043,23,AACY023199264.1/997-1050,AUCGUUCAUCUCGAAAGAGACGGAAGUAGGUAAUGGUUACCGAAGGAACGCACC,18,10,15,11,54
4044,23,AACY020334651.1/776-726,AUCGUUCAUCUCUUAGGAGACGGAAGUAGGUGAAAACCGAAGGAACGCGCC,16,9,15,11,51
4045,23,AACY023527417.1/118-65,AUCGUUCAACUUCAAUACGAAGUCGGAAGUAAGCGAAAGCUGAAGGAACGCAAC,21,9,13,11,54
4046,23,AACY021941581.1/688-741,AUCGUUCAUCCCUUAUAGGGUCGGAAGUAUGCUAUCAUGCAGAAGGAACGCAUC,15,14,13,12,54
4047,23,AACY022252054.1/2-52,AUCGUUCAACCCUUAUGGGUCGGAAGUAGACGAAAGUCGAAGGAUCGCAUG,15,11,15,10,51
4048,23,AACY020962165.1/104-52,AUCGUUCAACCUUUUGAAAGGUCGGAAGUAAGCAACAGCUGAAGGAACGCGGA,18,10,15,10,53
4049,23,AACY023745558.1/395-447,UUCGUUCAUCUCGCAAGAGACGGAAGUAGGUAAUGAUGCCGAAGGAACGCGCU,15,11,16,11,53
4050,23,AACY020330816.1/389-441,AUCGUUCAUCUUCGAAAGAAGACGGAAGUAGGUGAAAGCCGAAGGAACGCGAC,19,8,16,10,53
4051,23,AACY020220361.1/510-560,UACGUUCAUCCUAAAAGGACGGAAGUAGGCUUAAUGCCGAAGGAACGCACC,17,9,13,12,51
4052,23,AACY022594555.1/308-257,AUCGUUCAUCCCUUAGGGGGACGGAAGUAGUCGCAAGACGAAGGAACGCAUU,15,10,16,11,52
4053,23,AACY020555684.1/2503-2555,AUCGUUCAUCUUCGAAAGAAGACGGAAGUAGGUGAAAACUGAAGGAACGCGAC,20,9,15,9,53
4054,23,AACY020388886.1/777-836,AUCGUUCAAUUUAAAUUUAUUUAAAUCGGAAGUAGAUCAUAGCGAUCGAAGGAACGCAUG,22,18,12,8,60
4055,23,AACY023881567.1/1279-1332,AUCGUUCAAUCUGAAUUUUCAGAUCGGAAGUAGGUUAUGCCGAAGGAACGCGGA,16,14,15,9,54
4056,23,AACY020497055.1/1142-1194,AUCGUUCAUCUUCGUAAGAAGACGGAAGUAGACGAAAGUUGAAGGAACGCGCC,18,10,15,10,53
4057,23,AACY024042448.1/97-155,AUCGUUCAUCUCAUUAAAUGAGUGAGACGGAAGUAGGUUGAAAACCGAAGGAACGCUGU,20,14,16,9,59
4058,23,AACY022667721.1/442-387,AUCGUUCAUUUUGUAAAUUUCAAAACGGAAGUAAACGAAAGUUGAAGGAACGCAUG,22,15,12,7,56
4059,23,AACY021827325.1/774-826,AUCGUUCAACUCAAUAUGAGUCGGAAGUAGGCAUUGUGCUGAAGGAACGCAUG,16,13,15,9,53
4060,23,AACY023039004.1/261-210,AUCGUUCAACUCUUUUAGAGUCGGAAGUAAGCGAAAGCUGAAGGAACGCAAC,18,11,13,10,52
4061,23,AACY020334651.1/707-654,AUCGUUCAACUUCAAUAAGAAGUCGGAAGUAAGCGAAAGCUGAAGGAACGCAAC,22,9,13,10,54
4062,23,AACY023282293.1/634-689,CACGUUCAUCAUGUUUCUAACAUGACGGAAGUAGACGAAAGUCGAAGGAACGCAUG,19,12,14,11,56
4063,23,AACY022627048.1/276-217,AUCGUUCAAUUUAAGUAUAUUCUUAAAUCGGAAGUAAGUCUUUGACUGAAGGAACGCAUG,20,20,12,8,60
4064,23,AACY023051680.1/472-528,AUCGUUCAUCUUUAUGUAAAUAAAGACGGAAGUAGACGAAAGUUGAAGGAACGCGCC,21,13,14,9,57
4065,23,AACY023729856.1/46-109,AUCGUUCAUUCACUCUAAAUGUAGCAGUGAACGGAAGUAGUCAAUUUUGAUGAAGGAACGCAUC,21,18,14,11,64
4066,23,AACY023606304.1/143-87,AUCGUUCAUCCACUAGGGACGGAAGUAAGCGUAUAAUAAAUGCUGAAGGAACGCAUU,20,13,14,10,57
4067,23,AACY020477826.1/1925-1980,AUCGUUCAAUUUGCCUAUGGCAAAUCGGAAGUAGGGUUAACCCGAAGGAACGCGGA,17,12,16,11,56
4068,23,AACY022163341.1/230-285,AUCGUUCAUUUUGAAUAAUUCAAAACGGAAGUAAACGAAAGUUGAAGGAACGCAUG,23,14,12,7,56
4069,23,AACY021977799.1/712-766,CACGUUCAAUCUACAUUUGUAGAUCGGAAGUAAGCUUAUGCUGAAGGAACGCGGU,16,15,14,10,55
4070,23,AACY022001680.1/673-623,AUCGUUCAUCCUUAAGGGGACGGAAGUAGUCGCAAGACGAAGGAACGCAUU,16,10,15,10,51
4071,23,AACY023606132.1/47-99,AUCGUUCAACUCUUUUAGAGUCGGAAGUAGGCAUUGUGCCGAAGGAACGCAUG,14,14,15,10,53
4072,23,AACY020061925.1/1057-1109,AUCGUUCAUCUCGAAAGAGACGGAAGUAGGUAAUGGUACCGAAGGAACGCAUC,18,10,15,10,53
4073,23,AACY022183364.1/345-290,UUCGUUCAACCCUUGUAACAAGGGUCGGAAGUAGGCACCUGCCGAAGGAACGCUUU,14,13,15,14,56
4074,23,AACY023136147.1/479-534,AUCGUUCAAUCUGUUUUUAACAGAUCGGAAGUAAGCUAAAGCUGAAGGAACGCGGA,19,14,14,9,56
4075,23,AACY021626373.1/738-687,AUCGUUCAUCUAUUAUAGACGGAAGUAGGUUACUCAACCGAAGGAACGCACC,17,12,11,12,52
4076,23,AACY020132250.1/2989-3039,AUCGUUCAUCUCUUAGGAGACGGAAGUAGGUGAAAACCGAAGGAACGCCGC,16,9,15,11,51
4077,23,AACY024056113.1/488-433,UACGUUCAUCAUUCUCUUUGAAUGACGGAAGUAGACGAAAGUCGAAGGAACGCAUG,18,14,14,10,56
4078,23,AACY021876887.1/419-366,AUCGUUCAAUCUGAUUAUUCAGAUCGGAAGUAGGUUAAACCGAAGGAACGCGGA,18,13,14,9,54
4079,23,AACY020401044.1/66-118,AUCGUUCAUCUCGAAAGAGACGGAAGUAGGUAAUGAUACUGAAGGAACGCGUU,18,12,15,8,53
4080,23,AACY024111564.1/342-287,UACGUUCAUCACUCUUUUAGGGUGACGGAAGUAGACGAAAGUCGAAGGAACGCAUG,17,13,16,10,56
4081,23,AACY023683577.1/316-369,UACGUUCAUCAUGUUUUACAUGACGGAAGUAGGCGAAAGCUGAAGGAACGCAUG,17,13,15,9,54
4082,23,AACY020374393.1/1223-1168,CACGUUCAUCACUCUUUUAGGGUGACGGAAGUAGACGAAAGUCGAAGGAACGCAUG,17,12,16,11,56
4083,23,AACY022183364.1/418-358,AUCGUUCAAUUUAGGAUCAUUCCUAAAUCGGAAGUAAGUCAAAAGACUGAAGGAACGCAUG,23,15,13,10,61
4084,23,AACY020232172.1/1706-1652,CACGUUCAUCACCUUACAGGGUGACGGAAGUAGACGAAAGUCGAAGGAACGCAUG,18,9,16,12,55
4085,23,AACY021066889.1/623-569,AUCGUUCAAUUUGCCAUAGGCAAAUCGGAAGUAGGUUAACCCGAAGGAACGCGGA,18,11,15,11,55
4086,23,AACY020466332.1/944-896,UACGUUCAGGCAUCAGGCCCGGAAGUAGCAUACAGCGAAGGAACGCACC,15,6,14,14,49
4087,23,AACY021252411.1/838-791,AUCGUUUGGCUCAUUGAGUUGGAAGUAAGGUAACUGAAGAAACGCACU,15,13,13,7,48
4088,23,AACY022514364.1/693-748,AUCGUUCAAUUUGCAUUUUGCAAAUCGGAAGUAGGUUCUAACCGAAGGAACGCGGA,17,15,14,10,56
4089,23,AACY021989917.1/195-253,AUCGUUCAUCCUUGUUUGGGGACGGAAGUAGGUAAAAAAUCAAACCGAAGGAACGCAUC,20,13,15,11,59
4090,23,AACY023870187.1/255-308,AUCGUUCAUCCCUUUUUGGGACGGAAGUAGUCAAUUUAGACGAAGGAACGCAUU,15,16,13,10,54
4091,23,AACY022196254.1/55-5,AUCGUUCAACCCUUUUGGGUCGGAAGUAAGCUUCAGCUGAAGGAACGCGGA,13,12,15,11,51
4092,23,AACY020396928.1/115-168,AACGUUCAUCUUUUAAUGAAAGACGGAAGUAGGUUAGAACCGAAGGAACGCAAA,22,11,13,8,54
4093,23,AACY021067381.1/688-626,AUCGUUCAUUCACUCUAAAUGUAGCAGUGAACGGAAGUAGGCAUGGGGCCGAAGGAACGCAUU,19,14,18,12,63
4094,23,AACY020742811.1/396-342,UACGUUCAUCCUUUAGGACGGAAGUAAGUAUUAAUUAAUACUGAAGGAACGCAUU,19,17,11,8,55
4095,23,AACY020025239.1/2914-2867,UACGUUCAUCUAUUAUAGACGGAAGUAGCGAAAGCGAAGGAACGCACC,17,9,12,10,48
4096,23,CP001291.1/2649560-2649636,UACCUUCAUCUCUAUACAGCAAAUUCAACUCAUUGUAGAGAGACGGAAGUAGGUCAAAAGAACCGAAGGAAUGCACC,29,16,15,17,77
4097,23,AACY023076791.1/416-364,UUCGUUCAUCCCGCAAGGGACGGAAGUAGGUGAUAAUACCGAAGGAACGCAUC,16,10,15,12,53
4098,23,AACY022555790.1/330-384,CACGUUCAUCACCCUUUGGGGUGACGGAAGUAGACGAAAGUCGAAGGAACGCAUG,16,10,17,12,55
4099,23,AACY023718151.1/910-962,UACGUUCAUCCUCAAAAGGACGGAAGUAGGCAAUAAAGCUGAAGGAACGCACC,20,8,13,12,53
4100,23,AACY020563764.1/2530-2478,AUCGUUCAUCUUCGAAAGAAGACGGAAGUAGGUGAAAGCUGAAGGAACGCGCC,18,9,16,10,53
4101,23,AACY020555885.1/2589-2539,AUCGUUCAUCUCUUAGGAGACGGAAGUAGGUGAAAACCGAAGGAACGCGCC,16,9,15,11,51
4102,23,AACY024021050.1/503-445,UUCGUUCAUCUUAACUGACGGAAGUAGGGUGUACCUAUAAACACCUGAAGGAACGCAUU,18,16,13,12,59
4103,23,AACY020594496.1/838-888,AUCGUUUAUCCCAAUAGGGACGGAAGUAGGCAAUCGCCGAAGAAACGCUCU,16,10,13,12,51
4104,23,AACY023123681.1/476-531,UACGUUCAUCAUUCUUUUUGAAUGACGGAAGUAGACGAAAGUCGAAGGAACGCAUG,18,15,14,9,56
4105,23,AACY020240095.1/3686-3749,AUCGUUCAUUCACUCUAAAUGUAGCAGUGAACGGAAGUAGUCAAUUGUGACGAAGGAACGCAUC,21,16,15,12,64
4106,23,AACY020192141.1/2161-2107,CACGUUCAUCACCAUAAAUGGUGACGGAAGUAGACGAAAGUCGAAGGAACGCAUG,20,9,15,11,55
4107,23,AACY023729856.1/110-162,UUCGUUCAUCCCAAAAGGGACGGAAGUAGGUGGUAAUACCGAAGGAACGCAUC,17,10,15,11,53
4108,23,AACY020701840.1/541-588,UACGUUCAUCCCUAUGGGACGGAAGUAAGGAAACUGAAGGAACGCACC,16,8,13,11,48
4109,23,AACY021113899.1/734-785,AUCGUUCAACUCAAUAGAGUCGGAAGUACCCAUCAUGGGGAAGGAACGCACU,17,10,13,12,52
4110,23,AACY021364711.1/3-106,GUCGUUUAUCUCAUAAAUAUCUUCAACGAUCUACUUAUAGCGCAAUCAAUAUUUGGUUCAAACCAUUGUGAGACGCAAGUAAGCGGAAGCUGAAGAAACGGAGU,35,29,21,19,104
4111,23,AACY022149997.1/242-190,AUCGUUCAACUUCUUAGGAAGUCGGAAGUAGGUGAAAACUGAAGGAACGCGCC,17,11,15,10,53
4112,23,AACY023895541.1/244-191,AUCGUUCAUCCUCUUAGAGGACGGAAGUAGGUAAUGAUACCGAAGGAACGCAUC,17,12,14,11,54
4113,23,AACY023865164.1/48-165,AACGUUCAUCUUAUUUUAAGACGGAAGUAGGAAGAUACGAUCUGCGUUUACUCUUUCUGAGUGACGCAAGCUUUAGUCGAAAGACUAACAGUCCAUAGAUCUACCGAAGGAACGCGUU,36,33,26,23,118
4114,23,AACY022403129.1/124-179,UACGUUCAUCACUCUUUUAGGGUGACGGAAGUAGACGAAAGUCGAAGGAACGCAUG,17,13,16,10,56
4115,23,AACY022448527.1/404-342,AUCGUUCAUCUUUAGAAAUUUAUUUUUAAAGACGGAAGUAGACGAAAGUUGAAGGAACGCAUG,23,19,14,7,63
4116,23,AACY023616234.1/174-226,AUCGUUCAUCUUCGAAAGAAGACGGAAGUAGGUGAAAACUGAAGGAACGCGAC,20,9,15,9,53
4117,23,AACY022378028.1/248-301,UUCGUUCAUCUCUUUUGGAGACGGAAGUAGGUAAUGGUGCCGAAGGAACGCACU,13,15,16,10,54
4118,23,AACY021233376.1/200-252,AUCGUUCAUCUAUUCAUAUAGACGGAAGUAGGCAGACGCUGAAGGAACGCACU,17,12,13,11,53
4119,23,AACY020315100.1/933-879,AUCGUUCAUCCUUACUUGUAAGGACGGAAGUAGACGAAAGUUGAAGGAACGCGCC,17,12,15,11,55
4120,23,AACY023585828.1/635-579,AUCGUUCAUCCACUAGGGACGGAAGUAAGUGUAUAAUAAACACUGAAGGAACGCAUU,21,13,13,10,57
4121,23,AACY023353218.1/988-1038,CACGUUCAACUCAUUAGAGUCGGAAGUAAGCGUAAGCUGAAGGAACGCACC,17,9,13,12,51
4122,23,AACY023693896.1/589-639,CACGUUCAUCUCGAAAGAGACGGAAGUAGACGAUAGUCGAAGGAACGCAUG,18,8,15,10,51
4123,23,AACY020250641.1/1754-1709,AUCGUUCAUCCCAAUGGGACGCAAGUAAGCCGACUCGGAACGGAUU,13,9,12,12,46
4124,23,AACY022326751.1/241-187,AUCGUUCAAUUUGCAGUUUGCAAAUCGGAAGUAGGUAUACCCGAAGGAACGCGGA,17,13,15,10,55
4125,23,AACY023635669.1/480-533,CACGUUCAUCAUGUUUUACAUGACGGAAGUAAGCGAAAGCUGAAGGAACGCAUG,18,12,14,10,54
4126,23,AACY023928625.1/934-881,AUCGUUCAACUCACUAAGAGUCGGAAGUACCCAUCAUAGGGGAAGGAACGCACU,18,10,13,13,54
4127,23,AACY022667721.1/375-321,AUCGUUCAAUCUGUAUUAACAGAUCGGAAGUAGGCUGCAGCUGAAGGAACGCGGA,17,12,16,10,55
4128,23,AACY020363512.1/1284-1340,AUCGUUCAAUCUAAUUAUUAUUAGAUCGGAAGUAAGCUAAGGCUGAAGGAACGCAGA,21,15,13,8,57
4129,23,AACY020443434.1/284-409,UACGUUCAUCUUAAUCUGCAGGUUAAGACGGAAGUAGGGAGAUAGGAAAACCUCUUUCUUUGAUCAAAGAAAGGCAAGCUAGUACCGAAAGGGAACGAGACCGAAUAUCUACCGAAGGAACGCGUU,44,27,32,23,126
4130,23,AACY024021276.1/365-419,AUCGUUCAUCCUUACUUGUAAGGACGGAAGUAGACGAAAGUUGAAGGAACGCGCC,17,12,15,11,55
4131,23,AACY022183448.1/579-633,AUCGUUCAUCUUUGCUUGCAAAGACGGAAGUAGACAAAAGUUGAAGGAACGCGCC,18,12,14,11,55
4132,23,AACY022978235.1/284-233,AUCGUUCAACUCAAUUGAGUCGGAAGUAGGCAUUAUGCUGAAGGAACGCAUG,16,13,14,9,52
4133,23,AACY023255025.1/888-839,CACGUUCAUCCUAUUAUAGGACGGAAGUAGCAAUAGCGAAGGAACGCACU,17,10,12,11,50
4134,23,AACY023109972.1/190-245,CACGUUCAUCACUCUUUUAGGGUGACGGAAGUAGACGAAAGUCGAAGGAACGCAUG,17,12,16,11,56
4135,23,AACY022196254.1/126-68,AUCGUUCAAUUUAAGAUUUUCUUAAAUCGGAAGUAGGUCUUUGACCGAAGGAACGCAUG,18,19,13,9,59
4136,23,AACY022977491.1/56-114,AUCGUUCAAUUUAAAUUUAUUUAAAUCGGAAGUAGAUCUAACGAUCGAAGGAACGCAUG,22,18,11,8,59
4137,23,AACY022559745.1/837-787,AUCGUUCAACUCAUUAGAGUCGGAAGUAGGCGAUUGCCGAAGGAACGCACC,15,10,14,12,51
4138,23,AACY021844398.1/504-458,AUCGUUCAUCCCAAAAGGGACGCAAGUAAGCCGACUCGGAACGGAUU,15,8,12,12,47
4139,23,AP008231.1/1705656-1705712,AUCGUUGGCCCAGUUUAUCUGGGUGGAAGUAAGGUCUUUGGCCUGAAGCAACGCGCC,11,15,18,13,57
4140,23,AACY023477415.1/486-438,UACGUUCAUCCUCGCAAGAGGACGCAAAAGCCGACUGAAGGAACGGAUG,16,7,14,12,49
4141,23,AACY023249604.1/301-248,AUCGUUCAUCCUUUCUUGGGACGGAAGUAAGUAAUAAUACUGAAGGAACGCAUC,17,15,12,10,54
4142,23,AACY020134078.1/262-212,AUCGUUCAACUCUUCGGAGUCGGAAGUAAGCGAAAGCUGAAGGAACGCGCU,15,10,15,11,51
4143,23,AACY020133097.1/1416-1466,AUCGUUCAUCCCCUAGGGGACGGAAGUAAGCGAAAGCUGAAGGAACGCGCA,16,7,16,12,51
4144,23,BA000022.2/458952-458891,AUCGUUCAUCUUCUCUUUUUGAAGAAGACGGAAGUAGGGAUAUAUUCCUGAAGGAACGCGCC,17,18,15,12,62
4145,23,AACY021804600.1/576-692,UACGUUCAUCAUAUAGCAAUAUAUGACGGAAGUAAGCAACCUGAAAACCUCUUACAUUUGUAAGGCAAGCAAGUACCGAAAGGGAACGAGACCGAAAGUUGACUGAAGGAACGCGUU,44,24,27,22,117
4146,23,AACY020096225.1/446-392,UACGUUCAUCAUCCGUUUGGAUGACGGAAGUAAGCGAAAGCUGAAGGAACGCAUG,17,12,16,10,55
4147,23,AACY021768549.1/729-784,UACGUUCAUCAUUCACUUUGAAUGACGGAAGUAGACGAAAGUCGAAGGAACGCAUG,19,13,14,10,56
4148,23,AACY020039026.1/3657-3709,AUCGUUCAUCUCGAAAGAGACGGAAGUAGGUAAUGAUACCGAAGGAACGCAUC,19,10,14,10,53
4149,23,AACY022499355.1/321-269,AUCGUUCAACUUCUUAGGAAGUCGGAAGUAGGUGAAAACCGAAGGAACGCGCC,17,10,15,11,53
4150,23,AACY021363006.1/402-353,UACGUUCAACCUUAUGGUCGGAAGUAAGCUUGUAGCUGAAGGAACGCGAU,14,13,14,9,50
4151,23,AACY023900896.1/540-595,AUCGUUCAAUCUGAAUUAAUUCAGAUCGGAAGUAGGUUAAACCGAAGGAACGCGGA,20,13,14,9,56
4152,23,AACY023615516.1/874-927,AUCGUUCAACUUCAUUACGAAGUCGGAAGUAAGCGAAAGCUGAAGGAACGCAAC,20,10,13,11,54
4153,23,AACY020388700.1/1545-1494,AUCGUUCAACUCUUUUAGAGUCGGAAGUAAGCGAAAGCUGAAGGAACGCAAC,18,11,13,10,52
4154,23,AACY023484124.1/902-852,AUCGUUCAACUCUGAGGAGUCGGAAGUAAGCGAAAGCUGAAGGAACGCGCU,16,9,16,10,51
4155,23,AACY022842103.1/565-617,AUCGUUCAACUCUUUAUAGAGUCGGAAGUAGGCAAUAGCCGAAGGAACGCAUG,17,12,14,10,53
4156,23,AACY022404797.1/184-240,AUCGUUCAACUUAUUAUACAAUAAGUCGGAAGUAAGCUAAAGCUGAAGGAACGCGCA,22,13,12,10,57
4157,23,AACY023268770.1/563-512,AUCGUUUAUCCCAUUUUGGGACGGAAGUAGGCAAUCGCCGAAGAAACGCACC,15,11,13,13,52
4158,23,AACY020042403.1/1204-1151,AUCGUUCAAUAUGCAAAUGCAUAUCGGAAGUAGGUAAAACCGAAGGAACGCGGA,21,10,14,9,54
4159,23,AACY020428011.1/1761-1709,AUCGUUCAACUUCUUAGGAAGUCGGAAGUAGGUGAAAACCGAAGGAACGCGCC,17,10,15,11,53
4160,23,AACY021334105.1/365-315,AUCGUUCAACCCAAAUGGGUCGGAAGUAAGCAUCAGCUGAAGGAACGCGCA,17,8,14,12,51
4161,23,AACY022978235.1/220-164,AUCGUUCAAUCUAUUUUUAAUAGAUCGGAAGUAAGCACCAAGCUGAAGGAACGCGCA,20,14,12,11,57
4162,23,AACY021861345.1/60-113,AACGUUCAUCCCAUAAGGGGACGGAAGUAAGCAAUCAUGCUGAAGGAACGCACU,19,9,14,12,54
4163,23,AACY022135883.1/600-541,AUCGUUCAUCUCAUUUAAUGAAUGAGACGGAAGUAGGUUUAGUUACUGAAGGAACGCGGU,18,18,16,8,60
4164,23,AACY020443307.1/1766-1818,AUCGUUCAUCUCUAUUAGGAGACGGAAGUAGACAAAAGUUGAAGGAACGCGCU,18,12,14,9,53
4165,23,AACY023689073.1/1342-1284,AUCGUUCAUCUCAUUUAAUGAGUGAGACGGAAGUAGGUUGAAAGCCGAAGGAACGCUGU,18,15,17,9,59
4166,23,AACY020151967.1/2177-2122,UACGUUCAUCACUCUUAUAGGGUGACGGAAGUAGACGAAAGUCGAAGGAACGCAUG,18,12,16,10,56
4167,23,AACY021702671.1/742-687,AUCGUUCAAUCUGUAUAAACAGAUCGGAAGUAGGCUAAUAGCCGAAGGAACGCGGA,20,11,15,10,56
4168,23,AACY021302428.1/187-138,CACGUUCAUCCUAUCAAGGACGGAAGUAGCAUAACGCGAAGGAACGCACC,17,7,12,14,50
4169,23,AACY023879838.1/214-163,AUCGUUCAACCCUUUUUGGGUCGGAAGUAAGCUUCAGCUGAAGGAACGCGAA,14,13,14,11,52
4170,23,AADV02000026.1/14400-14340,AUCGUUCAUCUGCUGCUAUCAGCAGACGGAAGUAGGGAAAAAUAUCCCGAAGGAACGCGCC,19,11,16,15,61
4171,23,AACY022448527.1/329-269,AUCGUUCAAUUCUCAUUAUUUUUUGAGAAUCGGAAGUAGGUUUAUACCGAAGGAACGCGGA,18,20,14,9,61
4172,23,AACY020482819.1/233-180,AUCGUUCAUCUUCUACUAGAAGACGGAAGUAAGCGAAAGCCGAAGGAACGCGUG,18,10,15,11,54
4173,23,AACY021451918.1/661-712,AACGUUCAUCCUAAAAAGGACGGAAGUAGGCAAUAUGCCGAAGGAACGCACC,20,7,13,12,52
4174,23,AACY022691753.1/662-610,AUCGUUCAUCUUCGAAAGAAGACGGAAGUAGGUGAAAACUGAAGGAACGCGAC,20,9,15,9,53
4175,23,AACY022242696.1/765-815,CACGUUCAUCCUUAACAGGACGGAAGUAGGCUUAUGCUGAAGGAACGCAUU,15,12,13,11,51
4176,23,AACY022800930.1/463-412,UACGUUCAUCCCUCCGGGGACGCAAGUAGGACAGAGUCCGAAGGAACGGGAG,14,7,18,13,52
4177,23,AACY023174288.1/756-811,AUCGUUCAUCCUAACUAAUAAGGACGGAAGUAAGCUUCAUGCUGAAGGAACGCGCU,18,13,13,12,56
4178,23,AACY020106880.1/29-81,AUCGUUCAUCUUUGAAAAAAGACGGAAGUAGGUGAAAGCCGAAGGAACGCGAG,20,9,16,8,53
4179,23,AACY021423025.1/318-373,AUCGUUCAAUUUGCUUUAAGCAAAUCGGAAGUAGGUUUUUACCGAAGGAACGCGGA,17,16,14,9,56
4180,23,AACY020210349.1/1880-1826,AUCGUUCAACUCGUAGUGAGUCGGAAGUAGGUACAUUGUACCGAAGGAACGCAUG,16,13,16,10,55
4181,23,AACY023549608.1/451-399,AUCGUUCAUCUCGAAAGAGACGGAAGUAGGUAAUGAAGCCGAAGGAACGCAUC,19,9,15,10,53
4182,23,AACY020234329.1/394-340,AUCGUUCAUCCUUACUUGUAAGGACGGAAGUAGACGAAAGUUGAAGGAACGCGCC,17,12,15,11,55
4183,23,AACY023407327.1/810-760,AUCGUUCAUCCAUUUACGGACGGAAGUAAGCAACAGCUGAAGGAACGCGCU,16,10,13,12,51
4184,23,AACY021390959.1/810-861,AACGUUCAUCUAUCUAGACGGAAGUAAGGCUUCUAGCCUGAAGGAACGCAUU,16,13,12,11,52
4185,23,AACY021347722.1/342-294,UUCGUUCAUCUCCUACGGGAGACGCAAAAGCCGACUGAAGGAACGGGAA,15,8,14,12,49
4186,23,AACY020034973.1/2040-1979,UACGUUCAUCUCCUAACACUAGGAGACGCAAGUACCUCACGAAUGGAGGGAAGGAACGGGAA,21,10,17,14,62
4187,23,AACY020132250.1/2937-2987,AUCGUUCAACUCUUCGGAGUCGGAAGUAAGCGAAAGCUGAAGGAACGCAAA,18,9,14,10,51
4188,23,AACY020157868.1/401-455,AUCGUUCAAUCUGUAUUAACAGAUCGGAAGUAGGCUAAAGCUGAAGGAACGCGGA,19,12,15,9,55
4189,23,AACY023545052.1/258-203,AUCGUUCAAUUUGCCUUAGGCAAAUCGGAAGUAGGUUUAUACCGAAGGAACGCGGA,17,14,15,10,56
4190,23,AACY021890349.1/593-642,AUCGUUUAUCCUAUACGGACGGAAGUAGGCAUUUGCCGAAGAAACGCACC,15,11,12,12,50
4191,23,AACY022378028.1/193-244,UUCGUUCAUCUAUCUAGACGGAAGUAAAGCUUUUGGCUUGAAGGAACGCGUU,13,17,13,9,52
4192,23,AACY020399464.1/855-915,AUCGUUCAAUUCUCAUAAAUAUUUGAGAAUCGGAAGUAGGUUUAUACCGAAGGAACGCGGA,21,17,14,9,61
4193,23,AACY021953087.1/881-823,AUCGUUCAUCGUUAUUUGGGGACGGAAGUAGGUAAAAAAUCAAACCGAAGGAACGCAUC,21,13,15,10,59
4194,23,AACY022957008.1/763-713,AUCGUUCAACUCUUCGGAGUCGGAAGUAAGCGAAAGCUGAAGGAACGCGCU,15,10,15,11,51
4195,23,AACY022120080.1/17-69,AUCGUUCAUCUUCUAAAGAAGACGGAAGUAAGCGAAAGCUGAAGGAACGCGGC,19,9,15,10,53
4196,23,AACY020210349.1/1813-1757,AUCGUUCAAUCUAAUGUUGAUUAGAUCGGAAGUAAGCUCCAGCUGAAGGAACGCGCA,18,14,14,11,57
4197,23,AACY020210502.1/438-383,CACGUUCAUCACUCUUUUAGGGUGACGGAAGUAGACGAAAGUCGAAGGAACGCAUG,17,12,16,11,56
4198,23,AACY021451657.1/180-230,AUCGUUCAACUCUUCGGAGUCGGAAGUAAGCGAAAGCUGAAGGAACGCGCU,15,10,15,11,51
4199,23,AACY020192141.1/2094-2039,AUCGUUCAAUUUGCCUUAGGCAAAUCGGAAGUAGGUUUAUACCGAAGGAACGCGGA,17,14,15,10,56
4200,23,AACY020502525.1/359-305,AUCGUUCAUCCUUACAUGUAAGGACGGAAGUAGACGAAAGUUGAAGGAACGCGCC,18,11,15,11,55
4201,23,AACY020215975.1/332-285,UUCGUUCAGGCACUGGCCCGGAAGUAGCAUACAGCGAAGGAACGCACC,13,7,14,14,48
4202,23,AACY023937387.1/1535-1585,AACGUUCAACCAUUAUGGUCGGAAGUAGGUUUGAAGCCGAAGGAACGCAUC,16,11,14,10,51
4203,23,AACY023536350.1/587-532,CACGUUCAUCACUCUUUUAGAGUGACGGAAGUAGACGAAAGUCGAAGGAACGCAUG,18,12,15,11,56
4204,23,AACY020399464.1/780-842,AUCGUUCAUCUUUAAAAAUUUAUUUUUAAGGACGGAAGUAGACGAAAGUUGAAGGAACGCAUG,23,19,14,7,63
4205,23,AACY021885836.1/326-273,UUCGUUCAUCUCUUUAAGAGACGGAAGUAGGUAAUGAUGCCGAAGGAACGCACU,16,14,14,10,54
4206,23,AACY021946484.1/524-582,AUCGUUCAAUUUAAGUUUUUCUUAAAUCGGAAGUAAGUCUUUGACUGAAGGAACGCAUG,18,21,12,8,59
4207,23,AACY022283709.1/46-98,AUCGUUCAACUUCUUAGGAAGUCGGAAGUAGGUGAAAACCGAAGGAACGCGCC,17,10,15,11,53
4208,23,AACY020235333.1/134-79,AUCGUUCAAUUUGUCUUUGGCAAAUCGGAAGUAGGUUUAAACCGAAGGAACGCGGA,17,15,15,9,56
4209,23,AACY020766012.1/637-583,AUCGUUCAAUCUGUAUUAACAGAUCGGAAGUAGGCUAAAGCUGAAGGAACGCGGA,19,12,15,9,55
4210,23,AACY023899502.1/1274-1328,AUCGUUCAUCCUUACUUGUAAGGACGGAAGUAGACGAAAGUUGAAGGAACGCGCC,17,12,15,11,55
4211,23,AACY022336911.1/652-702,AUCGUUCAACCCUGAAGGGUCGGAAGUAAGCUUCAGCUGAAGGAACGCGAA,16,9,15,11,51
4212,23,AACY023520018.1/1362-1418,UUCGUUCAUCAGAGAAGACCCUGACGGAAGUAGGUAAUGACACCGAAGGAACGCAUC,19,10,15,13,57
4213,23,AACY020456021.1/49-101,AUCGUUCAUCUCGAGAGAGACGGAAGUAGGUAAUGAUGCCGAAGGAACGCACC,17,9,16,11,53
4214,23,AACY023065314.1/381-329,AUCGUUCAUCUUCGAGAGAAGACGGAAGUAGGUGAAAGCUGAAGGAACGCGAC,18,9,17,9,53
4215,23,AACY022102949.1/877-822,AUCGUUCAACCUAUUUUCAUAGGUCGGAAGUAAGCCAUAAGCUGAAGGAACGCUCA,18,14,12,12,56
4216,23,AACY023007897.1/839-894,CACGUUCAUCACUCUUUUAGGGUGACGGAAGUAGACGAAAGUCGAAGGAACGCAUG,17,12,16,11,56
4217,23,AACY021241356.1/534-486,AUCGUUCAGCCAUGAUGGCCGGAAGUAGGUAAUACCGAAGGAACGCACC,15,8,14,12,49
4218,23,AACY023736167.1/1195-1245,AUCGUUCAACCCGCAUGGGUCGGAAGUAAGCUGAAGCUGAAGGAACGCGAA,16,8,16,11,51
4219,23,AACY020419699.1/478-538,AUCGUUCAAUUCUCAUUAAUAUUUGAGGAUCGGAAGUAGGUUUAUACCGAAGGAACGCGGA,19,18,15,9,61
4220,23,AACY020346740.1/174-231,AUCGUUCAUCUCAUAAUUUGAGUGAGACGGAAGUAGGGUAAAACCGAAGGAACGCAGU,20,13,16,9,58
4221,23,AACY024076743.1/893-788,GUCGUUUAUCUCAUAAGUAUUUUCCAGUAUCUCCUUAAGGCGCACAGCAAAAAUUGGUUCAAAACCAUUGUGAGACGCAAGUAAGCGGAAGCUGAAGAAACGGAGU,35,27,24,20,106
4222,23,AACY024104261.1/967-915,AUCGUUCAUCUUCGUAAGAAGACGGAAGUAGGUGAAAGCUGAAGGAACGCGAC,18,10,16,9,53
4223,23,AACY023448407.1/107-157,AACGUUCAUCCCUUAGGGGACGGAAGUAGUCAUAAGACGAAGGAACGCAUU,17,10,14,10,51
4224,23,AACY020094250.1/485-531,AUCGUUCAGUCCCAUAAGGGACCGCAAGUAAGCCGACACGGAACGGA,15,6,13,13,47
4225,23,AACY020476800.1/1958-1908,AUCGUUCAUCCCCUAGGGGACGGAAGUAAGCGAAAGCUGAAGGAACGCGCA,16,7,16,12,51
4226,23,AACY020042403.1/1270-1217,CACGUUCAUCAUGUUUUACAUGACGGAAGUAGACGAAAGUCGAAGGAACGCAUG,18,12,14,10,54
4227,23,AACY022668466.1/390-444,AUCGUUCAAUUUGCAGCUUGCAAAUCGGAAGUAGGUAUACCCGAAGGAACGCGGA,17,12,15,11,55
4228,23,AACY023104284.1/766-826,AUCGUUCAAUUUAGGAUUAUUCCUGAAUCGGAAGUAAGUCAAAAGACUGAAGGAACGCAUG,22,16,14,9,61
4229,23,AACY024103490.1/687-737,AUCGUUCAACUCUUCGGAGUCGGAAGUAAGCGAAAGCUGAAGGAACGCGCU,15,10,15,11,51
4230,23,AACY023204119.1/495-442,AUCGUUCAUCCCUUAUAGGGUCGGAAGUAUGCUAUAAUGCAGAAGGAACGCAUC,16,14,13,11,54
4231,23,AACY023015051.1/670-527,AUCGUUCAUCUUAUUUUAUUAAAUAGGACGGAAGUAGGAAGAUAGGAAAACCUCUUUCUUUUUUAAAGAAAGGCUAGCAAGUACCGCUUGGGUUAAUUUAUCUUAGGCGGGAACGAGACCGAAUAUCUGCCGAAGGAACGCGUU,45,42,34,23,144
4232,23,AACY021720846.1/185-129,UUCGUUCAUUUUGAUUAUUUUCAAAACGGAAGUAGACAUAAGUCGAAGGAACGCGUG,18,18,13,8,57
4233,23,AACY020505512.1/1125-1075,AUCGUUCAACUCUUCGGAGUCGGAAGUAAGCGAAAGCUGAAGGAACGCGCU,15,10,15,11,51
4234,23,AACY023949594.1/631-577,AUCGUUCAAUUUGCAGUUUGCAAAUCGGAAGUAGGUUAAACCGAAGGAACGCGGA,18,13,15,9,55
4235,23,AACY020135087.1/1498-1558,UACGUUCAUCCUAAUUUAAUCAAAUUAGGACGGAAGUAGUCGUGAGACGAAGGAACGCAUU,21,16,14,10,61
4236,23,AACY020331357.1/1358-1410,AUCGUUCAUCUUCGGAAGAAGACGGAAGUAGGUGAAAACCGAAGGAACGCGAC,19,8,16,10,53
4237,23,AACY022617765.1/678-626,AUCGUUCAUCCCUUUAGGGUCGGAAGUAUGCAUUAAUGCAGAAGGAACGCAUC,15,14,13,11,53
4238,23,AAXW01000008.1/84668-84587,GUCGUUCAUCUCUACAUUGUUACGAGAAAACACAGUGAAGGGACGGAAGUAGGCUUGUAUCAUGAAGCCGAAGGAACGCUCA,26,18,22,16,82
4239,23,AACY023647930.1/388-442,AUCGUUCAACCUAUUAUUUAGGUCGGAAGUAAGCCAAAAGCUGAAGGAACGCGCA,19,12,13,11,55
4240,23,AACY023099954.1/111-167,AUCGUUCAUCUUUAUGUAAAUAAAGACGGAAGUAGACGAAAGUUGAAGGAACGCGCC,21,13,14,9,57
4241,23,AACY021623722.1/425-479,AUCGUUCAAUCUGUAUUAACAGAUCGGAAGUAGGCUAAAGCUGAAGGAACGCGGA,19,12,15,9,55
4242,23,AACY021267397.1/434-486,GUCGUUCAUCUCAAAUGAGACGGAAGUAGGUAAUAUAACCGAAGGAACGCACU,19,11,13,10,53
4243,23,AACY023745558.1/335-391,UUCGUUCAUCUAUCUAGACGGAAGUAAGUCUUUAAUUUAAGACUGAAGGAACGCAUU,18,19,11,9,57
4244,23,AACY021138991.1/535-589,AUCGUUCAAUUUGCCAUAAGCAAAUCGGAAGUAGGUUAAACCGAAGGAACGCGGA,20,11,14,10,55
4245,23,AACY023501516.1/463-414,UACGUUCAGCCUUAUGGUCGGAAGUAAGCUUGUAGCUGAAGGAACGCAAA,15,12,14,9,50
4246,23,AACY023870187.1/312-365,AUCGUUCAUCCUCUUAGAGGACGGAAGUAGGUAAUGAUACCGAAGGAACGCAUC,17,12,14,11,54
4247,23,AACY020338589.1/245-295,AUCGUUCAUCUCUUAGGAGACGGAAGUAGGUGAAAACCGAAGGAACGCGCC,16,9,15,11,51
4248,23,AACY021391528.1/593-646,UACGUUCAUCUUACAAAGUAAGACGGAAGUAAGCGAAUGCUGAAGGAACGCACC,20,10,13,11,54
4249,23,AACY020396882.1/757-816,AUCGUUCAAUUUAGGUUUUAACUUAAAUCGGAAGUAGAUCUUUGAUCGAAGGAACGCAUG,19,20,13,8,60
4250,23,AJ630128.1/142359-142415,AUCGUUCAUUCGCUAUUCGCAAAUAGCGAACGCAAAAGCCGACUGAAGGAACGGGAC,19,10,14,14,57
4251,23,AACY020428429.1/870-817,AUCGUUCAACUUCAAUACGAAGUCGGAAGUAAGCGAAAGCUGAAGGAACGCAAC,21,9,13,11,54
4252,23,AACY024021050.1/441-384,CUCGUUCAUUCUCAUAGACUGAGAACGGAAGUAGGUAAUGACACCGAAGGAACGCAUC,19,12,14,13,58
4253,23,AACY021396263.1/541-596,UACGUUCAUCAUUCUUAUUGAAUGACGGAAGUAGACGAAAGUCGAAGGAACGCAUG,19,14,14,9,56
4254,23,AACY020039042.1/482-534,AUCGUUCAUCUCGCAAGAGACGGAAGUAGGUAAUGAUACCGAAGGAACGCAUC,18,10,14,11,53
4255,23,AACY020425839.1/427-482,AUCGUUCAACCUAUAUAUAUAGGUCGGAAGUAAGCUAUAAGCUGAAGGAACGCGCA,20,13,13,10,56
4256,23,AACY020141842.1/1386-1335,AUCGUUCAACUCUUUUAGAGUCGGAAGUAAGCGAAAGCUGAAGGAACGCAAC,18,11,13,10,52
4257,23,AACY020396882.1/829-878,AUCGUUCAACCCUUUUGGGUCGGAAGUAGGCAAAGCUGAAGGAACGCGCA,14,10,15,11,50
4258,23,AACY022997040.1/784-729,UACGUUCAUCAUGUGUUUAACAUGACGGAAGUAGGCGAAAGCCGAAGGAACGCAUG,18,12,16,10,56
4259,23,AACY020266601.1/1180-1128,AUCGUUCAUCUUCGAAAGAAGACGGAAGUAGGUGAAAACUGAAGGAACGCGAC,20,9,15,9,53
4260,23,AACY021281822.1/369-422,CUCGUUCAUCUCUUUAAGAGACGGAAGUAGGUAAUGAUGCCGAAGGAACGCACU,16,13,14,11,54
4261,23,AACY021669684.1/506-562,AUCGUUCAACUCAUUGUGAGUCGGAAGUAGGCAUUACUAGUGCUGAAGGAACGCAUG,16,15,16,10,57
4262,23,AACY023503565.1/654-602,AUCGUUCAACUUCUUAGGAAGUCGGAAGUAGGUGAAAACCGAAGGAACGCGCC,17,10,15,11,53
4263,23,AACY021978343.1/929-873,AUCGUUCAAUCUGUUGAAUGCAGAUCGGAAGUAGGAUAAAAUCUGAAGGAACGCGGA,20,13,16,8,57
4264,23,AACY020473531.1/2284-2334,AUCGUUCAACUCAAAUGAGUCGGAAGUAGGCACAUGCCGAAGGAACGCACC,17,8,13,13,51
4265,23,AACY021804470.1/673-738,AUCGUUCAUCUUGUAAGUUUUCUAAGCUUAUUGGACGGAAGUAGACGAAAGUCGAAGGAACGCAUG,20,19,17,10,66
4266,23,AACY023184960.1/517-567,AACGUUCAACCAUUUAGGUCGGAAGUAGGUUUGAAGCCGAAGGAACGCAUC,16,11,14,10,51
4267,23,AACY020001711.1/3605-3667,UACGUUCAUCUCAACACAUUGUUGGGACGCAAGUAAGCAAGUUAAGUGCUGAAGGAACGGGAA,21,14,17,11,63
4268,23,AACY023516001.1/535-484,UUCGUUCAACCCCAAAAGGGUCGGAAGUAGGCAUCAGCUGAAGGAACGCUUA,16,10,14,12,52
4269,23,AACY022521969.1/316-264,AUCGUUCAACUCAAUUUGAGUCGGAAGUAGGCAUUGUGCCGAAGGAACGCAUG,15,13,15,10,53
4270,23,AACY023629992.1/212-160,AUCGUUCAUCUCGAAAGAGACGGAAGUAGGUAAUGAUACCGAAGGAACGCAUC,19,10,14,10,53
4271,23,AACY020236614.1/876-926,AUCGUUCAACUCUUCGGAGUCGGAAGUAAGCGAAAGCUGAAGGAACGCGCU,15,10,15,11,51
4272,23,AACY024036082.1/501-556,UACGUUCAUCACUCUUUUAGGGUGACGGAAGUAGACGAAAGUCGAAGGAACGCAUG,17,13,16,10,56
4273,23,AACY020101836.1/1327-1222,GUCGUUUAUCUCAUAAGUAUCUUCUAGUAUCUCCUUAUGGCGCAUAGCAAUAAUUGGUUCAAAACCAUUGUGAGACGCAAGUAAGCGGAAGCUGAAGAAACGGAGU,33,30,24,19,106
4274,23,AACY020141842.1/1458-1406,AUCGUUCAACUUCUUAGGAAGUCGGAAGUAGGUGAAAACCGAAGGAACGCGCC,17,10,15,11,53
4275,23,AACY020428904.1/128-179,AUCGUUCAACUCUUUUAGAGUCGGAAGUAAGCGAAAGCUGAAGGAACGCAAC,18,11,13,10,52
4276,23,AACY023550809.1/726-595,AUCGUUCAUUCAGUGCUCUUUUUUAGUGCAUUGAACGGAAGUAGGAAAACCUGAAAACCUCUAUCUGAAAAGAUAGGUAAGCAAGUACCCAUAAGGGGAACGAGACCGAAAGUUUUACCGAAGGAACGCGUU,45,32,31,24,132
4277,23,AACY020232024.1/232-286,AUCGUUCAUCCUUACUUGUAAGGACGGAAGUAGACGAAAGUUGAAGGAACGCGCC,17,12,15,11,55
4278,23,AACY022466684.1/260-381,UUCGUUCAUCUUAUAUUUUAUAUAAGACGGAAGUAGGAAACCUGAAAACCUCUUUCUAUUCAGAAAGGCAAGCAAGUACCCGCAAGGGGAACGAGACCGAAAGUUUACCGAAGGAACGCUAU,43,29,26,24,122
4279,23,AACY021808171.1/320-267,UACGUUCAUCAUGUUUUACAUGACGGAAGUAGACGAAAGUCGAAGGAACGCAUG,18,13,14,9,54
4280,23,AACY020394557.1/1138-1188,AUCGUUCAACUCUUCGGAGUCGGAAGUAAGCGAAAGCUGAAGGAACGCGCU,15,10,15,11,51
4281,23,AACY020362314.1/1080-1026,AUCGUUCAAUCUGUUUUUACAGAUCGGAAGUAAGCUAAAGCUGAAGGAACGCGGA,18,14,14,9,55
4282,23,AACY022404797.1/122-172,AUCGUUCAUCUCCAAGGAGACGGAAGUAGACUUAGGUCGAAGGAACGCAUG,16,10,15,10,51
4283,23,AACY020209947.1/299-354,AUCGUUCAAUUUGCCCUUAGGCAAAUCGGAAGUAGGUUAAACCGAAGGAACGCGGA,18,12,15,11,56
4284,23,AACY020208065.1/308-212,AACGUUCAUCUCACUUGUUAGUGAGACGGAAGUAGGAAGAUAGGAGCUUGAAAGCUCCGCUGCGAGUAAAUUGCUAAAUCUGCCGAAGGAACGCGUU,29,23,27,18,97
4285,23,AACY023081145.1/227-278,AUCGUUCAACUCUUUUAGAGUCGGAAGUAAGCGAAAGCUGAAGGAACGCAAC,18,11,13,10,52
4286,23,AACY023165440.1/662-610,UUCGUUCAACCUAGAAAUAGGUCGGAAGUAGGGUAAUACCGAAGGAACGCGCC,17,10,15,11,53
4287,23,AACY020123372.1/1977-2040,UUCGUUCAUUCACUCUAAAUGUAGCAGUGAACGGAAGUAGUCAAUUGUGACGAAGGAACGCAUC,20,17,15,12,64
4288,23,AACY023910677.1/47-97,AUCGUUCAACUCUUCGGAGUCGGAAGUAAGCGAAAGCUGAAGGAACGCAAA,18,9,14,10,51
4289,23,AACY023579103.1/822-764,AUCGUUCAUCCUUAUUGAAAGGACGGAAGUAGGUAAAAAUCAAACCGAAGGAACGCAUC,23,12,13,11,59
4290,23,AACY023109972.1/258-312,AUCGUUCAAUUUGCAGUUUGCAAAUCGGAAGUAGGUAUACCCGAAGGAACGCGGA,17,13,15,10,55
4291,23,AACY023150189.1/610-560,AUCGUUCAACUCUUCGGAGUCGGAAGUAAGCGAAAGCUGAAGGAACGCAAA,18,9,14,10,51
4292,23,AACY020237209.1/884-811,AUCGUUGGGCUCGGGCCUGCUCUUACAGACCUCUUCAGCCGGAAGUAGCCACCCGCGUGGCGAAGCAACGCUCC,13,14,21,26,74
4293,23,AACY021784107.1/103-51,AUCGUUCAACUCUUUACAGAGUCGGAAGUAAGCGAAAGCUGAAGGAACGCGCA,18,10,14,11,53
4294,23,AACY020214273.1/1267-1172,AUCGUUCAUUCUCGCAACGAGAACGGAAGUAAGAAACCUGAAAACCUCUCACUUUCUGUGAGGCUAGUUAACCGAAAGUUUCCGAAGGAACGCAUG,31,22,21,22,96
4295,23,AACY020151967.1/136-81,CACGUUCAUCACUCUUAUAGGGUGACGGAAGUAGACGAAAGUCGAAGGAACGCAUG,18,11,16,11,56
4296,23,AACY023616234.1/101-155,AUCGUUCAUCCUUACUUGUAAGGACGGAAGUAGACGAAAGUUGAAGGAACGCGCC,17,12,15,11,55
4297,23,AACY021883244.1/45-103,CACGUUCAUUUGCUAUUUGCAAAUAGCAAACGGAAGUAGGGAUACCGAAGGAACGCGAA,21,12,15,11,59
4298,23,AACY021946484.1/595-645,AUCGUUCAACCCAUUUGGGUCGGAAGUAAGCUGAAGCUGAAGGAACGCGAA,16,10,15,10,51
4299,23,AACY020938992.1/540-595,AUCGUUCAUUUUGAGUAUCUCAAAACGGAAGUAAACGAAAGUUGAAGGAACGCAUG,21,14,13,8,56
4300,23,AACY023091009.1/272-216,CACGUUCAUCACUAUUUUUUGAGUGACGGAAGUAGACGAAAGUCGAAGGAACGCAUG,18,14,15,10,57
4301,23,AACY023987148.1/159-105,AUCGUUCAAUCUGUAUUAACAGAUCGGAAGUAGGCUAAAGCUGAAGGAACGCGGA,19,12,15,9,55
4302,23,AACY023530723.1/1332-1382,AUCGUUCAUCUCUUAGGAGACGGAAGUAGGUGAGAACCGAAGGAACGCCAC,16,9,15,11,51
4303,23,AACY021402648.1/672-624,AACGUUCACCCGAAAGGGCGGAAGUAGGCAAUCGCUGAAGGAACGCACC,16,5,15,13,49
4304,23,AACY023581064.1/358-408,AUCGUUCAACUCUUCGGAGUCGGAAGUAAGCGAAAGCUGAAGGAACGCGCU,15,10,15,11,51
4305,23,AACY020061925.1/1003-1053,AUCGUUCAUCCCUAGAGGGACGGAAGUAGUCGCAAGAUGAAGGAACGCAUU,16,10,15,10,51
4306,23,AACY022670969.1/833-886,UACGUUCAUCUUUUUAAAUAAAGACGGAAGUAGACGAAAGUCGAAGAACGCAUG,21,13,12,8,54
4307,23,AACY024019205.1/1314-1364,AUCGUUCAACUCUUCGGAGUCGGAAGUAAGCGAAAGCUGAAGGAACGCGCU,15,10,15,11,51
4308,23,AACY023545356.1/434-488,CACGUUCAUCACCUUUUAUGGUGACGGAAGUAGACGAAAGUCGAAGGAACGCAUG,17,12,15,11,55
4309,23,AACY020070556.1/2461-2516,AUCGUUCAACCUAUUACUAUAGGUCGGAAGUAAGCCAAAAGCUGAAGGAACGCGCA,20,11,13,12,56
4310,23,AACY020078007.1/998-944,AUCGUUCAAUCCUUUUUAGGGGUCGGAAGUAGGUAUCAUACUGAAGGAACGCGGA,15,15,16,9,55
4311,23,AACY021702671.1/811-755,UUCGUUCAUUUUGAUUAAUUUCAAAACGGAAGUAGACAUAUGUCGAAGGAACGCGUG,18,18,13,8,57
4312,23,AACY023359536.1/288-339,UACGUUCAUCCCUUUUGGGACGCAAGUAAGCCAGAGGCUGAAGGAACGGGAA,15,10,16,11,52
4313,23,AACY020458048.1/622-572,UACGUUCAUCCUACAAAAGGACGGAAGUAGCACUAUGCGAAGGAACGCACU,18,9,12,12,51
4314,23,AACY020235333.1/201-147,CACGUUCAUCACCUAGUUGGGUGACGGAAGUAGACGAAAGUCGAAGGAACGCAUG,17,10,17,11,55
4315,23,AACY021769560.1/74-126,AUCGUUCAUCUCGAAAGAGACGGAAGUAGGUAAUGGUACCGAAGGAACGCAUC,18,10,15,10,53
4316,23,AACY023950991.1/720-674,UACGUUCAUCCAAUGGGACGGAAGUAGGGAAACCGAAGGAACGCACU,16,7,14,10,47
4317,23,AACY020203238.1/1485-1532,UACGUUCAUCCCACAGGGACGGAAGUAGCGAAAGCGAAGGAACGCACU,16,6,14,12,48
4318,23,AACY023655704.1/781-728,AACGUUCAAUCUAUAUUAUAGAUCGGAAGUAAGCUUAUGCUGAAGGAACGCGGU,18,15,13,8,54
4319,23,AACY022977491.1/127-179,AUCGUUCAACCUUUGUAAAGGUCGGAAGUAAGCUACAGCUGAAGGAACGCGUA,17,12,14,10,53
4320,23,AACY024072980.1/170-229,AUCGUUCAUCUUAUUGAUUAAGUGAGACGGAAGUAGGUUAGGGAACCGAAGGAACGCUGU,18,16,18,8,60
4321,23,AACY020596620.1/143-197,AUCGUUCAAUUUGCAGCUUGCAAAUCGGAAGUAGGUAUACCCGAAGGAACGCGGA,17,12,15,11,55
4322,23,AACY023593735.1/2-55,AUCGUUCAUCUGUUUAGACAGAUCGGAAGUAGGAUAAUACCGAAGGAACGCGGA,18,12,15,9,54
4323,23,AACY023136147.1/412-467,AUCGUUCAUUUUGAAUAAUUCAAAACGGAAGUAGACGAAAGUUGAAGGAACGCAUG,22,14,13,7,56
4324,23,AACY020376888.1/119-175,UUCGUUCAUUUUGAUUAAUUUCAAGACGGAAGUAGACAUAUGUCGAAGGAACGCGUG,17,18,14,8,57
4325,23,AACY020411127.1/1629-1524,GUCGUUUAUCUCAUAAAUAUCUUCUAGUAUCUCCUUAUGGCGCAUAGCAAUAAUUGGUUCAAAACCAUUGUGAGACGCAAGUAAGCGGAAGCUGAAGAAACGGAGU,34,30,23,19,106
4326,23,AACY020428281.1/2388-2331,AUCGUUCAUUCACUUAAUUGUGGACGGAAGUAAGUGUAGUACGCUGAAGGAACGCAUC,17,16,15,10,58
4327,23,AACY023653930.1/113-164,AUCGUUCAACUCAAUUGAGUCGGAAGUAGGCAUUAUGCCGAAGGAACGCAUG,16,12,14,10,52
4328,23,AACY020032680.1/219-166,AUCGUUCAUCCUUUCUUGGGACGGAAGUAGGUAAUAGUACUGAAGGAACGCAUC,15,15,14,10,54
4329,23,AACY020517659.1/1035-1087,AUCGUUCAUCUCGCAAGAGACGGAAGUAGGUAAUGAUACCGAAGGAACGCAUC,18,10,14,11,53
4330,23,AACY023736167.1/1122-1182,AUCGUUCAAUUUAAGAAUUUUUCUUAAAUCGGAAGUAAGUCAUUGACUGAAGGAACGCAUG,21,20,12,8,61
4331,23,AACY022295381.1/548-493,CACGUUCAUCACUCUUUUAGGGUGACGGAAGUAGACGAAAGUCGAAGGAACGCAUG,17,12,16,11,56
4332,23,AACY023245794.1/303-250,AUCGUUCAAUCCUUCUAAAGGAUCGGAAGUAGGGGUGACCUUAAGGAACGCGGA,16,12,16,10,54
4333,23,AACY020388886.1/849-901,AUCGUUCAACCUUUUUAAAGGUCGGAAGUAAGCUAAAGCUGAAGGAACGCGCA,18,12,13,10,53
4334,23,AACY021192611.1/379-425,AUCGUUCAUCCUAAAGGACGGAAGUAGGCUAGCCGAAGGAACGCACU,15,8,13,11,47
4335,23,AACY020209947.1/232-287,CACGUUCAUCACUCUUUUAGGGUGACGGAAGUAGACGAAAGUCGAAGGAACGCAUG,17,12,16,11,56
4336,23,AACY023594419.1/724-679,AUCGUUCAUCCCAAUGGGACGCAAGUAAGCCGACUCGGAACGGAUU,13,9,12,12,46
4337,23,AACY021278176.1/444-507,CUCGUUCAUUCACUCUAAAUGUAGCAGUGAACGGAAGUAGGAAAUUAAUCCGAAGGAACGCAUC,22,15,14,13,64
4338,23,AACY022138270.1/399-345,AUCGUUCAAUCUGUUUAUGCAGAUCGGAAGUAGGUUAAUACUGAAGGAACGCGGA,17,15,15,8,55
4339,23,AACY023219984.1/1151-1101,AUCGUUCAUCCCUGUGGGGACGGAAGUAGUCGCAAGACGAAGGAACGCAUU,14,10,16,11,51
4340,23,AACY022169908.1/95-147,UACGUUCAUCCUCACUAGGACGGAAGUAGGCGAAAACGCUGAAGGAACGCACC,17,8,14,14,53
4341,23,AACY022069665.1/540-490,AUCGUUCAACUCUUCGGAGUCGGAAGUAAGCGAAAGCUGAAGGAACGCGCU,15,10,15,11,51
4342,23,AACY021885836.1/381-330,UUCGUUCAUCUAUCUAGACGGAAGUAGAGCUUUUAGCUUGAAGGAACGCAUU,14,17,12,9,52
4343,23,AACY020074155.1/1646-1593,UACGUUCAUCAUGUUUAUCAUGACGGAAGUAGGUGAAAGCCGAAGGAACGCAUG,17,13,15,9,54
4344,23,AACY020329574.1/151-203,AUCGUUCAUCUUCGAAAGAAGACGGAAGUAGGUGAAAGCUGAAGGAACGCGAC,19,9,16,9,53
4345,23,AACY020557063.1/1854-1800,CACGUUCAUCACUCUUAGGAGUGACGGAAGUAGACGAAAGUCGAAGGAACGCAUG,18,10,16,11,55
4346,23,AACY020332481.1/755-808,AUCGUUUAUCCUGAAACGGACGGAAGUAAACCACAAAGGUUGAAGAAACGCUCU,20,11,12,11,54
4347,23,AACY023484401.1/885-837,AACGUUCACCCGAAAGGGCGGAAGUAAGCAAUAGCUGAAGGAACGCACC,18,5,14,12,49
4348,23,AACY020039026.1/3602-3653,AUCGUUCAUCCCGCGAGGGGACGGAAGUAGUCGCAAGAUGAAGGAACGCAUU,15,9,17,11,52
4349,23,AACY023899502.1/1347-1399,AUCGUUCAUCUUCGAAAGAAGACGGAAGUAGGUGAAAACUGAAGGAACGCGAC,20,9,15,9,53
4350,23,AACY022839264.1/262-316,AUCGUUCAACUCAUAGUGAGUCGGAAGUAAGUACGUUGUACUGAAGGAACGCAUG,17,14,15,9,55
4351,23,AACY020555885.1/2520-2467,AUCGUUCAACUUCAAUACGAAGUCGGAAGUAAGCGAAAGCUGAAGGAACGCAAC,21,9,13,11,54
4352,23,AACY022167379.1/379-429,AACGUUCAUCCUUAAGGGGACGGAAGUAGUCGAAAGACGAAGGAACGCAUU,18,9,15,9,51
4353,23,AACY024061969.1/570-623,AACGUUCAUCUUUUGAUAUAAGACGGAAGUAGGUGAUAACCGAAGGAACGCAUU,19,14,13,8,54
4354,23,AACY021505351.1/797-748,ACGUUCAACCAUUAUGGUCGGAAGUAGGUUUGAAACCGAAGGAACGCAUC,16,11,13,10,50
4355,23,AACY023718955.1/359-412,AUCGUUCAAUCUGUUUUUACAGAUCGGAAGUAGGUAAUACCGAAGGAACGCGGA,17,14,14,9,54
4356,23,AANP01000006.1/217608-217533,AACGUUGAGCUUGAUGGGUGCUCCGCAUCUGUCGUUCAGCCGGAAGUAGCCCCUCCGCAAGGCGAAGCAACGCUCC,15,15,22,24,76
4357,23,AACY023216978.1/742-690,AUCGUUCAUCUCGAAAGAGACGGAAGUAGGUAAUGAUACCGAAGGAACGCAUC,19,10,14,10,53
4358,23,AACY022360960.1/703-755,AUCGUUCAUCUUCGAAAGAAGACGGAAGUAGGUGAAAACUGAAGGAACGCGAC,20,9,15,9,53
4359,23,AACY023367856.1/758-708,ACCGUUCAACUCUUCGGAGUCGGAAGUAAGCGAAAGCUGAAGGAACGCGCU,15,9,15,12,51
4360,23,AACY022515796.1/555-501,AUCGUUCAAUUUGCAGUUUGCAAAUCGGAAGUAGGUUAAACCGAAGGAACGCGGA,18,13,15,9,55
4361,23,AACY022849373.1/548-601,CACGUUCAUCAUGUUUUACAUGACGGAAGUAAGCGAAAGCUGAAGGAACGCAUG,18,12,14,10,54
4362,23,AACY020411502.1/323-380,AUCGUUCAUCUCAUUAAUUGAGUGAGACGGAAGUAGGUAAGAUCCGAAGGAACGCAGU,19,14,16,9,58
4363,23,AACY020907559.1/603-660,AUCGUUCAUCUCAUAAUUUGAGUGAGACGGAAGUAGGUAAAAGCCGAAGGAACGCAGU,20,13,16,9,58
4364,23,AACY020016584.1/1235-1297,UACGUUCAUCUCAACACAUAGUUGGGACGCAAGUAAGCAAUAACAGUGCUGAAGGAACGGGAA,23,12,16,12,63
4365,23,AACY023581058.1/868-927,AUCGUUCAAUUUAAGAGUUUUCUUAAAUCGGAAGUAAGUCAUUGACUGAAGGAACGCAUG,20,19,13,8,60
4366,23,AACY020389322.1/915-772,AUCGUUCAUCUUAUUUUAUUAAAUAAGACGGAAGUAGGAAGAUAGGAAAACCUCUUUCUUUUUUAAAGAAAGGCUAGCAAGUACCGCUUGGGUUAAUUUAUCUUAGGCGGGAACGAGACCGAAUAUCUGCCGAAGGAACGCGUU,46,42,33,23,144
4367,23,AACY022625265.1/442-388,UACGUUCAGCCGAGAGGCCGGAAGUAGACUUCAUUAUUAGUCGAAGGAACGCAUU,16,13,15,11,55
4368,23,AACY020233904.1/1301-1249,AUCGUUCAACUCAUUUUGAGUCGGAAGUAGGCAUUGUGCUGAAGGAACGCAUG,14,15,15,9,53
4369,23,AACY022352167.1/319-188,AUCGUUCAUUCAGUGCCCUUUUUUAGUGCAUUGAACGGAAGUAGGAAAACCUGAAAACCUCUAUCUGAAAAGAUAGGUAAGCAAGUACCCGUAAGGAGAACGAGACCGAAAGUUUUACCGAAGGAACGCGUU,45,31,31,25,132
4370,23,AACY023969055.1/699-750,CACGUUCAUCCACUUAGGACGGAAGUAGACUACUCAGUCGAAGGAACGCAUU,16,11,12,13,52
4371,23,AACY022167379.1/433-485,AUCGUUCAUCUCGAAAGAGACGGAAGUAGGUAAUGAUACCGAAGGAACGCAUC,19,10,14,10,53
4372,23,CP001344.1/1229538-1229443,AUCGUUCAUCUCUCUAGCAACUUACCUCUGUACUUACCUCUGUAUAGUUAGGCAUCUGGAGAGACGGAAGUAGGGGUUUCCCCGAAGGAACGCGCC,22,26,23,25,96
4373,23,AACY020229567.1/124-51,AUCGUUGGGCUCGGGCCUGCUCUUACAGACCUCUUCAGCCGGAAGUAGCCACCCGCGUGGCGAAGCAACGCUCC,13,14,21,26,74
4374,23,AACY022834373.1/568-624,UACGUUCAUCUCAACACAUUUGAGACGCAAGUAGGGCUGAGCCUGAAGGAACGGGAA,18,11,16,12,57
4375,23,AACY020411740.1/25-75,ACCGUUCAACUCUUCGGAGUCGGAAGUAAGCGAAAGCUGAAGGAACGCGCU,15,9,15,12,51
4376,23,AACY023199264.1/943-993,GACGUUCAUCCAACAGGACGGAAGUAGACUACUCAGUCGAAGGAACGCAUU,17,9,13,12,51
4377,23,AACY020035461.1/1291-1345,AUCGUUCAUCCUUUUCUUGGGACGGAAGUAAGUAAUAAUACUGAAGGAACGCAUC,17,16,12,10,55
4378,23,AACY023257588.1/1100-1154,AUCGUUCAUCCUUUUCUUGGGACGGAAGUAGGUAAUAAUACUGAAGGAACGCAUC,16,16,13,10,55
4379,23,AACY024036082.1/568-622,AUCGUUCAAUUUGCCUUAGGCAAAUCGGAAGUAGGUUAAACCGAAGGAACGCGGA,18,12,15,10,55
4380,23,AACY020363512.1/1217-1271,AUCGUUCAACUCAUUGUGAGUCGGAAGUAGGUACAUUGUGCUGAAGGAACGCAUG,15,15,16,9,55
4381,23,AACY020376888.1/188-242,AUCGUUCAAUCUGUAUUAAACAGAUCGGAAGUAGGGAAAACCGAAGGAACGCGGA,21,10,15,9,55
4382,23,AACY020529410.1/5650-5725,AACGUUGAGCUUGACAGGUGUUCCGCAUCUGUCGUUCAGCCGGAAGUAGCCCCUCCGCAAGGCGAAGCAACGCUCC,16,15,21,24,76
4383,23,AACY023101112.1/405-460,UACGUUCAUCAUGUUUUUAACAUGACGGAAGUAGGCGAAAGCCGAAGGAACGCAUG,18,13,15,10,56
4384,23,AACY023868432.1/151-206,AUCGUUCAUUUUGAAUAAUUCAAAACGGAAGUAAACGAAAGUUGAAGGAACGCAUG,23,14,12,7,56
4385,23,AACY020562190.1/8543-8595,AUCGUUCAUCUUCGAAAGAAGACGGAAGUAAGCGAAAGCUGAAGGAACGCGGC,19,8,16,10,53
4386,23,AACY022499355.1/249-198,AUCGUUCAACUCUUUUAGAGUCGGAAGUAAGCGAAAGCUGAAGGAACGCAAC,18,11,13,10,52
4387,23,AACY020188747.1/1165-1120,AUCGUUCAUCCCAAUGGGACGCAAGUAAGCCGACUCGGAACGGAUU,13,9,12,12,46
4388,23,AACY020123372.1/2041-2093,UUCGUUCAUCCCGAAAGGGACGGAAGUAGGUGAUAAUACCGAAGGAACGCAUC,17,10,15,11,53
4389,23,AACY020471289.1/1134-1183,AUCGUUCAUCCCAAAAGGACGGAAGUAGGCAUUAGCCGAAGGAACGCACC,17,7,13,13,50
4390,23,AACY020324288.1/1229-1175,AUCGUUCAUCCUUACUUGUAAGGACGGAAGUAGACGAAAGUUGAAGGAACGCGCC,17,12,15,11,55
4391,23,AACY022240520.1/721-773,AUCGUUCAUCUCGAAAGAGACGGAAGUAGGUAAUGAUACUGAAGGAACGCGUU,18,12,15,8,53
4392,23,AACY020912192.1/748-800,AUCGUUCAACUCUUUUAGAGUCGGAAGUAGGCAUUGUGCUGAAGGAACGCAUG,14,15,15,9,53
4393,23,AACY022161803.1/756-812,AUCGUUCAUCUUUAUGUAAAUAAAGACGGAAGUAGACGAAAGUUGAAGGAACGCGCC,21,13,14,9,57
4394,23,AACY020147734.1/1525-1476,AUCGUUCAUCCAUUACGGACGGAAGUAGGCACCAGCUGAAGGAACGCGCU,14,9,14,13,50
4395,23,AACY023668649.1/502-562,AUCGUUCAAUUUAAUCAUUUGGUUAAAUCGGAAGUAGAUCUUUUGAUCGAAGGAACGCAUG,19,21,13,8,61
4396,23,AACY023638748.1/548-601,AUCGUUCAACUUCAAUACGAAGUCGGAAGUAAGCGAAAGCUGAAGGAACGCAAC,21,9,13,11,54
4397,23,AACY023207139.1/1222-1275,UACGUUCAUCCUACAGUGUAGGACGGAAGUAGACGUAAGUCGAAGGAACGCACC,17,10,15,12,54
4398,23,AACY023523806.1/411-541,AUCGUUCAUUCAGUGCCCUUUUUUAGUGCAUUGAACGGAAGUAGGAAAACCUGAAAACCUCUAUCUGAAAAGAUAGGCAAGCAAGUACCUGUAAGGGGAACGAGACCGAAAGUUUACCGAAGGAACGCGUU,44,30,32,25,131
4399,23,AACY020494819.1/354-304,AUCGUUCAACCAUUAUGGUCGGAAGUAGGUUUGAAACCGAAGGAACGCAUC,16,12,13,10,51
4400,23,BA000039.2/1753204-1753120,AUCGUUCAUCUUCGCUAGAGCGCACCUGAAAACUUGGGUGAGCAGCGAAGACGGAAGUAGGGCAGUUGUCCCGAAGGAACGCGCC,22,15,27,21,85
4401,23,AACY020158276.1/1001-941,AUCGUUCAUCCUUAUUUUUGGGGACGGAAGUAGGUAAAAAAUCAAACCGAAGGAACGCAUC,21,15,14,11,61
4402,23,AACY023719768.1/8-61,AUCGUUCAAUCUGCACAAGCAGAUCGGAAGUAGGUUAAACCGAAGGAACGCGGA,19,9,15,11,54
4403,23,AACY022714989.1/200-142,AUCGUUCAUCCUUGUUUGGGGACGGAAGUAGGUAAAAAAUCAAACCGAAGGAACGCAUC,20,13,15,11,59
4404,23,AACY021843513.1/630-685,UACGUUCAUCACUCUUUUAGGGUGACGGAAGUAGACGUAAGUCGAAGGAACGCAUG,16,14,16,10,56
4405,23,AACY022251786.1/814-760,AUCGUUCAAUCUGUUUAUGCAGAUCGGAAGUAGGUUAAUACUGAAGGAACGCGGA,17,15,15,8,55
4406,23,AACY022623996.1/664-617,AACGUUCAGGCGUCAAGCCCGGAAGUAGCAUUAGCGAAGGAACGCACU,15,7,14,12,48
4407,23,AACY020630404.1/110-50,AUCGUUCAAUUUAAGAAUUUUCUUAAAUCGGAAGUAGGUCAUUUGACUGAAGGAACGCAUG,20,20,13,8,61
4408,23,AACY021251278.1/383-440,AUCGUUCAAUCUAUUUUCUAAUAGAUCGGAAGUAAGCAACAAGCUGAAGGAACGCAGU,21,15,12,10,58
4409,23,AACY020400000.1/777-827,AUCGUUCAACUCUUCGGAGUCGGAAGUAAGCGAAAGCUGAAGGAACGCGCA,16,9,15,11,51
4410,23,AACY020400000.1/829-879,AUCGUUCAUCUCUUAGGAGACGGAAGUAGGUUAAAACCGAAGGAACGCGCC,16,10,14,11,51
4411,23,AACY023461508.1/164-216,UUCGUUCAUCCCGAAAGGGACGGAAGUAGGUGAUCAUACCGAAGGAACGCAUC,16,10,15,12,53
4412,23,AACY020479336.1/53-3,AACGUUCAUCCCUUUAGGGACGGAAGUAGACUAAUGUCGAAGGAACGCAUG,16,11,14,10,51
4413,23,AACY021669684.1/575-629,AUCGUUCAAUCUACAUUGUAGAUCGGAAGUAAGUUUAAAACUGAAGGAACGCGCA,20,14,12,9,55
4414,23,AACY020570891.1/242-187,UACGUUCAUCACUCUUUUAGGGUGACGGAAGUAGACGAAAGUCGAAGGAACGCAUG,17,13,16,10,56
4415,23,AACY022668466.1/322-377,CACGUUCAUCACCCUUUUAGGUUGACGGAAGUAGACGAAAGUCGAAGGAACGCAUG,17,12,15,12,56
4416,23,AACY021539475.1/694-640,AUCGUUCAUCCUUUUCUUGGGACGGAAGUAGGUAAUAAUACUGAAGGAACGCAUC,16,16,13,10,55
4417,23,AACY020557063.1/1787-1732,AUCGUUCAAUCUGAAUUAAUUCAGAUCGGAAGUAGGUAAAACCGAAGGAACGCGGA,21,12,14,9,56
4418,23,AACY020977974.1/529-472,UGCGUUGAUCCCGGAAUGGGACGCAAGUAGGCCACAUUUGGGGCCGAAGCAACGGAAA,16,9,20,13,58
4419,23,AACY021920004.1/423-483,AUCGUUCAAUUUAAAUGGAAACAUUUAGAUCGGAAGUAGACAAUUGUCGAAGGAACGCAUG,23,16,14,8,61
4420,23,AACY024085939.1/785-838,AUCGUUCAAUCUGUUAAAGCAGAUCGGAAGUAGGUUAAACCGAAGGAACGCGGA,19,11,15,9,54
4421,23,AACY020192141.1/120-65,CACGUUCAUCACCUUUACAGGGUGACGGAAGUAGACGAAAGUCGAAGGAACGCAUG,18,10,16,12,56
4422,23,AACY020066766.1/2107-2054,AUCGUUCAUCUCGAAAGAGACGGAAGUAGGUAAUGGUUACCGAAGGAACGCACC,18,10,15,11,54
4423,23,AACY020570891.1/175-121,AUCGUUCAAUUUGCCAUAGGCAAAUCGGAAGUAGGUUAAACCGAAGGAACGCGGA,19,11,15,10,55
4424,23,AACY023980157.1/761-710,AACGUUCAUCUUUUUUUAAAAGACGGAAGUAGCGAAAGCGAAGGAACGCACC,19,11,12,10,52
4425,23,AACY020803240.1/308-256,AUCGUUCAACUCAAUAGAGUCGGAAGUACCCAUCAUAGGGGAAGGAACGCACU,18,10,13,12,53
4426,23,AACY021286276.1/327-277,CUCGUUCAUCCCGCAAGGGACGGAAGUAGGCUAAGGCUGAAGGAACGUACC,14,8,16,13,51
4427,23,AACY020494598.1/250-300,AACGUUCAACCAUUAUGGUCGGAAGUAGGUUUGAAACCGAAGGAACGCGUC,16,11,14,10,51
4428,23,AACY021876887.1/486-432,CACGUUCAUCACUCAUUUGAGUGACGGAAGUAGACGCAAGUCGAAGGAACGCAUG,17,11,15,12,55
4429,23,CP002198.1/3653058-3653002,AUCGUUCAUCUCUGGAAUCAGAGACGGAAGUAGGGAAACCUCCCGAAGGAACGCGCC,17,9,16,15,57
4430,23,CP002198.1/1274053-1274110,AUCGUUCAUCUCUUUAUACCAGAGACGGAAGUAGGGAAAGUUCCCGAAGGAACGCGCC,17,12,15,14,58
4431,24,URS0000D67501_349102/1-58,CAGGAGUCCGGGUGCAAAUCCCGGAUGGCGAGCCCGGCCGCUGACCUGCCGGGGUAAC,10,7,22,19,58
4432,24,URS0000D69992_311402/1-53,AUCGGACUCGUUUUGACGAGUGGCUUCUCCGGGCGCCUAUCCCCCGGCCACAG,7,12,15,19,53
4433,24,URS0000D65DBF_314231/1-56,CAUGGACCCGCAUCUUCCGCGGGUGGCUAUGCCGGGCGCCUAUCCCCCGGCCCAUC,6,10,16,24,56
4434,24,URS0000D65E95_287752/1-53,CAUGGACCUGCCUUGGCAGGUGGCUAUGCCGGGCGCCUAUCCCUCGGCCAAUC,7,11,16,19,53
4435,24,URS0000D67A0B_272630/1-53,GUCGGACCCGGUUUUUCGGGUGGCUCGGCCCGGCGCCAAUCCCCGGGACAACC,6,9,18,20,53
4436,24,URS0000D6A087_317655/1-53,ACCGGACCCGGCUCGCCGGGUGGCUCGGCCCGGCGCCUAUCCCCGGGACAACC,6,5,18,24,53
4437,24,URS0000D6ADE4_392499/1-54,GUCGGACCCGGCCGUGCCGGGUGGCUCGGCCCGGCGCCUAUCCCCGGGACAACC,5,6,20,23,54
4438,24,URS0000D69889_323097/1-58,GUCGGACCCGAGGUGUUGUUUCGGGUGGCUCCGCCGGGCGCCUAUCCCCCGGAAACUC,6,12,20,20,58
4439,24,URS0000D68B3E_12908/1-54,AAUGGACCCGGCUGGACCGGGUGGCUAUCCUGGGCGCCGAUCCCUCAGGGACAC,9,8,19,18,54
4440,24,URS0000D68F94_12908/1-62,CUUGGACUCGGCGCCCCUGGGCUGCCGGGUGGCUAUCCCGUCCGCCGAUCCGUCGGGAAACU,6,12,21,23,62
4441,24,URS0000D6AA31_12908/1-64,CCUGGACCCGCGCCCCUGAGGGGCUUGCGGGUGGCUAUUCCGGCCGCCGAUCCGCCGGAGCAAU,7,10,23,24,64
4442,24,URS0000D6A6E8_12908/1-57,CUUGGAUCCCGGUUUCAUCCCGGGUGGCUAUUCCGGCCGCCAAUCCGCCGGAGCGAC,7,12,17,21,57
4443,24,URS0000D68922_12908/1-64,CUUGGACCCGGCCCUGUUCGCAGGCGACGGGUGGCUAUCCCCGCCGCCGAUCCGCUGGGAAACU,8,11,21,24,64
4444,24,URS0000D6C851_12908/1-64,CUUGGACCCGGCCCUGUUCGCAGGCGACGGGUGGCUAUCCCCGCCGCCGAUCCGCUGGGAAACC,8,10,21,25,64
4445,24,URS0000D6A92C_391600/1-62,CUUGGACCCGGCCUGUUUGAAGCGUCGGGUGGCUAUCCCGGCCGCCGAUCCGCCGGGAAACC,8,11,21,22,62
4446,24,URS0000D69540_314232/1-57,CAUGGACCUGGGGGUGACCUCGGGUGGCUCUUCCGGCCGCCUAUCCGCCGGACAACC,7,10,19,21,57
4447,24,URS0000D66603_314264/1-59,CAUGGACCCCGGGUGCAAGCCCCGGGUGGCUCUUCCGGCCGCCUAUCCGCCGGAUCAUU,7,11,18,23,59
4448,24,URS0000D6A4D5_12908/1-56,CAAGGACCCGGUGAGAUUCCGGGUGGCUAUCCCGGCCGCCAAUCCGCCGGGGAAAC,11,7,19,19,56
4449,24,URS0000D6905C_12908/1-57,CCUGGACCCGGCAGCGAUCCCGGAUGGCGCUUCCGGCCCCCGAUCCGCCGGACAACG,8,6,18,25,57
4450,24,URS0000D6C820_395963/1-56,UUUGGACCCGGUGUAAUUCCGGGUGGCUCUUCCGGCCGCCAAUCCGCCGGAUAACG,8,13,17,18,56
4451,24,URS0000D67E63_272630/1-56,GCCGGACCAGGUGAAAGCCCGGGUGGCUCUUCCGGCCGCCGAUCCGCCGGAUAACG,9,7,20,20,56
4452,24,URS0000D695E0_266779/1-56,ACUGGACCCGGUGAAACUCCGGGUGGCUCUUCCGGCCGCCGACCCGCCGGACAACA,10,7,17,22,56
4453,24,URS0000D69AA8_426355/1-56,CAAGGACCCGGUGAAAGCCCGGGUGGCUCUUCCGGCCGCCGAUCCGCCGGACCACG,9,6,19,22,56
4454,24,URS0000D6BDD8_272630/1-56,ACAGGACCCGGUGAAACCCCGGGUGGCUCUUCCGGCCGCCGAUCCGCCGGACCACG,9,6,18,23,56
4455,24,URS0000D6A5F8_441620/1-56,CCUGGACCCGGUGCAAGCCCGGGUGGCUCUUCCGGCCGCCGAUCCGCCGGAUCACG,6,8,19,23,56
4456,24,URS0000D6B3BE_272630/1-56,CUCGGACCCGGUGCAAGCCCGGGUGGCUCUUCCGGCCGCCGAUCCGCCGGACCACG,6,7,19,24,56
4457,24,URS0000D6B3BE_419610/1-56,CUCGGACCCGGUGCAAGCCCGGGUGGCUCUUCCGGCCGCCGAUCCGCCGGACCACG,6,7,19,24,56
4458,24,URS0000D6B3BE_440085/1-56,CUCGGACCCGGUGCAAGCCCGGGUGGCUCUUCCGGCCGCCGAUCCGCCGGACCACG,6,7,19,24,56
4459,24,URS0000D6B3BE_272627/1-56,CUCGGACCCGGUGCAAGCCCGGGUGGCUCUUCCGGCCGCCGAUCCGCCGGACCACG,6,7,19,24,56
4460,24,URS0000D699E6_311402/1-56,CACGGACCCGGUGAAAUUCCGGGUGGCUAUUCUGGCCGCCAAUCCGCCAGACAACG,12,9,16,19,56
4461,24,URS0000D67E30_641118/1-56,CAAGGACCCGGUGAAAGCCCGGGUGGCUCUUCUGGCCGCCUAUCCGCCAGACAACG,11,8,17,20,56
4462,24,URS0000D697B5_311403/1-56,CACGGACCCGGUGAAACUCCGGGUGGCUCUUCUGGCCGCCGAUCCGCCAGAUAACG,10,9,17,20,56
4463,24,URS0000D6610A_395492/1-56,CACGGACCCGGUGAGACCCCGGGUGGCUCUUCUGGCCGCCGAUCCGCCAGACAACG,9,7,18,22,56
4464,24,URS0000D6AE26_176299/1-56,CACGGACCCGGUGAAAUCCCGGGUGGCUCUUCUGGCCGCCGAUCCGCCAGACAACG,10,8,17,21,56
4465,24,URS0000D6BBCD_216596/1-56,CACGGACCCGGUGAGAUCCCGGGUGGCUCUUCUGGCCGCCGAUCCGCCAGACAACG,9,8,18,21,56
4466,24,URS0000D6BBCD_395491/1-56,CACGGACCCGGUGAGAUCCCGGGUGGCUCUUCUGGCCGCCGAUCCGCCAGACAACG,9,8,18,21,56
4467,24,URS0000D6C141_366394/1-56,CCCGGACCCGGUGAAACCCCGGGUGGCUCUUCUGGCCGCCGAUCCGCCAGACAACG,9,7,17,23,56
4468,24,URS0000D672AF_266834/1-56,CCUGGACCCGGUGUAACUCCGGGUGGCUCUUCUGGCCGCCGAUCCGCCAGACAACG,8,10,17,21,56
4469,24,URS0000D6C9FE_12908/1-56,CAAGGACCCGGUGUGAUUCCGGGUGGCUCUUCCGGCCGCUGAUCCGCCGGACCACG,7,10,19,20,56
4470,24,URS0000D6C9FE_349101/1-56,CAAGGACCCGGUGUGAUUCCGGGUGGCUCUUCCGGCCGCUGAUCCGCCGGACCACG,7,10,19,20,56
4471,24,URS0000D6C9FE_557760/1-56,CAAGGACCCGGUGUGAUUCCGGGUGGCUCUUCCGGCCGCUGAUCCGCCGGACCACG,7,10,19,20,56
4472,24,URS0000D682E5_318586/1-58,CAAGGACUCGGGUGCGAUUCCCGGGUGGCUCUUCCGGCCGCCGAUCCGCCGGACCAUU,7,11,19,21,58
4473,24,URS0000D68A15_349102/1-56,CUUGGACCCGGUGCGAUCCCGGGUGGCUAUUCCGGCCGCUGAUCCGCCGGACAACG,7,10,19,20,56
4474,24,URS0000D67D60_279238/1-56,CAAGGACCCGGUGAAAUUCCGGGUGGCUAUUCCGGCCGCCGAUCCGCCGGACAACA,12,8,17,19,56
4475,24,URS0000D6D0CE_314266/1-56,CAUGGACCCGGUGCAAUUCCGGGUGGCUAUUCCGGCCGCCGAUCCGCCGGACAACA,10,9,17,20,56
4476,24,URS0000D6C901_351016/1-58,CAUGGAGCCGGGUGCGAUCCCCGGCUGGCUCUUCCGGCCGCCGAUCCGCCGGACAACA,8,8,19,23,58
4477,24,URS0000D69BEC_318586/1-58,CAUGGAGCCGGGUGCAACUCCCGGCUGGCUGUUCCGGCCGCCGAUCCGCCGGACAACC,8,8,19,23,58
4478,24,URS0000D6D026_272943/1-58,UCAGGACCCGGGUGCGAUCCCCGGGUGGCUCCUCCGGCCGCCGAUCCGCCGGACAACC,7,7,19,25,58
4479,24,URS0000D6D026_349101/1-58,UCAGGACCCGGGUGCGAUCCCCGGGUGGCUCCUCCGGCCGCCGAUCCGCCGGACAACC,7,7,19,25,58
4480,24,URS0000D6D026_349102/1-58,UCAGGACCCGGGUGCGAUCCCCGGGUGGCUCCUCCGGCCGCCGAUCCGCCGGACAACC,7,7,19,25,58
4481,24,URS0000D6D026_557760/1-58,UCAGGACCCGGGUGCGAUCCCCGGGUGGCUCCUCCGGCCGCCGAUCCGCCGGACAACC,7,7,19,25,58
4482,24,URS0000D67C2B_12908/1-58,UCAGGACCCGGGUGCGAUCCCCGGGUGGCUCCUCCGGCCGCCGAUCCGCCGGACCACC,6,7,19,26,58
4483,24,URS0000D6C964_391613/1-59,CAUGGAUUUCGGGUGCAAUCCCCGGAUGGCUCUUCCGGCCGCCUAUCCGCCGGAUCAUC,8,14,16,21,59
4484,24,URS0000D68C64_742159/1-53,AUUGGACCCGGCUUGCCGGGUGGCUCGGCCGGGCGCCUAUCCCUCGGACAACU,6,10,18,19,53
4485,25,URS0000D6A678_12908/1-54,GGGUCUUGGGGGGCGUCCCCAAGAGGAUUGUUCUGAUGGCCGGGCCGCCAUCUG,6,12,22,14,54
4486,25,URS0000D6C6DE_12908/1-59,GGGUAUUUGUCUAGCAUGGGGCUAGGUAAAUAGGUAACGUACAGGUCGGGCCGCCUGUG,12,15,22,10,59
4487,25,URS0000D68A55_12908/1-60,GGGUGUCUAAAUCUAUUUGACUCGAUUUAGACAGGUAUUAGUGUCGGUCGGGCCGCCGCA,12,18,18,12,60
4488,25,URS0000D65FE3_12908/1-53,GGGUGGGAGGCAGUUGUUGCCUCUCAGGAUUUCAAGUGGUCGGGCCGCCACCU,7,13,20,13,53
4489,25,URS0000D67290_12908/1-54,GGGUGUCCGGCGAUGCCUGCCGGGCAGGGAAUUGGGGUAGCCGGGCCGCUGCCU,5,9,25,15,54
4490,25,URS0000D6590B_452637/1-51,GGGUUCGAAGCAGGCGCUUCGGAGGCAAUUGAAACAGUCGGGCCGCUGUUU,10,11,19,11,51
4491,25,URS0000D6AD8D_1217694/1-51,GGGUGUCUAGUUGAACUUAGGCAGGUGUUUGUUGUAGUCGGGCCGCUACAA,9,16,18,8,51
4492,25,URS0000D698CD_575588/1-51,GGGUGUCUAGCUGAGCUAAGGCAGGUAUUUGUUGUAGUCGGGCCGCUAUAA,10,15,18,8,51
4493,25,URS0000D698CD_1144674/1-51,GGGUGUCUAGCUGAGCUAAGGCAGGUAUUUGUUGUAGUCGGGCCGCUAUAA,10,15,18,8,51
4494,25,URS0000D698CD_12908/1-51,GGGUGUCUAGCUGAGCUAAGGCAGGUAUUUGUUGUAGUCGGGCCGCUAUAA,10,15,18,8,51
4495,25,URS0000D698CD_1144665/1-51,GGGUGUCUAGCUGAGCUAAGGCAGGUAUUUGUUGUAGUCGGGCCGCUAUAA,10,15,18,8,51
4496,25,URS0000D66DA9_12908/1-51,GGGUGUCCAGCUAAGCUGAGACAGGUGUUUGUUGUAGUCGGGCCGCUACAA,10,13,18,10,51
4497,25,URS0000D6848C_1120927/1-51,GGGUGUCUAGCUAGGCUAAGACAGGUGUUUGUUGUAGUCGGGCCGCUACAA,10,14,18,9,51
4498,25,URS0000D6C158_1116233/1-51,GGGUGCCUAGCUCAGCUAAGGCAGGUGUUUGUUGUAGUCGGGCCGCUACAA,9,13,18,11,51
4499,25,URS0000D6C158_525242/1-51,GGGUGCCUAGCUCAGCUAAGGCAGGUGUUUGUUGUAGUCGGGCCGCUACAA,9,13,18,11,51
4500,25,URS0000D6C158_903898/1-51,GGGUGCCUAGCUCAGCUAAGGCAGGUGUUUGUUGUAGUCGGGCCGCUACAA,9,13,18,11,51
4501,25,URS0000D6B18E_575588/1-51,GGGUGUCUAGCUAAGCUAAGGCAGGUGUUAGUUGUAGUCGGGCCGCUACAA,11,13,18,9,51
4502,25,URS0000D6D1EA_1217988/1-51,GGGUGUCUAGCUAAGCUAAGGCAGGUGUGUGUUGUAGUCGGGCCGCUACAA,10,13,19,9,51
4503,25,URS0000D6D1EA_1173062/1-51,GGGUGUCUAGCUAAGCUAAGGCAGGUGUGUGUUGUAGUCGGGCCGCUACAA,10,13,19,9,51
4504,25,URS0000D6D1EA_1221311/1-51,GGGUGUCUAGCUAAGCUAAGGCAGGUGUGUGUUGUAGUCGGGCCGCUACAA,10,13,19,9,51
4505,25,URS0000D68FF7_400667/1-51,GGGUGUCUAGCGUAGCUAAGACAGGUAUUCGUUAUAGUCGGGCCGCUAUAA,12,14,16,9,51
4506,25,URS0000D68FF7_903937/1-51,GGGUGUCUAGCGUAGCUAAGACAGGUAUUCGUUAUAGUCGGGCCGCUAUAA,12,14,16,9,51
4507,25,URS0000D68FF7_1144671/1-51,GGGUGUCUAGCGUAGCUAAGACAGGUAUUCGUUAUAGUCGGGCCGCUAUAA,12,14,16,9,51
4508,25,URS0000D68FF7_1144670/1-51,GGGUGUCUAGCGUAGCUAAGACAGGUAUUCGUUAUAGUCGGGCCGCUAUAA,12,14,16,9,51
4509,25,URS0000D68FF7_1209355/1-51,GGGUGUCUAGCGUAGCUAAGACAGGUAUUCGUUAUAGUCGGGCCGCUAUAA,12,14,16,9,51
4510,25,URS0000D68FF7_12908/1-51,GGGUGUCUAGCGUAGCUAAGACAGGUAUUCGUUAUAGUCGGGCCGCUAUAA,12,14,16,9,51
4511,25,URS0000D68FF7_981327/1-51,GGGUGUCUAGCGUAGCUAAGACAGGUAUUCGUUAUAGUCGGGCCGCUAUAA,12,14,16,9,51
4512,25,URS0000D68FF7_596318/1-51,GGGUGUCUAGCGUAGCUAAGACAGGUAUUCGUUAUAGUCGGGCCGCUAUAA,12,14,16,9,51
4513,25,URS0000D68FF7_1120929/1-51,GGGUGUCUAGCGUAGCUAAGACAGGUAUUCGUUAUAGUCGGGCCGCUAUAA,12,14,16,9,51
4514,25,URS0000D68181_12908/1-63,GGGUUUCAGCUUUACCGCCCUGGUGAAGCUGGGAGGUUCAGUGCAUUGGUCGGGCCGCCAAUG,9,16,23,15,63
4515,25,URS0000D65B44_643561/1-74,GGGUGCCCUUCCCGGUGCCGCGCCCCGCAGCGCCGGUGAAGAUGGCAGGUCGUCGCGCAGGUCGGGCCGCCGCG,6,9,31,28,74
4516,25,URS0000D6754A_12908/1-55,GGGUCCGCCGCCGAAUUGCUGCGGAGGUUCACACGGAAGGUCGGGCCGCCUGCCG,7,8,22,18,55
4517,25,URS0000D69952_12908/1-54,GGGUGUGACGGGUAACCCGGUCGGCAGGAUUCAGGGAUGGUCGGGCCGCCAUCU,8,10,23,13,54
4518,25,URS0000D668CB_12908/1-61,GGGUGUCGGGUCAACAUAGGGUUGAUCUAGGGCAGGUAAUUGUGUUGGUCGGGCCGCCACG,10,15,25,11,61
4519,25,URS0000D698C7_12908/1-53,GGGUGCGUGAUAAAUGUCAUCGCGCAGGAAUCGAGGUGGUCGGGCCGCCACCU,10,10,20,13,53
4520,25,URS0000D6977C_12908/1-65,GGGUCCAGAGAUAUGUCCUGUUAUUUCUGGAGGUUAAGAAGAUCGGAUAGUCGGGCCGCUAUCUG,14,19,21,11,65
4521,25,URS0000D68C75_404589/1-56,GGGUGUGACGGCCAAGUGGCCGCUCGCAGGCGAUCGGGAUGGUCGGGCCACCAUCC,8,8,23,17,56
4522,25,URS0000D6C667_577650/1-56,GGGUCCAGAAACAUUUCGCGUUUCUGGAGGUUUUCUUGUUAGCCGGGCCGCUAACC,9,17,16,14,56
4523,25,URS0000D6C667_12908/1-56,GGGUCCAGAAACAUUUCGCGUUUCUGGAGGUUUUCUUGUUAGCCGGGCCGCUAACC,9,17,16,14,56
4524,25,URS0000D6D419_12908/1-53,GGGUGCGGGAAGUGAUUUCCCGCAGGAGCAUCGGACGGUCGGGCCGCCGUUCG,7,9,23,14,53
4525,25,URS0000D676CF_12908/1-59,GGGUCCGCGGAUUUAUCGAGUCCGCGGAGGAGUUCUGCAAAUGGUCGGGCCGCCAUCUG,9,13,22,15,59
4526,25,URS0000D6823E_12908/1-59,GGGUGGGGAGGCAUGGUGCCGCCCCCAGGGUUCCCAAUCGGGUGGUCGGGCCGCCAUCC,6,9,25,19,59
4527,25,URS0000D6A9B5_12908/1-65,GGGUGUGACUUUUGCACAUGGCAUAGUUACAGGUUAAUUAAUCUUGAAUGGUCGGGCCGCCAUUC,14,21,18,12,65
4528,25,URS0000D6938A_12908/1-51,GGGUUCGGAAUAAUUUCCGAAGGGUUAACUGGAUGGUCGGGCCGCCAUUCG,10,13,18,10,51
4529,25,URS0000D66804_12908/1-52,GGGUCCGGGAUCAUUUUCCGGAGGGUGUUUAAGAUGGUCGGGCCGCCAUCCU,7,14,19,12,52
4530,25,URS0000D68D0C_483219/1-56,GGGUGUGCGUCGCGCUCCUGGCACGCACAGGUUCCUCGGUGGUCGGGCCGCCACCU,4,11,21,20,56
4531,25,URS0000D6A0EE_12908/1-52,GGGUUCGGGAAUCAGUUUCCCGGAGGCUAACGAGGUAGUCGGGCCGCUAUCU,9,12,19,12,52
4532,25,URS0000D6A1E2_12908/1-57,GGGUGUCGACGAAGCGUAAGCGCAGUCGACAGGAUCGGGUUGGUCGGGCCGCCAGCC,10,8,24,15,57
4533,25,URS0000D665B3_12908/1-49,GGGUGCAGCAAACUUGUUGCAGGAAUCUGAAAGGUCGGGCCGCCUUUUA,11,12,16,10,49
4534,25,URS0000D681F9_12908/1-49,GGGUGCCAUAUAAAAAUAUGGCAGGUAUGGUGAAGGCCGGGCCGCCUCA,13,9,17,10,49
4535,25,URS0000D6D34F_12908/1-49,GGGUGCCAUAUGAAAAUGUGGCAGGUAUGGUGAAGGCCGGGCCGCCUCA,11,9,19,10,49
4536,25,URS0000D68896_12908/1-49,GGGUGCCAUAUAAAAAUGUGGCAGGUAUGGUGAAGGCCGGGCCGCCUCA,12,9,18,10,49
4537,25,URS0000D69FE7_12908/1-55,GGGUUCAGGGAUAGACGUUAUCUUUGGAGGAUUUGGAUGGUCGGGCCGCCAUUCG,9,16,21,9,55
4538,25,URS0000D692EA_473781/1-55,GGGUGCUCGCCGAUCCCGGCAAGCAGGUUUCGCAGUGCCGGUCGGGCCGCCGGUG,5,9,23,18,55
4539,25,URS0000D6D434_12908/1-59,GGGUCUGGAGAUCUUUCUCCGGAGGUGCCAUUUUUUUAAGGUGGUCGGGCCGCCAUCUG,7,19,20,13,59
4540,25,URS0000D6AC05_12908/1-53,GGGUGCUGGACUAUCUAUGGUCCUGCAGGUUUUGAAUGGUCGGGCCGCCAUUU,7,17,18,11,53
4541,25,URS0000D68D2A_12908/1-52,GGGUGUGGUGCGCACCGUACCACAGGCUUAGGGGAAGGUCGGGCCGCCUUCC,7,9,21,15,52
4542,25,URS0000D659B1_12908/1-51,GGGUGUGCUACUUUCCGUAGCACAGGUUUUGGGCAGGUCGGGCCGCCUCCC,5,13,18,15,51
4543,25,URS0000D6AFFB_12908/1-63,GGGUGUGCCGCAGAAACCCCUGUCGCACAGGUUAUAAUAAAAAGGAUGGUCGGGCCGCCGUCC,15,11,20,17,63
4544,25,URS0000D65CB2_12908/1-52,GGGUGUGGUGCAGGGCGCGCUGCAGGCUUCAGGGAAGGUCGGGCCGCUUCCC,5,9,24,14,52
4545,25,URS0000D6CB1B_12908/1-56,GGGUGUCGGAUUCACGGUGAAUUCGUUAGGGUAACUGCGCAGGUCGGGCCGCCGCG,8,12,23,13,56
4546,25,URS0000D673C3_12908/1-54,GGGUUCGGAGAAGCGUCUCCGAAGGGGAACAGAGAGUUGGUCGGGCCGCCAUCU,11,9,22,12,54
4547,25,URS0000D6B77E_12908/1-55,GGGUGUCGUGCUCUUCCUUGCACGACAGGAUUCACGCGCAGGUCGGGCCGCCGCG,6,11,20,18,55
4548,25,URS0000D6B117_12908/1-53,GGGUGUGCCGGUCGUCACCGGCACAGGCAUAUUGGACGGUCGGGCCGCCGUCC,6,9,21,17,53
4549,25,URS0000D67E7F_12908/1-59,GGGUGCGUGCAUCGGACAGCGAUGCGGGCAGGAGAGUGACGCUGGUCGGGCCGCCAGUG,9,8,28,14,59
4550,25,URS0000D694F8_12908/1-53,GGGUUCAGAGACUAGUCUCUGGAGGAAUAUUGCAAGUUGGUCGGGCCGCCACU,11,13,18,11,53
4551,25,URS0000D69CD2_12908/1-53,GGGUUCAGAGAAUAUUCUCUGGAGGAAUAUUUAGCUGGUCGGGCCGCCAUCUG,11,15,17,10,53
4552,25,URS0000D6B26C_12908/1-54,GGGUUCAGAGAUUCCUUCUCUGGAGGAGUAAGUCAGAUGGCCGGGCCGCCACUG,10,12,19,13,54
4553,25,URS0000D66F51_1094558/1-55,GGGUGUUUGGCAAAUCCAUGUCAAACAGGCUUAUCAGUUGGUCGGGCCGCCAACU,12,14,16,13,55
4554,25,URS0000D68CE4_903818/1-49,GGGUGCGGUGGCAACGCCGCAGGUCUCCGGAAAGGUCGGGCCGCCUUUC,6,8,20,15,49
4555,25,URS0000D6A607_404589/1-60,GGGUGCGGCGCCGGCCGGAAGCCGGCGCCGCAGGCAUCCGGAGCAGUCGGGCCGCUGCUU,6,6,27,21,60
4556,25,URS0000D69063_12908/1-53,GGGUUCAGUUCGGUAGCCGAACUGGAGGUCUCUGGAUGGUCGGGCCGCCAUUC,7,13,20,13,53
4557,25,URS0000D66FD0_12908/1-49,GGGUGCAGCGCGCGCUGCAGGUCAUCGGGGAGGGUCGGGCCGCCCUCCU,4,7,22,16,49
4558,25,URS0000D6CE2B_12908/1-54,GGGUGCGGCGGGUCGUCCGCCGCAGGUCUCCACGGCUGGUCGGGCCGCCCGCCG,2,7,24,21,54
4559,25,URS0000D67299_12908/1-53,GUGUCCGGUAUAGAAAAACCGGAGGUUCAUACAGGAUGGUCGGGCCGCCAUCU,13,11,17,12,53
4560,25,URS0000D6BF92_12908/1-57,GGGUGCCAGGUCCCCGAAGGGAGCAGGCAGGGUUGAGCGUUGGUCGGGCCGCCAGCG,8,7,27,15,57
4561,25,URS0000D68F12_12908/1-60,GGGUUCAGAAAAGAUUACCUUUUCUGAAGGGUAAAUAGAACGAUAGUCGGGCCGCUAUCU,18,16,16,10,60
4562,25,URS0000D6623E_12908/1-60,GGGUUCAGAAAAGAUUAUCUUUUCUGAAGGGUAAAUAUAAUGAUAGUCGGGCCGCUAUCU,18,19,15,8,60
4563,25,URS0000D66C0D_12908/1-52,GGGUGUGACGGGUUGGCCGUCACAGGAAUCUGGAAUGGUCGGGCCGCCAUUC,8,11,21,12,52
4564,25,URS0000D65D93_12908/1-53,GGGUCCAGCCCAUUCCGGGGCUGGAGGUAAAGAAUAUGGUCGGGCCGCCAUAU,11,10,19,13,53
4565,25,URS0000D6D002_12908/1-60,GGGUGCACCGCUGCCGAAGGCGCAGCGGCGCAGGCUUGACGGGUGGUCGGGCCGCCAUCC,7,7,26,20,60
4566,25,URS0000D6BDC4_598467/1-61,GGGUGUCGGCUGUAUAGCGCAGUUAGGCAGGUUAUGAUUAUGCGUCGGUCGGGCCGCCACG,9,15,24,13,61
4567,25,URS0000D68299_12908/1-56,GGGUCCGGGGGUUGUGGGCCUCCGGAGGUCAGCGCGGGUGGUCGGGCCGCCACCCG,3,8,28,17,56
4568,25,URS0000D6BE4D_12908/1-55,GGGUCCGGGGCUAUGUAGCCCCGGAGGUCAACGCGGAUGGUCGGGCCGCCAUCCG,7,8,23,17,55
4569,25,URS0000D6BB9B_12908/1-55,GGGUUCGGGGUUGCGUAGCCUCGGAGGCAACUGCGGAUGGUCGGGCCGCCAUCCG,6,10,24,15,55
4570,25,URS0000D6C56F_12908/1-62,GGGUGCGUGACUGCAUAGGGCACAACGCAGGUUAAAGCAAAGCAUUGGUCGGGCCGCCAAUG,16,10,22,14,62
4571,25,URS0000D6B330_12908/1-61,GGGUGCGUCGCUGCAUAAGUACGGCGCAGGUUAAAGCCAAGCAUUGGUCGGGCCGCCAAUG,13,11,22,15,61
4572,25,URS0000D66E96_911240/1-63,GGGUGCGUUGUUGCAUAAAGCACGGCGCAGGUUAAAAGCCAAGCAUUGGUCGGGCCGCCAAUG,15,12,22,14,63
4573,25,URS0000D66E96_1037911/1-63,GGGUGCGUUGUUGCAUAAAGCACGGCGCAGGUUAAAAGCCAAGCAUUGGUCGGGCCGCCAAUG,15,12,22,14,63
4574,25,URS0000D66E96_911244/1-63,GGGUGCGUUGUUGCAUAAAGCACGGCGCAGGUUAAAAGCCAAGCAUUGGUCGGGCCGCCAAUG,15,12,22,14,63
4575,25,URS0000D6B90E_96901/1-63,GGGUGCGUUGCUGCAUAAGGCGCGGCGCAGGUUAAAAGCCAAGCAUUGGUCGGGCCGCCAAUG,13,11,24,15,63
4576,25,URS0000D68837_12908/1-63,GGGUGCGCUGCUGCAUACGGCACAGCGCAGGUUAAAGGAUAAUCAUUGGUCGGGCCGCCAAUG,14,12,22,15,63
4577,25,URS0000D6C794_1240676/1-63,GGGUGCGCUGCUGCAUACGGCACAGCGCAGGUUAAAGGAUAAGCAUUGGUCGGGCCGCCAAUG,14,11,23,15,63
4578,25,URS0000D6C794_12908/1-63,GGGUGCGCUGCUGCAUACGGCACAGCGCAGGUUAAAGGAUAAGCAUUGGUCGGGCCGCCAAUG,14,11,23,15,63
4579,25,URS0000D6C794_1197727/1-63,GGGUGCGCUGCUGCAUACGGCACAGCGCAGGUUAAAGGAUAAGCAUUGGUCGGGCCGCCAAUG,14,11,23,15,63
4580,25,URS0000D6C794_463794/1-63,GGGUGCGCUGCUGCAUACGGCACAGCGCAGGUUAAAGGAUAAGCAUUGGUCGGGCCGCCAAUG,14,11,23,15,63
4581,25,URS0000D68EB7_1125977/1-63,GGGUGCGCUGCUGCAUACGCUACAGCGCAGGUUAAAGGAUAAGCAUUGGUCGGGCCGCCAAUG,14,12,22,15,63
4582,25,URS0000D66A52_12908/1-63,GGGUGUAUCGACGCAUGUCGCGCGGUGCAGGUUAAAAGUGACGCGUUGGUCGGGCCGCCAACG,11,12,25,15,63
4583,25,URS0000D66A52_450396/1-63,GGGUGUAUCGACGCAUGUCGCGCGGUGCAGGUUAAAAGUGACGCGUUGGUCGGGCCGCCAACG,11,12,25,15,63
4584,25,URS0000D68342_1054213/1-56,GGGUGUUCGUCUCCGAUGAGAGAGGGCAGGGUUCAACACUGGUCGGGCCGCCAGUG,9,11,23,13,56
4585,25,URS0000D66EE7_12908/1-53,GGGUUCAGAGGAUUAAGCUCUGGAGGUAUUAUCAGAUGGUCGGGCCGCCAUCU,11,14,18,10,53
4586,25,URS0000D66310_12908/1-56,GGGUCUAGAGACUAAGCUCUAGAGGAUAAAUUAAUAAGAUAGUCGGGCCGCUAUCU,18,14,15,9,56
4587,25,URS0000D6AE58_12908/1-59,GGGUCUAGAGGGAAUACGCUCUAGAGGUUAAAUAAGGUAAGAUGGUCGGGCCGCCAUCU,16,13,20,10,59
4588,25,URS0000D6C9C0_12908/1-52,GGGUCUAGUGGAGUAUCCCUAGAGGUAUUAUUUGAUGGUCGGGCCGCCAUCC,9,15,17,11,52
4589,25,URS0000D6CB21_12908/1-50,GGGUCUAGGGUUAUCCCCUAGAGGUUGUUUUGAUGGUCGGGCCGCCAUCU,6,16,17,11,50
4590,25,URS0000D6971A_12908/1-52,GGGUGCACACACGCUGGUGUGAUGCAGGAUGCGCGAUGGUCGGGCCGCCACG,8,8,22,14,52
4591,25,URS0000D69386_12908/1-53,GGGUGUCGGGCGAAUCAACGUUCGACAGGUCAUGCGCAGGUCGGGCCGCCGCG,8,8,22,15,53
4592,25,URS0000D6B50D_864051/1-55,GGGUGCUCCGCCAAGCCAUGGCGAGGCAGGUUCCAGCGAAGGUCGGGCCGCCUCG,8,7,22,18,55
4593,25,URS0000D685B6_12908/1-53,GGGUGUCCGCCGCCACUGCGGCGAACAGGCAUUGCGCUGGUCGGGCCGCCGCG,5,7,22,19,53
4594,25,URS0000D6716C_12908/1-49,GGGUGCAGCGAUCUCCGCUGCAGGUGCCGUGGGGGCCGGGCCGCCUCCG,3,7,22,17,49
4595,25,URS0000D6A7C8_12908/1-52,GGGUUCGGUUACAUGGUAACCGGAGGAAAUUUGGAUGGUCGGGCCGCUAUCC,10,13,19,10,52
4596,25,URS0000D6C698_12908/1-53,GGGUGCGCGGCCGCGUGGCCGUGCAGGGAUCUCGGACGGUCGGGCCGCCGUCC,3,7,25,18,53
4597,25,URS0000D68DE2_12908/1-58,CGGUCUGGGAAUACAUAAGUAUUCCCGGAGGAUCUAUAGGAUGGUCGGGCCGCCAUCU,13,14,18,13,58
4598,25,URS0000D67BF6_12908/1-50,GGGUCCGAGAAAAAUUCUCGGAGGGUUGUUUGAUGGUCGGGCCGCCAUCU,9,13,18,10,50
4599,25,URS0000D67F30_12908/1-54,GGGUUCGGGAAUAUUUUUCUCGAAGGGUUUUUCUUAAUGGUCGGGCCGCCAUUU,8,21,16,9,54
4600,25,URS0000D65C5D_12908/1-53,GGGUGUUCGGGAAAUCGUUUCGGGCAGGUUUCAAGCUGGUCGGGCCGCCAGCA,8,12,21,12,53
4601,25,URS0000D6A8DD_12908/1-53,GGGUGUCCGAGAAAUCGUUUCGGGCAGGUUUCAAGCUGGUCGGGCCGCCAGCA,9,11,20,13,53
4602,25,URS0000D6AAE5_12908/1-54,GGGUGUCCGGUAAAUUGUUUACGGGCAGGUUUCAAGCUGGUCGGGCCGCCAGCA,9,13,20,12,54
4603,25,URS0000D6831B_12908/1-55,GGGUGUCCUAUAAAUGGUUAUAGGUCAGGUAAUAAGCUAGGUCGGGCCGCCAGCU,13,14,18,10,55
4604,25,URS0000D69559_12908/1-53,GGGUCUGGGGGAGCUAUCUCCUAGAGGCAAACUGGAUGGUCGGGCCGCCAUCC,9,10,20,14,53
4605,25,URS0000D6A7B9_12908/1-55,GGGUGUCAACCGCGUCGGGCGGUGAGGCAGGACGUGCGAUGGUCGGGCCGCCACG,7,7,26,15,55
4606,25,URS0000D6889F_12908/1-55,GGGUGUCCGCACUGUUGUGCUUUGGCAGGUCAUAGCGCUGGUCGGGCCGCCAGCG,5,13,22,15,55
4607,25,URS0000D68AD3_742013/1-62,GGGUGUCCAGACCGCAUGGGGCGGCAGGACAGGUGUUGAUAGCGCAGGUCGGGCCGCCUGCG,9,9,28,16,62
4608,25,URS0000D68AD3_398578/1-62,GGGUGUCCAGACCGCAUGGGGCGGCAGGACAGGUGUUGAUAGCGCAGGUCGGGCCGCCUGCG,9,9,28,16,62
4609,25,URS0000D6B4F5_12908/1-56,GGGUGCCCGCCGCAUAAGGCAGCGAGGCAGGUAGCAGCGUCGGUCGGGCCGCCACG,9,5,24,18,56
4610,25,URS0000D6AC7C_12908/1-56,GGGUGCUUGCUGCAUGACGUGGCGAGGCAGGCAAUAGCGUCGGUCGGGCCGCCACG,8,9,24,15,56
4611,25,URS0000D66C95_12908/1-56,GGGUGUCACGCUGCAUUCCGCAGACGACAGGACUAACGUUGGUCGGGCCGCCAACG,11,9,19,17,56
4612,25,URS0000D69519_12908/1-58,GGGUGUACACGGUGCAUAUUGCUGCGUGACAGGUUUUAGCGUAGGUCGGGCCGCCACG,9,14,22,13,58
4613,25,URS0000D65C77_1007104/1-56,GGGUGUUCGCAAAAUGCUGAUGCGGACAGGUUCUAACGUUGGUCGGGCCGCCAACG,11,12,20,13,56
4614,25,URS0000D68DA4_12908/1-56,GGGUGCAGAUGAAUAUCAAGUAAUCUGCAGGUUUUUGGGUGGUCGGGCCGCCAUCC,11,15,19,11,56
4615,25,URS0000D69076_12908/1-52,GGGUGCGACAGGGCUACCUGUCGUAGGUUUCCGGAUGGUCGGGCCGCCAUCC,6,11,20,15,52
4616,25,URS0000D6B39B_12908/1-54,GGGUGCGACUGAACUGACUCAGUCGCAGGUUUCUUGGAUGGUCGGCCGCCAUCC,8,13,18,15,54
4617,25,URS0000D685FC_12908/1-55,GGGUGCGACUAAAAUGACUUAGUCGCAGGUUUUGCGAGUGGUCGGGCCGCCAUUC,10,14,19,12,55
4618,25,URS0000D6D21F_12908/1-55,GGGUGCGAUUGAACUGACUCAGUCGCAGGUAUUGCGAAUAGUCGGGCCGCUAUUC,11,14,18,12,55
4619,25,URS0000D6614B_12908/1-61,GGGUGCGGUCUAGCAACCAGGAUGUUGGACCGCAGGUUGGGGAAUGGUCGGGCCGCCAUUC,10,12,25,14,61
4620,25,URS0000D6BDBB_12908/1-54,GGGUCCGCCGGCGAGCACUGGCGGAGGUUAUUGCGGAUGGUCGGGCCGCCAUCC,6,9,23,16,54
4621,25,URS0000D65A08_12908/1-57,GGGUGUUCGCUGCGAUAUGAGCGGGCAGGUUCACAUGUGUUGGUCGGGCCGCCAGCA,8,13,23,13,57
4622,25,URS0000D67B2C_12908/1-51,GGGUGCAGCAGGAAGUCUGUUGCAGGAUAACGGGUGGUCGGGCCGCCACAC,10,8,21,12,51
4623,25,URS0000D67239_12908/1-55,GGGUGUCCGCGAUUUUACGUAUGGACAGGUGAUAGCGCUGGUCGGGCCGCCAGCG,8,12,22,13,55
4624,25,URS0000D6BC78_12908/1-53,GGGUGUCCGCACAUCGGCGCGGGCAGGGAAUAGCGCUGGUCGGGCCGCCAGCG,7,6,24,16,53
4625,25,URS0000D680FE_1144305/1-58,GGGUGUCCGGUCUUUGCGGGAGCGGGCAGGGUCUUUUGCGCUGGUCGGGCCGCCAGCG,3,13,27,15,58
4626,25,URS0000D6AB5C_12908/1-53,GGGUGUUCGCCAGUCGUGGCGGGCAGGGUGCAGCGCUGGUCGGGCCGCCGGCG,3,8,27,15,53
4627,25,URS0000D658A6_12908/1-51,GGGUUCGGAAGGUUCCUUCCGGAGGUUGUUUAGAUAGUCGGGCCGCUAUCU,7,16,18,10,51
4628,25,URS0000D6C622_12908/1-53,GGGUCCGGAAACGCAUGGCGCUUCCGGAGGAAUGGAUGGUCGGGCCGCCAUCU,9,9,21,14,53
4629,25,URS0000D673CF_12908/1-57,GGGUUCGGAACUGCGGGUGCAUUUCCGGAGGAUUUUUAGAUGGUCGGGCCGCCAUCU,8,16,21,12,57
4630,25,URS0000D68385_12908/1-54,GGGUUCGGGAGCAGCUUGCUUCCGGAGGAAAUUUAGAUGGCCGGGCCGCCAUCU,9,12,20,13,54
4631,25,URS0000D66E5D_12908/1-52,GGGUCCGGAAGCUUUUUGCUGCCGGAGGAUUUAGAUGGUCGGGCCGCCAUCU,7,14,19,12,52
4632,25,URS0000D66BCD_12908/1-58,UGGUCCGGAGAUGCGUAAGUAUUUCCGGAGGUGAUUUUAGAUGGUCGGGCCGCCAUCU,10,17,20,11,58
4633,25,URS0000D6A8FB_12908/1-52,GGGUCUGGGUUGUAAAUCCAGAGGUAAUCUUUCGAUGGUCGGGCCGCCAUCU,9,15,17,11,52
4634,25,URS0000D65967_12908/1-53,GGGUCUGGGUUGUAAUAUCCAGAGGUAAUCUUUAGAUGGUCGGGCCGCCAUCU,10,16,17,10,53
4635,25,URS0000D6853D_190650/1-53,GGGUGGUCGAUCGUCUUGGUCGAUCAGGGUUUACGUUGGUCGGGCCGCCAGCG,5,14,22,12,53
4636,25,URS0000D6676D_12908/1-53,GGGUGCCAGGGCUCGAGCCAUGGCAGGUUUCCAGGUUGGUCGGGCCGCCAGCC,6,9,22,16,53
4637,25,URS0000D6739F_12908/1-56,GGGUGUCGCGGGGGUGGUCCCGCGACAGGAUCGUUUGGUUGGUCGGGCCGCCAGCC,4,11,26,15,56
4638,25,URS0000D6633D_12908/1-49,GGGUGCGACGGCUGGCCGUUGCAGGUUCGGGCUGGUCGGGCCGCCAGCC,3,8,23,15,49
4639,25,URS0000D67E71_1192759/1-60,GGGUGUUCGUUUUCCAUAUGCAGGUGCGGGCAGGUAUUCACGCUGGUCGGGCCGCCAGCG,7,15,23,15,60
4640,25,URS0000D67E71_12908/1-60,GGGUGUUCGUUUUCCAUAUGCAGGUGCGGGCAGGUAUUCACGCUGGUCGGGCCGCCAGCG,7,15,23,15,60
4641,25,URS0000D65875_12908/1-59,GGGUGUUCGCCGCCAUAUUCGGAGGUGGGCAGGUUCUUACGCUGGUCGGGCCGCCAGCG,6,13,24,16,59
4642,25,URS0000D6D1AB_12908/1-55,GGGUGUCAGCUGCAUGUCGCAGCGGGCAGGUUCAUGCGUCGGUCGGGCCGCCACG,6,10,23,16,55
4643,25,URS0000D67080_12908/1-55,GGGUGUCCACCGCAUCGUGCGGCGGGCAGGUUCAUGCGUCGGUCGGGCCGCCACG,5,9,23,18,55
4644,25,URS0000D6AA6C_272630/1-56,GGGUGUGCGGUCCGGCAAUAGGAUCGGCAGGUCAAGCGUUGGUCGGGCCGCCAGCG,8,9,25,14,56
4645,25,URS0000D6993C_12908/1-55,GGGUGCACGGUCCUGCCAGGAUCGGCAGGUCUUCGCGCUGGUCGGGCCGCCAGCG,5,9,23,18,55
4646,25,URS0000D69BC6_440085/1-57,GGGUGCGCGGUCCGAACGUCGGGCCGGCAGGCUUCAGCGUUGGUCGGGCCGCCAGCG,5,8,26,18,57
4647,25,URS0000D6D333_12908/1-57,GGGUGCGUGAUCCGGCGAUCGGAUCGGCAGGUGUCAGCGCUGGUCGGGCCGCCAGCG,6,9,26,16,57
4648,25,URS0000D671EB_272630/1-57,GGGUGCACGGUCCGAAGGUCGGAGCGGCAGGUUUAUGUGCUGGUCGGGCCGCCAGCA,8,10,25,14,57
4649,25,URS0000D675E2_1096546/1-57,GGGUGUACGAUCCGGAGGUCGGAUCGGCAGGUUUCUGCGUUGGUCGGGCCGCCAGCG,6,12,25,14,57
4650,25,URS0000D6CFC9_426355/1-56,GGGUGCGCGGUCCGUCGUUCGGAUCGGCAGGUUGAGCGCUGGUCGGGCCGCCAGCG,4,10,26,16,56
4651,25,URS0000D67145_438753/1-56,GGGUGCGCGAUCCCCUAUUGGAUCGGCAGGUUGUUGCGCUGGUCGGGCCGCCAGCG,5,12,23,16,56
4652,25,URS0000D6B30D_1230476/1-53,GGGUGUUGUCUGCAUGGAGCAGUGACAGGUUGAGCGAUGGUCGGGCCACCACG,9,11,22,11,53
4653,25,URS0000D674EF_319017/1-51,GGGUGUUCGCUGUAUCGGCAGCGACAGGAAAGCGAUGGUCGGGCCGCCACG,9,8,21,13,51
4654,25,URS0000D66C08_12908/1-52,GGGUGUUCGCUGCGUGGUGCAGCGGCAGGUUAGCGAUGGUCGGGCCGCCACG,5,10,24,13,52
4655,25,URS0000D6CE05_12908/1-53,GGGUGUCCGCUGCAUGCAGCAGUGACAGGUCAAGCGAUGGUCGGGCCGCCACG,9,8,21,15,53
4656,25,URS0000D6BD98_335659/1-53,GGGUGCUCGCUGCAUGUGGCAGCGACAGGUCAAGCGAUGGUCGGGCCGCCACG,8,8,22,15,53
4657,25,URS0000D6ACB0_1037409/1-54,GGGUGCUCGCUGCAUUUGCGCAGCGACAGGUCAAGCGAUGGUCGGGCCGCCACG,8,9,21,16,54
4658,25,URS0000D6620C_12908/1-53,GGGUGCUCGCUGCUUGAUGCGGCGACAGGUCAAGCGAUGGUCGGGCCGCCACG,7,9,22,15,53
4659,25,URS0000D691B6_1144344/1-54,GGGUGCUCGCUGCAUGUGUGCAGCGACAGGUCAAGCGAUGGUCGGGCCGCCACG,8,9,22,15,54
4660,25,URS0000D6690D_12908/1-64,GGGUGCCCGCCGCACGAGGUGGCGAUGGCAGGUGAAUGUUCAUGCGCAGGUCGGGCCGCCAGCG,9,9,28,18,64
4661,25,URS0000D6BA73_563045/1-64,GGGUGCCCGUCACACAAGGUGGCGAUGGCAGGUGAAUGUUCAUGCGCAGGUCGGGCCGCCAGCG,11,10,26,17,64
4662,25,URS0000D6BA73_399795/1-64,GGGUGCCCGUCACACAAGGUGGCGAUGGCAGGUGAAUGUUCAUGCGCAGGUCGGGCCGCCAGCG,11,10,26,17,64
4663,25,URS0000D6898B_314253/1-58,GGGUGUUUUUGCUGCAUCGGGCAGCGGAAACAGGUCGUGCGUUGGUCGGGCCGCCGCG,6,13,25,14,58
4664,25,URS0000D671D8_1055192/1-56,GGGUGUCGUCACAUAGGGUGUAGCGGCAGGUUGUGAGCGAAGGUCGGGCCGCCUCG,8,11,25,12,56
4665,25,URS0000D671D8_12908/1-56,GGGUGUCGUCACAUAGGGUGUAGCGGCAGGUUGUGAGCGAAGGUCGGGCCGCCUCG,8,11,25,12,56
4666,25,URS0000D6AC00_365044/1-58,GGGUGUCGUCAUCGCAUGCAGCGGUGCGGCAGGUUCAUGCGAUGGUCGGGCCGCCUCG,6,12,24,16,58
4667,25,URS0000D699F8_643561/1-51,GGGUGUCGUCACAUGGGGUGCGGCAGGUUUAGCGAAGGUCGGGCCGCCUCG,6,10,23,12,51
4668,25,URS0000D6C9EA_397945/1-51,GGGUGCCGUCACAUGGGGUGCGGCAGGUGUAGCGAAGGUCGGGCCGCCUCG,6,8,24,13,51
4669,25,URS0000D6ABFA_1144317/1-53,GGGUGUACGCGCUACAGGGGCGCGGCAGGUUCAGCGUCGGUCGGGCCGCCACG,6,7,24,16,53
4670,25,URS0000D6ACB3_358220/1-54,GGGUGUCGGCGCCAUGGUGGCCCGGCAGGUUCAUGCGCUGGUCGGGCCGCCGCG,3,9,25,17,54
4671,25,URS0000D6AA74_12908/1-54,GGGUGUCGGCGCCAUGGUGGCCCGGCAGGUUCAUGCGCUGCUCGGGCCGCCGCG,3,9,24,18,54
4672,25,URS0000D69F42_573060/1-53,GGGUGUACGCGCAGUGGGGCGCGGCAGGUUCAUGCGCUGGUCGGGCCGCCGCG,4,8,26,15,53
4673,25,URS0000D66783_12908/1-58,GGGUGUUCGCGCUGCAUGUCGCAGCGAAACAGGUUCUUGCGCUGGUCGGGCCGCCGCG,6,12,23,17,58
4674,25,URS0000D6CA91_375286/1-56,GGGUGUUUACGCUGCAUACCGCAGCGGACAGGUAACGCGUCGGUCGGGCCGCCACG,9,9,21,17,56
4675,25,URS0000D6C322_381666/1-59,GGGUGUCUACGCUGCACGUCGCAGUGAGACAGGUUAAUGCGUUGGUCGGGCCGCCAACG,10,12,22,15,59
4676,25,URS0000D6C322_1229514/1-59,GGGUGUCUACGCUGCACGUCGCAGUGAGACAGGUUAAUGCGUUGGUCGGGCCGCCAACG,10,12,22,15,59
4677,25,URS0000D67334_12908/1-57,GGGUGUCAGCUGCAUCGUGCAGCGGGGACAGGUCAAUGCGUCGGUCGGGCCGCCACG,8,9,24,16,57
4678,25,URS0000D6937A_987059/1-52,GGGUGCCGCGGAGAUCGCCGCGGCAGGUUUUCGCGCAGGUCGGGCCGCCGCG,4,7,24,17,52
4679,25,URS0000D68E09_12908/1-52,GGGUGCCGGGCCACGAGGCGCGGCAGGUUCUGCACUGGUCGGGCCGCCAGCG,5,6,24,17,52
4680,25,URS0000D688EB_543728/1-65,GGGUGCGGGGCCGCUUGCUUCUUGUUGGCGGCGCCGCAGGUUCAUGCGAUGGUCGGGCCGCCACG,4,14,28,19,65
4681,25,URS0000D699EC_365046/1-53,GGGUGCGGCGCCGUGCGGGCGCCGCAGGUUCUCGCGCAGGUCGGGCCGCCGCG,2,6,26,19,53
4682,25,URS0000D68F75_420662/1-56,GGGUGUCGGACCGCGAGCGCGGUGCGGCAGGUUCAUGCGAAGGUCGGGCCGCCUCG,6,8,26,16,56
4683,25,URS0000D6CDD7_983917/1-52,GGGUGCCGUGGCGACCGCCGCGGCAGGUUCAUGCGCAGGUCGGGCCGCCGCG,4,6,24,18,52
4684,25,URS0000D68733_887062/1-51,GGGUGCGAUGCCGGUCGGCAUGGCAGGUACAGCGCAGGUCGGGCCGCCGCG,6,6,24,15,51
4685,25,URS0000D6CABE_94624/1-57,GGGUGUCGGCCGCAACCUGCGGCAAGACAGGUUCAUUGCGCUGGUCGGGCCGCCACG,8,9,22,18,57
4686,25,URS0000D6660E_743720/1-59,GGGUGCCACCGCAGUUGCGGCAAGGCAGGUUCAUUCCCGCGCUGGUCGGGCCGCCAGCG,7,9,23,20,59
4687,25,URS0000D69FD2_1134475/1-60,GGGUGCCACCGCAACAACGCGGCAGGGCAGGUUAAUUUAGCGAAGGUCGGGCCGCCAUCG,13,8,22,17,60
4688,25,URS0000D69FD2_1206777/1-60,GGGUGCCACCGCAACAACGCGGCAGGGCAGGUUAAUUUAGCGAAGGUCGGGCCGCCAUCG,13,8,22,17,60
4689,25,URS0000D69FD2_12908/1-60,GGGUGCCACCGCAACAACGCGGCAGGGCAGGUUAAUUUAGCGAAGGUCGGGCCGCCAUCG,13,8,22,17,60
4690,25,URS0000D6C005_12908/1-59,GGGUGUCACCGCAAAACGCGGGAGGGCAGGUUUAAUUCAGCGCAGGUCGGGCCGCCGCG,11,8,24,16,59
4691,25,URS0000D6874D_1144328/1-60,GGGUGCCACCGCAACAACGCGGCAGGGCAGGUUUAAUUCAGCGCAGGUCGGGCCGCCGCG,11,7,23,19,60
4692,25,URS0000D6874D_12908/1-60,GGGUGCCACCGCAACAACGCGGCAGGGCAGGUUUAAUUCAGCGCAGGUCGGGCCGCCGCG,11,7,23,19,60
4693,25,URS0000D6874D_743713/1-60,GGGUGCCACCGCAACAACGCGGCAGGGCAGGUUUAAUUCAGCGCAGGUCGGGCCGCCGCG,11,7,23,19,60
4694,25,URS0000D686FD_232721/1-61,GGGUGUCCACCGCAUGGGGCGGCAGGGCAGGAUUGUUGCAGCGCAGGUCGGGCCGCCUGCG,7,9,28,17,61
4695,25,URS0000D699FB_535289/1-61,GGGUGUCCACCGCAUGGGGCGGCAGGGCAGGAUUGUUGCAGCGCAGGUCGGGCCGCCUGUG,7,10,28,16,61
4696,25,URS0000D699FB_12908/1-61,GGGUGUCCACCGCAUGGGGCGGCAGGGCAGGAUUGUUGCAGCGCAGGUCGGGCCGCCUGUG,7,10,28,16,61
4697,25,URS0000D6664A_1112217/1-60,GGGUGUCGCCGCAUUCACGCGGUAGGACAGGUUGAACUGAGCGCAGGUCGGGCCGCCGCG,9,9,25,17,60
4698,25,URS0000D6B4BA_12908/1-54,GGGUGCGGUGGCGCAAUGCUUCCGCAGGUAGUGAGGGUGGUCGGGCCGCCAUCC,6,10,24,14,54
4699,25,URS0000D66CE1_12908/1-59,GGGUCCGGAGGUAGCGUUUCACUAUUUCCGGAGGACAGAGGAUGGUCGGGCCGCCAUCC,10,12,22,15,59
4700,25,URS0000D6C242_671143/1-59,AGGUCCGGAGAUAGCGAUUACCUAUUUCCGGAGGAGAGAGGGUGGUCGGGCCGCCAUCC,12,11,22,14,59
4701,25,URS0000D6B003_12908/1-52,GGGUGCAGGGGUAGACGCUCCUGCAGGUAUUGAGAUGGUCGGGCCGCCAUCC,8,10,21,13,52
4702,25,URS0000D670D0_671143/1-59,GGGUCCGGAGACGGCAAUCAUGCGUUUCCGGAGGAGAGAGGGUGGUCGGGCCGCCAUCC,10,9,25,15,59
4703,25,URS0000D6B4FF_12908/1-54,GGGUUCAGAGACUUAAAGGUUUCUGGAGGAUUUUUGAUGGUCGGGCCGCCAUCU,10,17,18,9,54
4704,25,URS0000D6D0EB_12908/1-53,GGGUUCAGGAACUUAAAGGUUUCUGGAGGAUUUUGAUGGUCGGGCCGCCAUCU,10,16,18,9,53
4705,25,URS0000D65C9A_12908/1-56,GGGUGCGUCGGCAUCGGGCCGCCGCAGGUAGACAUCGGGUGGUCGGGCCGCCACUC,6,8,24,18,56
4706,25,URS0000D6B732_12908/1-49,GGGUUCAGCCGCUAGGCUGGAGGGAUUCAGGAUGGUCGGGCCGCCAUUC,7,10,20,12,49
4707,25,URS0000D66E2F_12908/1-47,GGGUCCAGCCGAAAGGCUGGAGGAUAUGGAUGGUCGGGCCGCCAUCC,9,7,19,12,47
4708,25,URS0000D65E2F_12908/1-50,GGGUCCAGCCUGGAAAGGCUGGAGGUAUUGGAAUGGUCGGGCCGCCAUUC,9,10,20,11,50
4709,25,URS0000D6D192_12908/1-61,GGGUGCGGGGCCGGGUUCGCCGCCGGCCGCCGCAGGCGGUGGGAUGAUCGGGCCGUCAUCC,4,8,29,20,61
4710,25,URS0000D6B936_12908/1-51,GGGUGCAGCGAGCAUCGCUGCAGGCACCGCUGCUGGUCGGGCCGCCAGUGG,6,7,22,16,51
4711,25,URS0000D69B79_12908/1-55,GGGUGUGGCAGCACUAACGCUGCCGCAGGCAAUUUGGAUGGUCGGGCCGCCAUCC,9,10,20,16,55
4712,25,URS0000D69088_12908/1-52,GGGUGCGGCGGGUCGGUCCGCCGCAGGAAUCCGGUUGGUCGGGCCGCCAGCC,4,7,24,17,52
4713,25,URS0000D6BB09_12908/1-49,GGGUGCGGCGCCCGGUGCCGCAGGAAAGAGGAUGGUCGGGCCGCCAUCU,7,6,22,14,49
4714,25,URS0000D6CFBD_1297742/1-49,GGGUGCGGCGAUGCGCGCCGCAGGACCACGGAUGGUCGGGCCGCCAUCC,6,5,21,17,49
4715,25,URS0000D69379_246197/1-49,GGGUGCGGCGAUGAACGCCGCAGGAACUCGGAUGGUCGGGCCGCCAUCC,8,6,20,15,49
4716,25,URS0000D6675E_483219/1-48,GGGUGCGGCGAUGCACGCCGCAGGAACGGGAUGGUCGGGCCGCCAUCC,7,5,21,15,48
4717,25,URS0000D6C64A_12908/1-51,GGGUGCGGCGGAUUCCCGCUGCAGGAACUCGGGAUGGUCGGGCCGCCAUCC,6,8,21,16,51
4718,25,URS0000D66F22_12908/1-50,GGGUGCAGCGGGCUCCCGCUGCAGGCACUCGGAUGGUCGGGCCGCCAUCC,5,7,20,18,50
4719,25,URS0000D6C761_12908/1-51,GGGUGCAGCCGCCGUCGGCUGCAGGCAUCGUGGAUGGUCGGGCCGCCAUCC,5,8,21,17,51
4720,25,URS0000D65F9C_12908/1-48,GGGUGCAGCGUCGUUUGCUGCAGGAUGAGGAUGGUCGGGCCGCCAUCC,6,10,20,12,48
4721,25,URS0000D65953_12908/1-53,GGGUGCAGCGGGUCGUGUGCGCUGCAGGCAGCUGGAUGGUCGGGCCGCCAUCC,5,9,24,15,53
4722,25,URS0000D6C93A_12908/1-48,GGGUGCAGUCCCGGCACUGCAGGACAACGGAUGGUCGGGCCGCCAUCC,8,6,18,16,48
4723,25,URS0000D67410_12908/1-47,GGGUGCGGCGCCGGGCCGCAGGAGAGCGGAUGGUCGGGCCGCCAUCC,5,4,23,15,47
4724,25,URS0000D6CD39_12908/1-49,GGGUGCAGCGACGUCCGCUGCAGGCAUCGCGACGGUCGGGCCGCCGUCG,5,6,21,17,49
4725,25,URS0000D6ABA6_12908/1-50,UGGUGCGGCGCUCGCGCGCCGCAGGCAUCGAGUAGGUCGGGCCGCCUACC,5,7,20,18,50
4726,25,URS0000D66509_767434/1-56,GGGUGUCUUGGCCAUGGUGGCGCAAGACAGGUCGAUGCGCAGGUCGGGCCGCCGCG,7,9,25,15,56
4727,25,URS0000D6AC6B_204773/1-57,GGGUGUAGCGUUGCAUCGUGCAGCGAGACAGGUUUAUGCGAUGGUCGGGCCGCCACG,9,12,23,13,57
4728,25,URS0000D6BEF5_323098/1-55,GGGUGUUCGCUGCAUUGGGCAGCGAAACAGGUCGUGCGAUGGUCGGGCCGCCACG,8,10,23,14,55
4729,25,URS0000D6B24C_743720/1-57,GGGUGUUAGCCGCAUGGUGCGGUGAGACAGGUCUGUUGCGUUGGUCGGGCCGCCGCG,5,13,26,13,57
4730,25,URS0000D65A33_391038/1-57,GGGUGUUAGCUGCACGUUGCAGCGGGACAGGUCAUCUGCGCUGGUCGGGCCGCCACG,7,11,23,16,57
4731,25,URS0000D6645F_985010/1-63,GGGUGUCUGCUGCAUGGUGCAGUGAGGCAGGUUAAAGAACAGCGCAGGUCGGGCCGCCAUGCG,12,11,26,14,63
4732,25,URS0000D66BD7_1196325/1-63,GGGUGCCAGCUGCACGGUGCAGUGGGGCAGGUUAAAGAACAGCGCAGGUCGGGCCGCCAUGCG,12,8,27,16,63
4733,25,URS0000D66BD7_1227924/1-63,GGGUGCCAGCUGCACGGUGCAGUGGGGCAGGUUAAAGAACAGCGCAGGUCGGGCCGCCAUGCG,12,8,27,16,63
4734,25,URS0000D66BD7_12908/1-63,GGGUGCCAGCUGCACGGUGCAGUGGGGCAGGUUAAAGAACAGCGCAGGUCGGGCCGCCAUGCG,12,8,27,16,63
4735,25,URS0000D66BD7_1388762/1-63,GGGUGCCAGCUGCACGGUGCAGUGGGGCAGGUUAAAGAACAGCGCAGGUCGGGCCGCCAUGCG,12,8,27,16,63
4736,25,URS0000D66BD7_351746/1-63,GGGUGCCAGCUGCACGGUGCAGUGGGGCAGGUUAAAGAACAGCGCAGGUCGGGCCGCCAUGCG,12,8,27,16,63
4737,25,URS0000D66BD7_1193146/1-63,GGGUGCCAGCUGCACGGUGCAGUGGGGCAGGUUAAAGAACAGCGCAGGUCGGGCCGCCAUGCG,12,8,27,16,63
4738,25,URS0000D66BD7_1042876/1-63,GGGUGCCAGCUGCACGGUGCAGUGGGGCAGGUUAAAGAACAGCGCAGGUCGGGCCGCCAUGCG,12,8,27,16,63
4739,25,URS0000D66BD7_231023/1-63,GGGUGCCAGCUGCACGGUGCAGUGGGGCAGGUUAAAGAACAGCGCAGGUCGGGCCGCCAUGCG,12,8,27,16,63
4740,25,URS0000D6B7BF_931281/1-63,GGGUGCCAGCUGCACGGUGCAGUGAGGCAGGUUAAAGAACAGCGCAGGUCGGGCCGCCAUGCG,13,8,26,16,63
4741,25,URS0000D6B7BF_12908/1-63,GGGUGCCAGCUGCACGGUGCAGUGAGGCAGGUUAAAGAACAGCGCAGGUCGGGCCGCCAUGCG,13,8,26,16,63
4742,25,URS0000D6B255_390235/1-63,GGGUGCUAGCUGCAUGACGCAGUGACGCAGGUUAAAUAACUACGCAGGUCGGGCCGCCGUGCG,13,11,23,16,63
4743,25,URS0000D6B45F_1144340/1-63,GGGUGCUAGCUGCAUGAAGCAGUGAUGCAGGUUAAACAGCUACGCAGGUCGGGCCGCCUUGCG,13,12,23,15,63
4744,25,URS0000D6B9EB_12908/1-64,GGGUGCUGACUGCUUGGUGCAGUGAGGCAGGUUAAAAAGACUACGCUGGUCGGGCCGCCAUGCG,12,13,25,14,64
4745,25,URS0000D675BB_12908/1-63,GGGUGCUAGCUGCAGAGUGCAGUGAAGCAGGUUAAUCGAACAUCGCCGGUCGGGCCGCCAGCG,13,10,24,16,63
4746,25,URS0000D6C80B_513052/1-56,GGGUGUUAGCUGCAUUCCGCAGCGAAACAGGUUCAUGCGUCGGUCGGGCCGCCACG,9,11,20,16,56
4747,25,URS0000D6927D_12908/1-56,GGGUGUUAGCUGCAUGCCGCAGCGGGACAGGUUCAUGCGUCGGUCGGGCCGCCACG,7,10,23,16,56
4748,25,URS0000D6828C_12908/1-56,GGGUGUUGGCUGCAUACCGCAGUGGAACAGGUUCAUGCGCAGGUCGGGCCGCCGCG,8,10,23,15,56
4749,25,URS0000D678DE_12908/1-63,CGGUGCCAGCUGCGAGGUGCAGUGGGGCAGGUUAAUUCGAUAGCGCAGGUCGGGCCGCCAGCG,10,10,27,16,63
4750,25,URS0000D6D358_12908/1-60,GGGUUCUGAAGUUUAUAUUUUAAGCUUCAGAAGGGACUGUAGAUGGUCGGGCCGCCAUCC,13,18,18,11,60
4751,25,URS0000D675EB_12908/1-55,GGGUCCGUGGGCACUGACGCCCACGGAGGUCACGUGGAUGGUCGGGCCGCCAUCC,7,8,22,18,55
4752,25,URS0000D6B814_12908/1-55,GGGUUCGAGGACACUGAAGUCCUCGGAGGUCAACCGGAUGGUCGGGCCGCCAUCC,10,9,20,16,55
4753,25,URS0000D6A60A_12908/1-55,GGGUCCGAGGGCACUGACGCCCUCGGAGGUCAACCGGAUGGUCGGGCCACCAUCC,9,7,20,19,55
4754,25,URS0000D6B1FD_12908/1-56,GGGUCCGUGGGCACUGACGCCCACGGAGGUUACGCGGCUGGUCGGGCCGCCAUCCG,6,8,23,19,56
4755,25,URS0000D660F6_12908/1-51,GGGUUCGGGAAGAUUUUCUCCCGGAGGACUUGGGUGGUCGGGCCGCCACUC,6,12,20,13,51
4756,25,URS0000D6CE9A_12908/1-46,GGGUCCGGGAAUAACCCGGAGGAAAUGAGUGGUCGGGCCGCCAUUC,10,7,18,11,46
4757,25,URS0000D6CD31_448385/1-59,GGGUGUCGCGGCGGCGGAGCGCCGCGACAGGUCUUCAUGGGACGGUCGGGCCGCCUUCC,5,9,26,19,59
4758,25,URS0000D66296_12908/1-55,GGGUCUGUCAGCGAGCGCUGGCGGAGGACAAUCCGGAUGGUCGAGCCGCCAUCCG,9,8,22,16,55
4759,25,URS0000D6962F_12908/1-56,GGGUCCGAUAGUGAGUGCUGUCGGAGGAAAAUUCCGGAUGGUCGGGCCGCCAUCCG,10,11,22,13,56
4760,25,URS0000D6C087_12908/1-55,GGGUCCGAUGGUGCGUGCUGUCGGAGGAAAACCCGGGUGGUCGGGCCGCCAUCCG,7,9,24,15,55
4761,25,URS0000D6C00D_12908/1-55,GGGUUCGACCGCACUUGCGGUCGGAGGUCAAUUCGGAUGGUCGGGCCGCCAUCCG,7,11,21,16,55
4762,25,URS0000D69E19_12908/1-66,GGGUUCGAAGGCACACUGUGUGCUUUCGGAGGAUAGACGGGUAGCAAAUGGUCGGGCCGCCAUUCG,13,14,25,14,66
4763,25,URS0000D68CE2_12908/1-53,GGGUCUGGCAAUGAAAUGCGUGCCAGAGGAUAAAGAUGGUCGGGCCGCCAUCU,13,10,19,11,53
4764,25,URS0000D66748_903818/1-52,GGGUGCACUGAUAGCCAGUGCAGGGUUCAGGUGAAGGUCGGGCCGCCUUCCG,8,10,21,13,52
4765,25,URS0000D6876F_12908/1-60,GGGUGCCCACCACAUCAGGUGGUGAUGCAGGUCAUUCAGGUACAGGUCGGGCCGCCUGUA,11,12,21,16,60
4766,26,AJ012295.1/100-178,GAAUUAUCCCGUGGUGAUUUGGCCGGUCGGCUUGCAGCCACGUUAAACAAGUGGCUAAAAAGACCGGGUUGAAACCGGU,20,18,24,17,79
4767,26,BX572608.1/148770-148849,GACUUAUCCCGUGGUGAUUUGAGCCGGCCGGCUUGCAGCCACGUUAAACAAGUCGCUAAACAGGCCGGGGACGUUGUGGU,16,18,26,20,80
4768,26,BX572607.1/122628-122549,ACCAGAACUCGUGGUCAUUUGAGCCGGCCGGCUUGCAGCCACGUUAAACAACUCGCUAAACAGGCCGGGGACAGUUCCGA,20,14,22,24,80
4769,26,CP000301.1/5473167-5473246,GACUUAUCCCGUGGUGAUUUGAGCCGGCCGGCUUGCAGCCACGUUAAAUAAAUCGCUAAACAGGCCGGGGACAGUGUGAU,19,18,24,19,80
4770,26,CP000115.1/164818-164739,UACGUCUCCCGUGGUGAUUUGAGCCGGCCGGCUUGCAGCCACGUUAAACAAGUCGCUAAACAGGCCGGGGACAAUGUGAU,18,17,24,21,80
4771,26,CP000494.1/790440-790361,CACUUAUCCCGUGGUGAUUUGAGCCGGCCGGCUUGCAGCCACGUUAAAUAAGUCGCUAAACAGGCCGGGGACGAAUGUGA,19,17,24,20,80
4772,26,CP000319.1/239336-239415,GACCUGUCCCGUGGUGAUUUGAGCCGGCCGGCUUGCAGCCACGUUAAAUAAGUUGCUAAACAGGCCGGGGACAAUGUGAU,18,18,25,19,80
4773,26,CP000463.1/5459740-5459819,AACUUAUCCCGUGGUGAUUUGAGCCGGCCGGCUUGCAGCCACGUUAAAUAAAUCGCUAAACAGGCCGGGGAUAUGUGUCC,19,19,22,20,80
4774,26,AAMY01000002.1/143789-143710,GACGCGCUCCGUGGUGAUUUGAGCCGGCCGGCUUGCAGCCACGUUAAACAAGUCGCUAAACAGGCCGGGGACAGCGCGAU,17,13,27,23,80
4775,26,CP000390.1/128049-128127,CUUUAUCCCCGUGGUGAUUUGGCCGGUCGGCUUGCAGCCACGUUAAAGAAGUCGCUAAAAAGGCCGUGCUCGAAGCUCG,16,19,23,21,79
4776,26,CP000738.1/3178367-3178444,CAAACAAUCCGUGGUGAUUUGGCCGGCCGGCUUGCAGCCACGUUAAAGAAGUCGCUAAAGGGCCGAGGGAACGAUAGA,22,13,25,18,78
4777,26,CP000774.1/443091-443012,GCCCGAACUCGUGGUGAUUUGAGCCGACCGGCUUGCGGCCACGUUAAAUAAUUCGCUAAAAAGGUCGGGACGCGAGCCCC,18,15,24,23,80
4778,26,AAUW01000005.1/136978-137057,GGCGCACUUCGUGGUGAUUUGGGCCGGCCGGCUUGCAGCCACGUUAAACAAGUUGCUAAAAAGGCCGGAGGUGAGAACCC,18,15,27,20,80
4779,26,BA000040.2/1515209-1515288,UGCCUGUUCCGUGGUCAUUUGAGCCGGCCGGCUUGCAGCCACGUUAAAAAACUCGCUAAACAGGCCGGGGACGCUUCCGA,16,17,23,24,80
4780,26,CP000158.1/3446494-3446417,AUCCUCGUCCGUGGUGAUUUGGCCGGCCGGCUUGCAGCCACGUUAAACAAGUCGCUAAAGGGCCGAGAUGCAGGAAAC,18,15,24,21,78
4781,26,CP000133.1/4272024-4272101,AAGGCACUCCGUGGUGAUUUGGCCGGCCGGCUUGCAGCCACGUUAAAAAAGUCGCUAAAGGGCCGCGUGCGGACCGGU,16,14,27,21,78
4782,26,CP000250.1/4839177-4839098,GCCAGAUCCCGUGGUCAUUUGAGCCGGCCGGCUUGCAGCCACGUUAAACAACUCGCUAAACAGGCCGGGGACAGUUUCUG,17,16,23,24,80
4783,26,AM236080.1/4895428-4895351,UAAGGCCUCCGUGGUGAUUUGGCCGGCCGGCUUGCAGCCACGUUAAAAAAGUCGCUAAAGGGCCGCGUGCGGACCGGU,15,15,27,21,78
4784,26,CP000283.1/4563959-4563880,CCGCGAUCCCGUGGUCAUUUGAGCCGGCCGGCUUGCAGCCACGUUAAACAAUUCGCUAAACAGGCCGGGGAUAGUUUCGA,17,17,23,23,80
4785,26,BA000012.4/2853663-2853740,CAACAGUUCCGUGGUGAUUUGGCCGGUCGGCUUGCAGCCACGUUAAACAAUUCGCUAAAGGGCCGUUUGCGUGACGUA,16,20,23,19,78
4786,26,CP000758.1/425473-425394,AAUGUGUUCCGUGGUGAUUUGGCCGGCCGGCUUGCAGCCACGUUAAAGAAUUCGCUAAAAAAGGCCGCGGUUCGUUACCG,17,20,24,19,80
4787,26,AAAP01003864.1/43186-43108,GUCUUGGUCCGUGGUGAUUUGUCCGACCGGAUUGCGGCCACGUUAAACAUCCCGCUAAAGAGGUCCGAGCGCUCCGCUA,14,19,23,23,79
4788,26,CP000230.1/3707118-3707042,CCCCAGAUUCGUGGGGAUUUGAGACCGGCUUGCGCCCACGUUAAACAAACAGCUAAAAGGGUCGUGUGACGAAAGUC,21,15,22,19,77
4789,26,AP007255.1/4636275-4636197,GACUCGAAGCGUGGUGAUUUGUCCGACCGGAUUGCGGCCACGUAAAACAUCCCGCUAAAGAGGUCCGAGCGCUCCGCCA,18,14,23,24,79
4790,26,AATP01000002.1/342466-342543,GCAAAGGACAGUGGUGAUUUGGCCGGCCGGCUUGCAGCCACGUUAAACAACUCGCUAAAGGGCCGAUCCGAUCGUGGA,19,14,25,20,78
4791,26,AAPJ01000002.1/433486-433409,CAAAGCAGAAGUGGUGAUUUGGCCGGCCGGCUUGCAGCCACGUUAAAGAAGUCGCUAAAGGGCCGUUCUGACGAUAUG,20,16,25,17,78
4792,26,CP000394.1/99101-99022,AGUCCUCUCCCUCGCGAUUUGUCCGGCCAGCUUGCGGCGAGGUUAAAUAAUCGCGCUAAAGAGGCCUGGGGAGCGUUGUU,14,20,25,21,80
4793,26,ABCL01000002.1/530718-530642,AGUCGCAACCGUGGCGAUUUGUUACCGGAUUGCGGGCCACGUUAAACAAACCGCUAAAAGGUCAGGAUGAAAGGCCC,22,14,22,19,77
4794,26,CP000781.1/516361-516281,CCGCUCACUCGUGGUGAAUUUGAGCCGGCCCGCUUGCAGCCACGUUAAACAACCUUGCUAAAAGGCCGGGGACGAACAGAC,20,14,22,25,81
4795,26,CP000009.1/1829616-1829537,GUGCCUGACCCUCGUGAUUUGAGCGGCCGGCUUGCGGCGAGGCUAAAGAACUGCGCUAAAGAGGCCCUGCGUCGUUAUCG,14,17,27,22,80
4796,26,AAMT01000001.1/270050-270128,CGCGAUUGCCGUGGCGAUUUGUCUUCCGGAUUGCGGGCCACGUUAAUCACUCCGCUAAAGAGGUCUGGGACGAUGAACG,15,19,25,20,79
4797,26,CP000577.1/522526-522602,GGCAAAUGCCGUGGUGCUUUGUGCCGGAUUGCGGGCCACGUUAAAGAAACCGCUAAAGAGGCGAGGGCCCGCCGCCC,16,12,27,22,77
4798,26,AAMV01000014.1/88367-88291,AUGCGCGACUGUGGCGAUUUGUUACCGGAUUGCGGGCCACGUUAAACAAACCGCUAAAAGGUCAGGAUGAAAGGCCC,21,15,23,18,77
4799,26,CP000661.1/637462-637539,GCCGGGCCUCGUGGUGCUUUGUUGCCGGAUUGCGGGCCACGUUAAAGAAGCCGCUAAAGAGGCGAGGGCGCACAGCCC,14,13,29,22,78
4800,26,CU234118.1/6715248-6715169,UGCCCGUUCCGUGGUCAUUUGAGCCGGCCGGCUUGCAGCCACGUUAAAAAACUCGCUAAACAGGCCGGGGACGUUAUCGA,17,17,23,23,80
4801,26,AE007869.2/429434-429356,AGCUUAUCCCGUGGUGAUUUGGCCGGUCGGCUUGCAGCCACGUUAAACAAGUGGCUAAAAAGACCGGGUGCUAGGAACC,19,17,24,19,79
4802,26,CP000830.1/2546702-2546778,CCGCGACACCGUGGUGAUUUGGUGCCGGAUUGCAGGCCACGUAAAACACGCUGCUAAAAGGACGCGGAACCCCCGAG,19,11,24,23,77
4803,26,CP001389.1/177149-177071,GCUUUAUCCCGUGGUGAUUUGGCCGGUCGGCUUGCAGCCACGUUAAACAAGUAGCUAAAAAGGCCGGGUGUCAAACCGG,18,18,24,19,79
4804,26,AE007869.2/2703451-2703527,AAACGCCUCAGUGGUGAUUUGCCGACCGGCUUGCAGCCACUUUAAAGAAGUCGCUAAAGGGUCGAGGAAAAGGGCAA,23,14,23,17,77
4805,26,AL591688.1/3461766-3461843,CAAAUGAUCCGUGGUGAUUUGGCCGGCCGGCUUGCAGCCACGUUAAAGAAGUCGCUAAAGGGCCGAGGGAACAAUGGA,21,14,26,17,78
4806,27,AP006618.1/133448-133513,GACGAGCCCGGUGCGCGGGCUCCCGGACGAGGGGUGCCGUACCCGGAGUGCGACAAGACGGCCCGA,11,5,28,22,66
4807,27,CP000910.1/2096309-2096249,AAAGGGCCAAAGGCGCCCGGACGAGGUGCGCCGUACCCGGCCAGCGACAAGACGGCGUAAG,16,3,23,19,61
4808,27,CP000511.1/851388-851320,ACAGGCGUCGCGUGUUCCGGCGCCCCGGACGAGGUGCGUCGUACCCGGUCAGCGACAAGACGGCGCGAU,11,9,26,23,69
4809,27,AM849034.1/2863085-2863022,GAUGGGCGCCCAUCCGCGCUCCCGGACGAGGGAUCAGUACCCGGAACGCGACAAGACUGGCCAG,14,6,22,22,64
4810,27,ABJH01000172.1/10128-10201,CGCGCCCCCGCUUUGCUACGGUGGGGACACCCGACGAGACGCGCCGUACCGGGCUUUCGCAAAGACGACGCACC,13,9,23,29,74
4811,27,CP000113.1/4374426-4374485,CGUGAGGGUGUCUGGCCCGGACGAGGCGCGCCGUACCCGGUCAGGACAAGACGACGCGAC,11,6,24,19,60
4812,27,AM711867.1/3063871-3063808,GUCGGGCGCCCUCCCGCGCUCCCGGACGAGGGAUCAGUACCCGGAACGCGACAAGACUGGCCAG,12,6,22,24,64
4813,27,AM746676.1/8188359-8188291,GCGGCGCUCCUUCAGACAGAGCGUCCCGGACGAGACGCGCCGUACCCGGUCAGGAUAAGACGACGCAGC,15,7,23,24,69
4814,27,AP011115.1/5208127-5208067,AAAUCGUCGACACGACAUCCGGACGAGCGCACCGUACCCGGCCAGCGACAAGACGGUGCCC,16,5,17,23,61
4815,27,CP000580.1/1319367-1319304,GCCAUGUCACCAGUUGACACCGGACGAGCGGCACCGUACCCGGCCAGCGACAAGACGGCGCUUU,14,8,19,23,64
4816,27,CR628336.1/661276-661213,GAUAUGCUAUAAAAUAAUCUCCGGACGAGACGCGCCGUACCCGGUUAAGACAAGACGACGCCUU,20,12,15,17,64
4817,27,CP000656.1/85042-85109,GCAGGCGCCGUCGAUCCGGCGCCCCGGACGAGGUGUGCCGUACCCGGUCAGCGACAAGACGGCGCGUU,10,8,26,24,68
4818,27,CP000454.1/4240999-4241061,AGGCUUUCCCUUCCGGAGCCUCCGGACGACGGUUCAGUACCCGGCACGCGACAAGACUGGCCA,12,10,18,23,63
4819,27,CP000359.1/2285879-2285947,CGGUCGGCCUUAUAGGCUGCGCCCCGGACGAGAGCACCGCCGUACCCGGUCACGACAAGACGGCGCGGA,13,7,24,25,69
4820,27,BX842652.1/324410-324345,UCAGUUUCUGCGACUGAGGUGCCCGGACGAUGUGCGACGUACCCGGUCAGGACAAGACGACGCUUU,13,14,21,18,66
4821,27,ABJF01000294.1/7123-7044,GUAUGCCCUUUUGCUACGGUGGAGGGGAACCCCCGACGAGACGCGCCGUACCGGGUAGCUGGCUGAAAAGACGACGCACC,17,12,27,24,80
4822,27,CP001341.1/3865849-3865912,CCAAGGCUCCGCACCCGAGCCUCCGGACGACGGUUCAGUACCCGGCACGCGACAAGACUGGCCA,14,6,18,26,64
4823,27,AAMN01000002.1/564690-564754,UCAGAGCCUGGGACCAGGCUUCCGGACGAGGGGCGCCGUACCCGGCACGCGACAAGACGGCCCGC,12,5,24,24,65
4824,27,AE017354.1/593290-593227,GAUAUGCUAUAAAAUAAUCUCCGGACGAGACGCGCCGUACCCGGUUAAGACAAGACGACGCCUU,20,12,15,17,64
4825,27,CR628337.1/644770-644707,GAUAUGCUAUAAAAUAAUCUCCGGACGAGACGCGCCGUACCCGGUUAAGACAAGACGACGCCUU,20,12,15,17,64
4826,27,CP000325.1/3207260-3207196,ACAGAGCCUUGAUCAAGGCUCCCGGACGAUGGGUGCCGUACCCGGUGUGCGACAAGACGGCCCGG,13,9,23,20,65
4827,27,AL939114.1/119358-119291,CCUUUGCUACCUUGGGAAGCACCCCGACGAGACGCGCCGUACCGGGCUGAAGGCAAAGACGACGCACC,16,8,20,24,68
4828,27,AE016958.1/3831493-3831556,GUGCCGUCAGCAACUGACACCGGACGAGGGGCCCCGUACCCGGCCAGCGACAAGACGGCGCCGU,13,5,22,24,64
4829,27,CP000750.2/209444-209507,AGCGAACCCGGCGCAGGGUUCCCGGACGAGGGUGCCGUACCCGGUGUGCGACAAGACGGCCUGC,11,7,25,21,64
4830,27,CP000675.2/685132-685069,GAUAUGCUAUAAAAUAAUCUCCGGACGAGACGCGCCGUACCCGGUUAAGACAAGACGACGCCUU,20,12,15,17,64
4831,27,CP000854.1/3478073-3478137,ACAGAGCCUUGAUCAAGGCUUCCGGACGAUGGGUGCCGUACCCGGUGUGCGACAAGACGGCCCGG,13,10,23,19,65
4832,27,ABIN01000081.1/32257-32319,GAGACGUCAGCACCUGACACCGGACGAGGGGCCCCGUACCCGGCCAGCGACAAGACGGGCGCC,14,3,22,24,63
4833,27,CP000518.1/1318365-1318302,GCGAUGUCACCAGUUGACACCGGACGAGCGGCACCGUACCCGGCCAGCGACAAGACGGCGCUCA,15,6,20,23,64
4834,27,CP000088.1/1465653-1465596,CCCGAGCCUCAGCCCCGGACGAGGUGCGCCGUACCCGGUCAGGACAAGACGGCGCGGC,10,4,21,23,58
4835,27,AANZ01000001.1/452592-452651,UGCUUGGCAAUCUGCCCCGGACGAGACGCGCCGUACCCGGUUAUGUAAAGACGACGCCCU,12,11,17,20,60
4836,27,CP000480.1/1755118-1755055,GCGACGCCAGCACAUGGCACCGGACGAGGGGCGCCCGUACCCGGCCAGCGACAAGACGGGCCUC,13,3,23,25,64
4837,27,AAOB01000006.1/32110-32049,GGGUAGCUGCAACGACAGCUCCCGACGACGGAUCAGUACCGGGUACGCGACAAGACUGGCCA,16,7,20,19,62
4838,27,CP000479.1/4438905-4438968,GUGCCGUCAACAACUGACACCGGACGAGGGGCCCCGUACCCGGCCAGCGACAAGACGGCGCCGU,14,5,21,24,64
4839,27,CP000656.1/5615876-5615812,GCGGCGUCCAUUUCCGGAUGCCGGCGGACGAGGGAGCAGUACCCGCACAGACAAGACUGACUCGC,14,8,22,21,65
4840,27,CP000113.1/446679-446736,AGAUUGCAGCCCUGCCCGGACGAGAUGCGCCGUACCCGGUUACGUAAGACGACGCCCU,12,9,17,20,58
4841,27,CP000474.1/3894383-3894446,UGAAGGUUCCCCUCUGGAACCUCCGGACGACGGUUCAGUACCCGGCACGCGACAAGACUGGCCA,14,10,18,22,64
4842,27,CP001131.1/4934528-4934594,UGGCCGCGCGACCCCGCGCGACCCCGGACGAGGCGCGUCGUACCCGGUGACGACAAGACGACGCGAG,12,4,25,26,67
4843,27,ABJI02000500.1/27579-27638,UGCUACGUUGGAACGACCCCGACGAGACGCGCCGUACCGGGUAGGAAAAGACGACGCACC,16,6,19,19,60
4844,27,ACVP01000007.1/106973-107037,UUCGCCGCGGCUUGCGCGAGCCCCGGACGAGGGAGCCGUACCCGGCAACGCGACAAGACGGCCAG,12,5,24,24,65
4845,28,AE017355.1/1568663-1568707,AAUAACGUGGUUCGAAACCAUCCCACGUAAAAAAACUAAGGAGAU,20,8,8,9,45
4846,28,AE017355.1/1321429-1321472,ACGGGAGAGGUUCGCGAACUCCCUCUAUAAAAAACUAUGGAAAC,16,8,10,10,44
4847,28,AL766846.1/39196-39152,CUCGGACUGGUUCGAAAACUUCCCAGAAUAAAAAACUAAGUGACU,17,10,8,10,45
4848,28,AL596166.1/191853-191900,CCACACGUGGUUCAUUCAUACCAUCCCACGUAAAAAAACUAGGAGGAA,18,9,8,13,48
4849,28,X99978.2/10136-10181,CAAUACGUGGUUCGUAACCAUCCCACGUUAAAAAAACUAGGAGGAA,18,9,9,10,46
4850,28,AE016827.1/1848390-1848434,UAAUUCGUGGUUCGAAAACCUCCCACGCAAAAAAACUAAGGAAAA,20,8,7,10,45
4851,28,AASA01000045.1/1296-1252,UUAUUUGUGGUUCGUAAACCUCCCACACAAAAAAACUAAGGACAC,17,11,6,11,45
4852,28,CP000746.1/2223340-2223384,UUCAUCGUGGUUCGCAAACCUCCCACGCAAAAAAACUAAGGAAAU,17,9,7,12,45
4853,28,AAXV01000007.1/14855-14899,AGCACCGUGGUUCGUAACCAUCCCACGAAAAAAAACUAAGGAGAA,19,6,9,11,45
4854,28,AAXB02000001.1/142227-142271,CUUGAACUGGUUCGAAAACCUCCCAGUAUAAAAAACUAGGCAAAG,18,9,8,10,45
4855,28,CP000513.1/859945-859989,CCGCUUGUGGUUCGAAAACUUCCCACACUAAAAAACUAGGAAAAA,18,9,7,11,45
4856,28,AARF01000079.1/5363-5319,AUGGGAGAGGUUCGAGAUCUUCCCUCUAUAAAAAACUAAGGAGCU,15,11,11,8,45
4857,28,CP000233.1/1599957-1600001,CUUGGACUGGUUCGUAAACUUCCCAGUAUAAAAAACCAAGAAUCU,16,12,7,10,45
4858,28,BA000028.3/467676-467632,AUCACCGUGGUUCGUAACCAUCCCACGCAAAAAAACUAGGAAGGA,17,7,9,12,45
4859,28,AE017333.1/1501710-1501754,GCGGGAGAGGUUCUAGCAAAACCCUCUAUAAAAAACUAAGGAAAG,19,7,11,8,45
4860,28,CR936503.1/1598027-1597983,AAAAACGUGGUUCGUAACCAUCCCACGCUAAAAAACUAGGAGGAU,18,8,9,10,45
4861,28,ABDX01000003.1/184506-184550,UUGGUAGAGGUUCGUAACCAUCCCUCUAUAAAAAACUAAGGGCUG,14,12,10,9,45
4862,28,CP000414.1/1235047-1235002,AUAAUAGCGGUUCAUCAACCAUCCCGCUUAAAAAAACUAGGAGAUA,19,10,7,10,46
4863,28,AAYG02000018.1/120313-120357,UCUGGACUGGUUCGUGAACUUCCCAGUAUAAAAAACCAAGUAUCU,14,13,8,10,45
4864,28,ABCF01000001.1/139145-139189,GCAGGAGAGGUUCUAGCUUAACCCUCUAUAAAAAACUAAGGAAAC,18,9,9,9,45
4865,28,AE002098.2/329220-329176,CCGCCCGUGGUUCGAAAACCUCCCACAUUAAAAAACUAAGGAAAC,17,7,7,14,45
4866,28,AAAK03000099.1/1629-1673,CUUGGACUGGUUCGGAAACUUCCCAGAAUAAAAAACUAAGUAUCU,16,12,8,9,45
4867,28,CP000764.1/1180651-1180694,AUGGGAGAGGUUCGCGAACUCCCUCUAUAAAAAACUAUGAGAAC,16,9,10,9,44
4868,28,AAOX01000006.1/21305-21347,ACGGUAGAGGUUCUAGCUACCCUCUCAAAAAAACUAAGGAAAA,18,8,8,9,43
4869,28,BA000004.3/2373342-2373299,GUGAGAGAGGUUCGCGAACUCCCUCUAUAAAAAACUAAGGCAAG,16,8,11,9,44
4870,28,AP006627.1/2249570-2249527,AAAGAAGAGGUUCGCGAACUCCCUCUAUAAAAAACUAACCAAUU,19,9,6,10,44
4871,28,AM421808.1/1884627-1884671,CGCCCCGUGGUUCGAAAACCUCCCACACUAAAAAACUAAGGAAAC,17,6,7,15,45
4872,28,AAVO02000002.1/275638-275594,UCAUAACUGGUUCGAAACCCUCCCAGUAUAAAAAACUAGGUCAUG,16,11,7,11,45
4873,28,CP000029.1/370924-370878,AUAACAGAGGUUCCUAGCCGAAACCCUCUAUAAAAAACUAGACAUGA,20,9,7,11,47
4874,28,AP006716.1/2221258-2221304,UCAAAAGAGGUUCCUAGCUGAAACCCUCUAUAAAAAACUAGACAAUA,21,10,6,10,47
4875,28,AP008934.1/2076124-2076170,UAUAAAGAGGUUCCUAGCUGAUACCCUCUAUAAAAAACUAGACACAU,19,12,6,10,47
4876,28,AARM02000383.1/1741-1694,CCACACGUGGUUCAUUCAUACCAUCCCACGUAAAAAAACUAAGGAGGA,18,9,8,13,48
4877,28,AL009126.3/1439274-1439318,GCGGGAGAGGUUCUAGCUACACCCUCUAUAAAAAACUAAGGACGA,16,8,11,10,45
4878,28,AE004439.1/209165-209100,UUCAUAGUGGUUCGUAACCCUCCCACUUGAACAACCAACAAUUGUUCGAAACAAAACUAGGAAAAU,25,16,9,16,66
4879,28,AL935263.2/2519559-2519515,GCUGGCCUGGUUCGUAAACUUCCCAGGAUAAAAAACCAAGAACUU,15,10,9,11,45
4880,29,AL954747.1/2722783-2722598,CUGUUACAAUUUGCCGGUCAUUGGGGAGUAGCCGCUCUUCGUUUCGAAGGGGCUUACGUCAACAUACUUGACCGGCAGGUCAUGGCGUAAGCGGUUCUAAGCCUGGCAAGACCUUUGACCACAAUGCCUCCGAUUUGGCCGGGGAGGCGUUGUGGUCAAUCGUCUGUAAACCGGCCGGAGAACAUU,38,47,55,46,186
4881,29,CU207211.1/3280200-3280389,CUGCUAUCAUUCGCCCCGAACAUUGGGGAGUAGCCGGCCUUAGUCAACUAAGGGAUCUGCGUCAACAUUCUUGGCCCGCAGGCCAUGGUGCAGAUAGUCGCAAGACUUGGCGAGACCAUCGCUCAAAUGACGACCGCAUGGGCCGGGGUCGCUGUUUGCGCUUUGGUUAUUAUUCCGGCCCCAGAAAGUU,39,45,54,52,190
4882,29,AEGR01000046.1/5080-4892,UUGUUAGAAUGCGCCCCGUCAUUGGGGAGUAGCCGCUCUUCACCGCGAAGAGGCUUGCGUCAACACACUUGGUCCAUCGGACCAUGGCGCAGGCAGCUCCUGGCCUGGCAAGACCUUUGACCACGAAGCCUCCGUUUUGGCCGGGGAUGCGUCGUGGUCAAUCGUCUCUGUACACCGGCCUUGGACAUU,33,44,55,57,189
4883,29,CP000269.1/3948088-3948277,CUGCUAUCAUUACGCCUGAACAUUGGGGAGUAGCCGGCCUUUGGCAACAAAGGAAUCUGCAUCAACACUCUUGGCACGCAUGCCAUGGUGCAGAUAGUCGCAAGACUUGGCGAGACCAUUGAUCAAGUGACGACCGCAUGGGCCGGGGUCGUUGUUUGGUCUUUGGUUAUUCGUCCGGCCCGAGAAAGUC,42,46,55,47,190
4884,29,FP929140.1/858523-858335,CUGAUAUACUUCGCUGGUCAUUGGGGAGUAGCCGAUCUUCGCACUGAAGAUGCUUACGUCAACACACUUGGCCCACAGGCCAUGGCGUAAGCGGUUCACACGCUUGGCAAGACCUUUGACCACAACGCCUCCGUAUUAAGGCUGGGGAUGCGUCGUGGUCAAUUGUGUCUAAUCCAGCCUGAGAAUCGU,42,47,50,50,189
4885,29,CP001013.1/98070-98260,UCGCUAUACUCGCGGCGCUUUCGUCAUUGGGGAGUAGCCGCCCUGCGCCCGCAGGGGUUCGCGUCAACACACUUGACCCUCACGGUCAUGGCGCGAACAGCUCCAGAGCCUGGCAAGACCUUUGACCACACUGCCUCCGGAAGGGCCGGGGAUGCCGUGUGGUCUCUGGUAUUCGCUGGCCCUUGGAGAUC,30,40,59,62,191
4886,29,AM406670.1/393403-393588,UCGCUAAUAUCCGCGCCUUCAUUGGGGAGUAGCCGCCCUUCACCGUGGUGAAGGGGCUUGCGUCAACACACUUGGCCGUCCGGCCAUGGCGCAAGCAGUUCCUGGACUUGGCAAGACCUUUGAUCACGAUGCCUCUGGUAUGGCCGGGGAGGCGCGUGGUCAUCGGUUGUACCGGCCAGGGAUCAU,31,42,60,53,186
4887,29,CP000155.1/3815875-3815690,UUGCAUUAGUAUGCCCGGCGUCACUGGGGAGUAGCCUCUCUUCGCCCUGAAGAGGUUUGCGUCAACAUACUUGGCCCACAGGCCAUGGCGUAAACGGUUCCAUAACUUGGCAAGACCUUUGACUAUGCCGCACCGGUUGGGCCGGGGCGUGGCGUAGUCAUAUGGUUAAUCCGGCCCAGGAGAUUU,36,46,55,49,186
4888,29,ABSP01053999.1/668-852,CCGGUAGAAUCGCGCGGUCAUUGGGGAGUAGUCGCCCUCUACCCAGAGGGGCUUGCGUCAACAUACUUGACCGAUUGGUCAUGGCGCAAGCGGUUUCCUAGCUUGGCGAGACCUUUGACCAUAUCGCCUUCGGACUGGCCGGAGAAGCGGUGUGGUCAUUUGUCUUCUUCCGGCCAGGGAGCACC,32,44,58,51,185
4889,29,CP000555.1/403908-404093,AAUCGCGGCUCCCACCCGUCAUCGGGGAGUAGCCGCCCUGCAUCCGUUGCAGGGGCUCGCGUCAACACACUUGGCCUGCAGGCCAUGGUGCGAGCAGCUUCCACAGCCUGGCAAGACCUUUGACCGCACAGCCUCCGCGUGGCCGGAGAGGCCGUGUGGUCAUUGCGUCAUCCGGCCCAGGACCUC,30,32,57,67,186
4890,29,CP000089.1/2431458-2431642,UCGAUAGAAUGUUCCUGAGUCAUUGGGGAGUAGCCGCUCUUCAAUCUGAAGAGGCUUGCGUCAACAUACUUGGUCAUUCGACCAUGGCGUAAGCGGUUUCUGCUUGGCAAGACCUUUGACCAUACUGCCUUCCGAAUGGCCGGGGAGGUGGUGUGGUCAUUCGUCGAAUUCCGGCCAAGGAAACC,39,49,53,44,185
4891,29,CP000450.1/221379-221198,CUGGUACAAUUUUCAGGUCAUUGGGGAGUAGCCACUCUUUAUCACAAAGAGGCUUACAUCAACAUACUUGACCCACAGGUCAUGGUGUAGGCAGCCCUUCGCCUGGCAAGACCUUUGACUGCGAUGCUUCCACUAGGCCGGAGAUGUAUCGUGGUCAAUCGUCUUUUCCGGCCAGGAAAUUC,42,49,44,47,182
4892,29,AFQG01000103.1/17144-17325,CCGAUAUAAUCUAGCCAUCACUGGGGAGUAGCCGCUCAUUUUCCUGAGGUUUACGUCAACAUACUUGAUGCAUGCAUCAUGGCGUAAACAGCGAUAUCGCUUGGCAAGACCUUUGAUCACUUUUUUCCGUUCAGACCGGAGGAAAAGGUGAUCAUUCGUCUAUUGUCCGGUCGCGGUAUUGA,43,54,43,42,182
4893,29,ADNR01000005.1/164179-163991,CCGUUAGAAUCGCCCGGUCACUGGGGAGUAGCCUUCCUUCAUCCUUUGAAGGAGAACGCGUCAACAUACUUGGCCUCGUAGGUCAUGGCGCGUUCGACCGUGUCGGUUUGGCGAGACCAUUGACGCACUGCCUCGUUCUGGUCGGACGGGCGGCGGUGCGUCAUUGGUUUGUCAUCUACGUCCGACCGC,29,48,58,54,189
4894,29,ADGO01015088.1/632-820,CGUGUAUGCUCCCGCCCCGUCAUUGGGGAGUAACCUCCUGCGGCGUUACGCCGCCGGGCUUACAUCAACACACUUGGCCGGUUGGGCCAUGGUGUAAGCGGCUUCAGUGCUUGGUGAGACCUUUGAUCAUGUCGUUCCGGUAUGGGCCGCGGACGGCGUGGUCAAUUGUGUCCUCCGGCCCUGAACGCU,26,47,60,56,189
4895,29,ABCT01000004.1/172288-172470,CGGUUAACAUACCAUCACUCAUUGGGGAGUAGCCUCCUUUUCUCGAAAAGGGCUUGCAUCAACAUACUUGGCCCAAAAGCCAUGGUGCAAGCGGUUUCCACACUUGGCAAGACCUUUGACUGCAUUUCCACCGCUUCGGCCUGGGUGGAAUGUGGUCAUUUGGUUCUCAAGGCCGUGGAAUUU,40,51,45,47,183
4896,29,CP000270.1/4748060-4747865,CCGUUAGAAUCCCCCGGUCACUGGGGAGUAGCCUUCCUUCAUCGUUUGAAGGAGAACGCGUCAACAUACUUGGCCUUGCAGGUCAUGGCGCGUUCGGCCGUGUCGGUUUGGCGAGACCAUUGACGCACUGCCUCGUUCUGGUCGGACGGGCGGCGGUGCGUCAUUGGUUUGUCGUCUACGUCCGACCGUGGAGUUG,28,51,64,53,196
4897,29,CP001052.1/4299894-4299707,CCGUUAAAAUCCCCCGGUCACUGGGGAGUAGCCUUCCUUCAUCCAUUGAAGGAGAGCGCGUCAACAUACUUGGCCUGCGGGUCAUGGCGCGUUCGACCGGGUCGGUUUGGCGAGACCAUUGACGCACUGCCUCGUUCUGGUCGGACGGGCGGCGGUGCGUCAUUGGUUUGUUAUCGACGUCCGACCGC,29,45,60,54,188
4898,29,CR555306.1/995584-995774,CCGGUAGAAUUCGCGCCGUCAUCAGGGAGUAGCCGCCUGCGAGCCUUCGCAGGGACCACGUCAACAGACUUGCGCGUCGCGCAUGGCGUGGCCAGCCUUCGGGCCUGGCGAGACUUUUGGCUGCAUGCCCUCCGAUUUUUCGGGCCCGGGAGGCGUGCGGUCAUCGGUCAUCAGCCGGCCCGGAGAACCUG,28,36,65,62,191
4899,29,CP002021.1/2050633-2050454,ACACUAAAAAUAGUCAUUGGGGAGUAGCUGCCCUCCGAAUGCGAGAGGGACCUGCGUCAACAUACUUGCCUCACAAGGCAUGGCGCUGGUGAUUCCAUAUUUGGCAAGACCUUUGACCGAAGCGCCUCCGUUGGGCCGGAGAAGCGUUCGGUCAUUGUGUUCUUCCGGCCCGGAGUCAUC,39,42,51,48,180
4900,29,AACY020053177.1/876-690,UUGUUAUAAUUUAAAUGUCACUAGGGAGUAGCUUCUCUUCUCUACAGAAGAUGGCUUACAUCAACAUACUUGAGCUUAGGCUUAUGGUGUAAGCGGUUUAAAUACUUGGCAAGACUUUUGACUACAAACACUUACUUAGGCUGUGGGUGCGUUGUAGUCAUUUGUUUAUGUCACAGCCUAGAGGACU,49,65,41,32,187
4901,29,CP001616.1/2283380-2283567,UCGUUAUACUGCGCCGGUCAUUGGGGAGUAGCCUCCUUUAGGGUUUGCAUCAACAGACUUGACCCUCACGGUCAUGGUGCAAACAGUGAUUCGUCAUUAAAACGGAUACACCUGGCAAGACCUUUGACCAUACCCUGUGCGGCCGGACAGGUGUGUGGUCAAUGGAAGUUUUCCGGCCAUGGAGUAUC,42,49,51,46,188
4902,29,AEWG01000141.1/70250-70056,CUAGAAUCGCGCCCGCACUCGUCAUCGGGGAGUAGCCGCCCUGCCGCCCGGCAGGGGUCCGCGCCAACACGCUUGGCCCUCAGGGGCCAUGGUCCGGACAGCCCCCAGCCUGGCAAGACCGCUGACUGCGCCGCCUCCGAAUGGGCCGGGGUCGCGGCGUGGUCAAGCUCCGGUCAUGCCGGCCCGUAUCGGAUU,27,28,66,74,195
4903,29,CP000103.1/662385-662565,CAAGUAGAAUAUUCCGGUCAUCGGGGAGUAGCUUCCUUCCGUCGAAUAGAAGGGCUUGCAUCAACAUACUUGACCCGUGGUCGUGGUGCAAGGAGUUCGUGCCUGGCAAGACCUUUGACCACAUUGUCUCCGGAAGGGCGGGGAGAAGCCUGGUCUCGCUUCUUGUCCGGCCUGGAGCGUA,36,44,56,45,181
4904,29,AF270169.1/2621-2476,AAAACUGUCAGAGGGGAGUAACUUGAGAAUAGUUAUUGAAUGCAUUUAAACCGAUAAUAACUAUUCAACACUUUGUCGUCAUUACGAAGAUAAGUCUUCCGGUAAAGUGGGCAAAAAUAUUGCUAAGUGAGACCUUUGCUAUUAAA,53,43,29,21,146
4905,29,AL591977.1/131463-131588,ACAAAUGUCAGAGGGGAGUAGCGCUGAUUAGCUUUUUAAUCAGGAUAAAGUCGUCAUUACAUGAUAGAGAUAUCAUCGGUUUUAUCACAUUUAACUUUAAAUGUUAGCGAGACCUUUGCCUUUACG,38,42,26,20,126
4906,29,AF109909.2/85-201,UUACGGAGUAAAGGGGAGUAGCGUCAGGGAAACCUGAAACAAAGUCGUCAUUACAUGGAGUAUUCCAUCGGCUUUGUUGGCAUAAUGAUUAUGCUUAGCAAGACCUUUGCCAUAUUU,34,34,29,20,117
4907,29,Y14370.1/1315-1188,CAUUUUGUCAGAGGGGAGUAACUUAAGAAUCAUGACCGUAUAAAUGAUUCGACACUUUAUCGUCAUUACGAAGAUAUCUUCCGGUAAAGUGGGCAAUUAAAUUGCUUAGUGAGACCUUUGCUAUUUAU,39,43,26,20,128
4908,29,AL596167.1/48063-48187,ACAAAUGUCAGAGGGGAGUAGCGCUGAUUAGCUUUUAAUCAGGAUAAAGUCGUCAUUACAUGAUAGAGAUAUCAUCGGUUUUAUCACAUUUAACUUUAAAUGUUAGCGAGACCUUUGCCUUUAUG,38,42,26,19,125
4909,30,BABG01013292.1/257-357,GAGCAACUUAGGAUUUUAGGCUCCCCGGUGCGUCUCGAACCGCGCCGGGCCAAACCCACAGGGGCUGGCGGUCCUGUGCGGUCAAAAUCUUUCCGCUGGAG,18,20,32,31,101
4910,30,BABD01012433.1/319-419,GAGAAACUUAGGAUUUUAGGCUCCGCUGCCGGCUGCUGGUCGGCAGCGCAAACCCCGCAAGGCUGGCGGUCUUGCGCGUGGUCAAAAUCUAUCCGCCGGAG,19,20,33,29,101
4911,30,FP929046.1/562024-562125,GAGCAACUUAGGAUUUUAGGCUCCCCGGUGCCACUCGAGCGGCGCUGGGCAAAACCCACAGGAGCUGGCGGUUCCUGUGCGGUCAAAAUCAAACCGCUGGAG,23,18,32,29,102
4912,30,BAAY01013224.1/926-826,GAGCAACUUAGGAUUUUAGGCUCCCCGGCGUGUCUCGAACCAUGCCGGGCCAAACCCAUAGGGCUGGCGGUCCCUGUGCGGUCAAAAUUCAUCCGCCGGAG,20,20,30,31,101
4913,30,FP929045.1/1765647-1765748,GAGCAACUUAGGAUUUUAGGCUCCCCGGCGUGUCUCGAACCAUGCCGGGCCAAACCCACGGGGGCUGGCGGUCCCCGCGCGGUCAAAAUCAAACCGCUGGAG,21,16,32,33,102
4914,30,BAAX01019688.1/382-483,GAGCAACUUAGGAUUUUAGGCUCCCCGGCGUGUCUCGAACCAUGCCGGGCCAAACCCACGGGGGCUGGCGGUCCCCGCGCGGUCAAAAUCAAACCGCUGGAG,21,16,32,33,102
4915,30,BAAY01002983.1/1264-1163,GAGCAACUUAGGAUUUUAGGCUCCCCGGCGUGUCUCGAACCAUGCCGGGCCAAACCCACGGGGGCUGGCGGUCCCCGCGUGGUCAAAAUCAAACCGCUGGAG,21,17,32,32,102
4916,30,ADJS01009939.1/10976-11077,GAGCAACUUAGGAUUUUAGGCUCCGCCGUCUCCCCUGCGGGAGGCGGCGCAAACCCCGCAAGGCUGGCGGUCUUGCGUGCGGUCAAAAUCUAUCCGCCGGAG,18,19,33,32,102
4917,30,ADJS01012726.1/612-517,GAGCAACUUAGGAUUUUAGGCUCCACCGCGGCUUGCUGCGGUGCAAACCCCGCAAGCCUGGCGGUCUUGCGCGCGGUCAAAAUCUAUCCGCCGGAG,18,19,29,30,96
4918,30,BAAZ01007046.1/1247-1147,GCAACUUAGGAUUUUAGGCUCCCCGUGCGUGUCUCGAACCAUGCCGGGCCAAACCCACGGGGGCUGGCGGUCCCCGUGCGGUCAAAAUCAAACCGCUGGAG,20,18,31,32,101
4919,30,BABA01010993.1/1076-1176,GAGCAACUUAGGAUUUUAGGCUCCCCGGCGUGUCUCGAACCAUGCCGGGCCAAACCCACAGGGGCUGGCGGCCCUGUGCGGUCAAAAUCAUCCCGCUGGAG,20,18,31,32,101
4920,30,BAAY01002380.1/1139-1039,GAGCAACUUAGGAUUUUAGGCUCCCCGGCGUGUCUCGAACCAUGCCGGGCCAAACCCACAGGGGCUGGCGGCCCUGUGCGGUCAAAAUCAUCCCGCUGGAG,20,18,31,32,101
4921,30,BABA01026116.1/736-636,GAGCAACUUAGGAUUUUAGGCUCCCCGGUGCGUCUCGAACCGCGCUGGGCCAAACCCACAGGGGCUGGCGGCCCUGUGCGGUCAAAAUCAAACCGCUGGAG,21,17,32,31,101
4922,30,BABA01018694.1/413-513,GAGCAACUUAGGAUUUUAGGCUCCGCUGCCGGCUGCUGGUCGGCAGCGCAAACCCCGCAAGGCUGGCGGUCUUGCGCGUGGUCNAAAUCUAUCCGCCGGAG,17,20,33,30,101
4923,30,AECU01000177.1/7590-7690,GAGCAACUUAGGAUUUUAGGCUCCCCGGCGUGUCUCGAACCAUGCCGGGCCAAACCCACAGGGGCUGGCGGCCCUGUGCGGUCAAAAUCAUCCCGCUGGAG,20,18,31,32,101
4924,30,ADJS01009870.1/10212-10312,GAGCAACUUAGGAUUUUAGGCUCCCCGGCGUGUCUCGAACCAUGCCGGGCCAAACCCACAGGGGCUGGCGGCCCUGUGCGGUCAAAAUCAUCCCGCUGGAG,20,18,31,32,101
4925,30,BAAX01000750.1/3091-2990,GAGCAACUUAGGAUUUUAGGCUCCCCGGUGCCACUCGAGCGGCGCUGGGCAAAACCCACAGGAGCUGGCGGUUCCUGUGCGGUCAAAAUCAAACCGCUGGAG,23,18,32,29,102
4926,30,ADJS01011583.1/9082-9183,GAGCAACUUAGGAUUUUAGGCUCCCCGGUGCCACUCGAGCGGCGCUGGGCAAAACCCACAGGAGCUGGCGGUUCCUGUGCGGUCAAAAUCAAACCGCUGGAG,23,18,32,29,102
4927,30,BAAX01000347.1/2947-2847,GAGCAACUUAGGAUUUUAGGCUCCCCGGCGUGUCUCGAACCAUGCCGGGCCAAACCCAUAGGGCUGGCGGUCCCUGUGCGGUCAAAAUUCAUCCGCCGGAG,20,20,30,31,101
4928,30,BAAV01004919.1/1075-1175,GAGCAACUUAGGAUUUUAGGCUCCCCGGCGUGUCUCGAACCAUGCCGGGCCAAACCCAUAGGGCUGGCGGUCCCUGUGCGGUCAAAAUUCAUCCGCCGGAG,20,20,30,31,101
4929,30,ABED02000027.1/116756-116655,GAGCAACUUAGGAUUUUAGGCUCCCCGGUGCCACUCGAGCGGCGCUGGGCAAAACCCACAGGAGCUGGCGGUUCCUGUGCGGUCAAAAUCAAACCGCUGGAG,23,18,32,29,102
4930,30,ADJS01012663.1/5165-5065,GAGCAACUUAGGAUUUUAGGCUCCCCGGCGUGUCUCGAACCAUGCCGGGCCAAACCCAUAGGGCUGGCGGUCCCUGUGCGGUCAAAAUUCAUCCGCCGGAG,20,20,30,31,101
4931,30,ACOP02000046.1/22370-22270,GAGCAACUUAGGAUUUUAGGCUCCCCGGCGUGUCUCGAACCAUGCCGGGCCAAACCCAUAGGGCUGGCGGUCCCUGUGCGGUCAAAAUUCAUCCGCCGGAG,20,20,30,31,101
4932,30,ADJT01005830.1/328-228,GAGCAACUUAGGAUUUUAGGCUCCCCGGCGUGUCUCGAACCAUGCUGGGCCAAACCCAUAGGGCUGGCGGUCCCUGUGCGGUCAAAAUUCAUCCGCCGGAG,20,21,30,30,101
4933,30,ACBY02000013.1/114529-114434,GAGCAACUUAGGAUUUUAGGCUCCGCCGCAGCUUCCGCGGCGCAAACCGGUGUCAGGCUGGCGGUCUGGCAUGCGGUCAAAAUCUAUCCGCCGGAG,18,19,31,28,96
4934,30,BAAU01020333.1/1-83,GGCUCCGCUGUCGGCUGCUGGUCGGCAGCGCAAACCCCGCAAGGCUGGCGGUCUUGCGUGUGGUCAAAAUCUAUCCGCCGGAG,12,16,29,26,83
4935,30,ADJT01007369.1/6381-6474,GAGCAACUUAGGAUUUUAGGCUCCGCCUGGUUUUCAGGCGCAAACCCACCCAAGCCUGGCGGUCUUGGGCGCGGUCAAAAUCUAUCCGCCGGAG,19,20,27,28,94
4936,30,ADJS01013861.1/2134-2227,GAGCAACUUAGGAUUUUAGGCUCCGCCUGGUUUUCAGGCGCAAACCCACCCAAGCCUGGCGGUCUUGGGCGCGGUCAAAAUCUAUCCGCCGGAG,19,20,27,28,94
4937,31,ACHK01000062.1/4026-4119,UUGUUACAAGUUCCCGAAAGGAUUUAGCAAGUAAUUGUCGUUACUUACUAAAGAUGCCUUGUAACCGAAACUAUUUAGGGGGAAUAACAUUAUG,31,30,19,14,94
4938,31,ACBD01000055.1/1906-1985,GUUCGUUGCAAGUUCCCGAAAGGAUCCGUAGGACGGAGAUGCCUUGUAACCGAAUUUAACUAGGGGGAAUCAUUAUAAUG,23,21,22,14,80
4939,31,ACAJ01000030.1/519-601,GUCCGUUGCAAGUUCCCGAAAGGAUUCGCAGCUGCGAAGAUGCCUUGUAACCGAAUCGAAAUUUAGGGGGAAUACAAAAAAUG,27,18,22,16,83
4940,31,ACAO01000044.1/534-615,GUCCGUUGCAAGUUCCCGAAAGGAUUCGCAGCUGCGAAGAUGCCUUGUAACCGAAACAUAUAUUAGGGGGAAUACAAAAAUG,27,18,21,16,82
4941,31,AE017198.1/564018-564088,UUCGGUUAAGGUCCCGAAAGGAUUCGUUUUUAACGAAGAUGCCUUGUAACCGAAAGAUGGGGGACUCUAUG,19,20,20,12,71
4942,31,CP000233.1/487061-487146,AAUAGUUACAAUCCAUUCCCGAAAGGAUUCGUUUUAAACGAAGAUGCCUUGUAACCAAAUUACUUAUAAUAAUGGGGGAAUUAAAU,33,26,14,13,86
4943,31,ACLL01000026.1/19090-19198,CUUCGUUAUGAAGCAAAUUCCCGAUAGGAUUCACUUAAUUGUGAAGAUGCCUUGUAACCGCAACUACAAAACUACUACUAGAGUUUCGACUAGAAUAUGGGGGAAUUAA,37,31,21,20,109
4944,31,ACGV01000186.1/13246-13351,UCUCGUUAUAAAGCAAAUUCCCGAUAGGAUUCACUUUACUGUGAAGAUGCCUUGUAACCACUAAAUGUUUCAAUUGUAACUUGCAUAUGGGGGAAUUAACACACAU,34,34,18,20,106
4945,31,CP000422.1/681467-681547,GUAAGUUACUAGUGUUCCCGAUAGGAUUAGUUAUCCAAAAGAUCCUUGUAACCGAAAUUAAAUUUAGGGGGAAUUUACAUG,27,26,17,11,81
4946,31,ACIZ01000041.1/43695-43782,UAGAGUUGCAAUACAUUCCCGAUGGGGUUCGUUAGCGAUUAACGAACAUGCCUUGUAACCGAAAAUCAUGAGGGGGAAACAAACGAUG,29,20,23,16,88
4947,31,FM177140.1/914403-914491,UAGAGUUGCAAAACAUUCCCGAUGGGGUUCGUCAAAGCUAUGACGAACAUGCCUUGUAACCUAAAAUAAUAAGGGGGAAACAAAACAUG,34,19,20,16,89
4948,31,CP000413.1/483009-483080,UUCGGUUAAGGUCCCGAAAGGAUUCGCUUUUUAACGAAGAUGCCUUGUAACCGAAAGAUGGGGGACUCUAUG,19,20,20,13,72
4949,31,CP000517.1/1692576-1692488,UAUCGGUUCAAGUCCUGAAAGGAUUCACUAUUAUUAGUGAAGAUGCCUUGUAACCGAAUAGCUAAUGUCUAUAUGGGGGGACUAUUAUG,26,29,21,13,89
4950,31,ACIL02000003.1/164571-164483,GUCAGUUACAACAAUAAAUUCCCGAUGGGAUUCAUUUUCUUAAUGAAGUUGCCUUGUAACCAAUCUACAAAAUGGGGGAAAUUACUAUG,30,28,16,15,89
4951,31,CP000033.3/1626537-1626447,UAUCGGUUCAAGUCCUGAAAGGAUUCAUUAAAUAAUUAGUGAAGAUGCCUUGUAACCGAAUAGCCGAUGUCUAUAUAGGGGGACUAAUAUG,30,27,21,13,91
4952,31,ACGH01000133.1/29066-28984,GUAGGUUAUGAGUUCCCGAUAGGAUUCACGCCAGACGUGAAGAAGCCUUGUAACCUAAAAAAUAUAUAGGGGGAAAUAAAAUG,31,19,21,12,83
4953,31,ACLN01000012.1/57665-57589,UACGGUUAAGGUCCCGAGAGGAUUCGAAAUUCGAAGAUGCCUUGUAACCGAUUUUUUAAAGGGGGACUUCUAUUAUG,21,24,20,12,77
4954,31,CR954253.1/1355763-1355676,AUUUGUUACAAGUCCUGAUAGGAUUCACCAAAUUGGUGAAGAUGCCUUGUAACCGUGUAGCUAGUCUAUAGGGGGACACAUAUAGAUG,26,26,22,14,88
4955,31,ACKR01000001.1/1180-1268,UAUCGGUUCAAGUCCUGAGAGGAUUCACUAUGAUUAGUGAAGAUGCCUUGUAACCGAAUAGCCAAUGUCUAUAUAGGGGGACUAAUAUG,27,26,22,14,89
4956,31,ABHH01000037.1/13513-13426,GAGGUUUGCAAUUCGGAUUCCCGAGAGGAUUCACUUUUAAAGUGGAGAAGCCUUGUAACCGAAAAUUUAAAGGGGGAACAAAGUAAUG,30,22,24,12,88
4957,31,ACKZ01000012.1/36527-36446,AAAAGUUAAAAAUGAUAUUCCCGAAAGGAUGCACCAUGUGUAGAUGCCUUGUAACCGGAAUUGAAUGGGGGAAAAAGAAAUG,33,18,21,10,82
4958,31,AF401669.1/1455-1540,UAGAGUUAUAAGAAGUUCCCGAUAGGAUUCACACACCGUGAAGAGGCCUUGUAACCGACACAUAUAUAGGGGGAAACAUAGAAAUG,32,18,21,15,86
4959,31,ACGU01000017.1/23671-23581,UAUCGGUUCAAGUCCUGAUAGGAUUCAUUACUUAGUUAAUGAAGAUGCCUUGUAACCGGAUAGCCAAUGUCUAUAUAGGGGGACUAAUAUG,27,29,21,14,91
4960,31,ADEX01000093.1/3153-3076,AUCGGUUCAAGUCCUGAUAGGAUUCGUUAUACGAAGAUGCCUUGUAACCGAAUAGCUUGUCUAUAGGGGGACAUUAUG,21,24,20,13,78
4961,31,CP003032.1/1501869-1501780,AAGCGUUACAACUCAUUCCCGAUAGGAUUCACGCUUUUAGUGAAGAUGCCUUGUAACCACAAAUAUAAUGAAUGGGGGAAUUUUAUUAUG,29,28,18,15,90
4962,32,AF270378.1/2268-2051,UUAAUAAUUAAAGCGCCUGUGCAAAAUACCUAAAUAGUUAUCAAGUAUUAAAAGUUAAAAUAGUAGAACUUUUAUAGAUAACGAUUUGGAUUUUGUAGACGAGGAGGAUAGUGAUCGAAUCAGAUCGGCGGAUGCUAUCCCGGAUGUGGCACAUUCGUUAGCUUAUUAAGUAAAUCAUUAAGGUGACUUAGUGGACAAAGUUAAUAAGAUCGCCAAAC,79,64,46,29,218
4963,32,AB006424.1/2989-3156,CCUAUAAUUAUAGCGCCCGAACUAAGCGCCCGGAAAAAGGCUUAGUUGACGAGGAUGGAGGUUAUCGAAUUUCGCGGAUCCUCCCGGCUGAGUGUGCAGAUCACAGCCGUAAGAAUUUCUUCAAACCAAGGGGGUGACUCCUUGAACAAAGAGAAAUCACAUGAUCUU,50,38,42,38,168
4964,32,AC078934.3/32621-32405,AGUACAGUUAAAGCGCCUGUGCAAAUAAAUAUUUGUAUUUGAAGAUUAAAGGUUAAUAUAUGAGUGGCCUUUAUAGAGUGCAAUAUAUGUAUUUGUAGACGAGGAGGAUAGUGAUCGAAUAGAUCGGCGGAUGCUAUCCCGGAUGUGGCUCAUUCGUUAGCUUAUUAAGUAAAACAUUAGGGUGACUUAAUGGACAAAGUUAAUAAGAUCGCCAGAA,73,65,53,26,217
4965,32,AL596166.1/50734-50929,AACUGAAUAGAAGCGCCAGAACUGAUUGGGACGAAAAUGCUUAAAGGUGAAAUUCCUGGAAAGUAAACAAUCAGUUGACGAGGAGGAGAUUAAUCGAAAUUUCGGCGGGAGUCUCCCGGCUGUGCAUGCAGUCGUUAAGUCUUACUUACAAAUCAUUUGGGUGACCAAGUGGACAGAGUAGUAAUGAAACAUGUGC,65,46,53,32,196
4966,32,CP000557.1/163698-163870,GACGACAAAAAAGCGCCUGGACUAAGCGCGGGAACGGACGCGCGCUUAGUUGACGAGGAGGAGGUUUAUCGAGGUUUUCGGCGGAUGCCUCCCGGCUGGAGCGAUGACAGCCGCAAGUCCUCUCUUAAAACAAAGGGGUGACCCUUUGGACAAAGGGGAGGAUGUCAUCGCAC,44,30,58,41,173
4967,32,AE016830.1/2055460-2055313,CAAUAUCGGAUAGCGCCAGACCUGAACGUUCAGGUGACGAGGAGAGAGCUUAUCGAAGAUUCGGCGGGUGGCUCUAGGGACUGCACUCUACAGAUAACAAAGAAAAACUAAUUGUGAAGUUAGAACAAAGCGGUUAUCACGCAGGUAG,49,29,42,28,148
4968,32,AE001437.1/179915-180075,AUUAUAGUUAAAGCGCCCGAACUUGAGUGAUAUAGUUCAUUUAAGUUGACGAGGAUGGGGAGAAUCGAAUCUUCGGCGGAUGCCCCACGGUACCGCACUACCGUUAGCGGUUGGUAAAAGCAGAAAGUGAUUUCUGUCACAAAGCCAAUCUGGUGUUAAAA,48,41,42,30,161
4969,32,AE017333.1/183152-183325,UUUAUAGUUAUAGCGCCCGGACUAAGCGUACGGAUGAAACAGCUUAGUUGACGAGGAUGGAGGUUUAUCGAAUUUUCGGCGGAUGCCUCCCGGCUGACCUCAAAGAUCACAGCCGCAAGGAUUUCCUCAAACCAAAGAGGCGACUCUUUGAACAAAGGGAAAUUGCAUGAUCUU,50,42,44,38,174
4970,32,AM263198.1/720655-720850,AAUUAAAUAGAAGCGCCAGAACUGAUUGGGACGAAAAUACUUGAAGGUGAAAUUCCUGAAAAGUAACGGUCAGUUGACGAGGAGGAGAUUAAUCGAAAGUUCGGCGGGAGUCUCCCGGCUGUAGCAUGCAGUCGUUAAGUCUUACUUACAAAACAUUUGGGUGACCAAAUGGACAGAGUAGUAAUGAAAUAUGUGU,67,47,53,29,196
4971,32,BA000043.1/166978-167147,GACGAGACAAAAGCGCCUGGACUAAGCGUUGGACGGAAGAACGCUUAGUUGACGAGGAGGAGGUUUAUCGAGGUUUUCGGCGGAUGCCUCCCGGCUGGAGCGAUGACAGCCGCAAGUCCUCUCUUAAAACAAAGGGGUGACCCUUUGCACAAAGGGGAGGAUGUCAUCGC,44,32,56,38,170
4972,32,AP008934.1/759374-759589,AGUUCAAUUAAAGCGCCUGUACAAGUGAAGAGGUUAUGUGUUUGUAAUUUAAGGUUUAUAACAGAAAUCUUAAUAGACACGAUAAUCGAAGUUUGUAGACGAGGAGGGUAGUUAUCGAACCAUCGGCGGAUGCUAUCCCGGAUGUGGCUCAUUCGUUAACUUAUUAAGGAAAACAUUAGGGUAACCUGGUGCACAAAGUUAAUAAGAUAGCCAAAA,74,60,51,31,216
4973,32,AP006716.1/888948-889158,AUAAAUUAUAAAGCGCCAGGGCAAAAUAUAAGUGUACCUAUAAUCAAAAGUUAAAUAUGAGAGCUUUUGUAGGGCAAUUUAUUUCUUUGCAGACGAGGAGAAUAGUCAUCGAAAAUAUCGGCGGAUGCUAUUCCGGAUGAGGCUCAUUCGUUAGCUUAUUAUUUAAAACAUUUAGGUAACUAAAUGCACAAAAAUAAUAAGAAUGCCUAAA,81,61,40,29,211
4974,32,AE017262.2/770944-771139,AAUUAAAUAGAAGCGCCAGAACUGAUUGGGACGAAAAUACUUGAAGGUGAAAUCCCUGAAAAGUAAACAGUCAGUUGACGAGGAGGAGAUUAAUCGAAGUUUCGGCGGGAGUCUCCCGGCUGUGCAUGCAGUCGUUAAGUCUUACUUACAAAUCACUUGGGUGACCAAGUGGACAGAGUAGUAAUGAAACAUGUUU,65,47,52,32,196
4975,32,CP000924.1/498335-498489,AAAAUUUAAAAAGCGCCUGGGCUUAAAGUGUAUACUUUAAGCUGACGAGGACAGGGUUUAUCGAGUUAUCGGCGGGUGCCCUGCGGUUUCCUGCGACCGAUAAAGGACUGGUAAAACCACAGGCGACUGUGGCAUAGAGCAGUCUGGGCAGGGAG,42,34,49,30,155
4976,32,AE008691.1/2101605-2101448,UUUAAUUUAGAAGCGCCUGGACUUAAAGCCUUAAGGCUUUAAGUUGACGAGGGCAGGGUUUAUCGAGACAUCGGCGGGUGCCCUGCGGUCUUCCUGCGACCGUUAGAGGACUGGUAAAACCACAGGCGACUGUGGCAUAGAGCAGUCCGGGCAGGAAA,39,35,50,34,158
4977,32,AARQ02000011.1/391-585,AAUUGAAUAGAAGCGCCAGAACUGAUUGGGACGAAAAUGCUUGAAGGUGAAAUCCCUGAAAAGUAUCGAUCAGUUGACGAGGAGGAGAUUAAUCGAAGUUUCGGCGGGAGUCUCCCGGCUGUGCAUGCAGUCGUUAAGUCUUACUUACAAAUCAUUUGGGUGACCAAGUGGACAGAGUAGUAAUGAAACAUGCUU,61,48,54,32,195
4978,32,CP001617.1/730337-730488,UAAAGCGGAAUAGCGCCAGGACUUUAGAAUCUAAAGUUGACGAGGAUGACGUUUAUCGAUAAUCGACGGGUGACGUCAGGGACUGCACUCUACAGGUCAAUUACAAAAACCGACUGUGAGGUUGGUGACAGAUAUAUUGACCACGCAGCUAG,48,34,41,29,152
4979,32,FJ935779.1/2022-2192,CCUAUAAUUAUAGCGCCCGAACUAAGCGCCCGAAAAAAGGCUUAGUUGACGAGGAUGGAGGUUAUCGAAUUUUCGGCGGAUGCCUCCCGGCUGAUUAUGCAGAUCACAGCCGUAAGGAUUUCUUCAAACCAAGGGGGUAACUCCUUGAACAAAGAGAAAUCACAUGAUCUU,52,40,41,38,171
4980,33,ABAC01000009.1/939-843,UGUGCUAUACUAGUAAGGUUGAAUGAAUCAACCCUUGGUGCUUAGCUUCUUUCACCAAGCAUAUUACACGCGGAUAACCGCCAAAGGAGAAAAGAUG,31,25,21,20,97
4981,33,AAJR01000052.1/12937-13050,UGUGAUAUACUUAGUAAGUUGUUUUACACAACCCUUGAUGCUUAGUUCCCUUUCAUCAAGCAUAUUACAAACGUUAGAAGUGUUAACUGUCUAAACGUUAAAGGAGAAAUUAUG,37,40,19,18,114
4982,33,AM406671.1/1746216-1746111,UCUGCUAAAAUAAAAACGUUGCUCAAUAGUGAGUUAACCCUUGAGCCUUCAUCCCUUUGCUCAAGCAUAUUAUAGGCGAAUUUUGUCGCCAAAGGAGAACCUUUUG,31,33,19,23,106
4983,33,CP000260.1/602445-602560,UAUGGUACAAUGUAACCGUUGCUUUGCAACCCUUGGUGCUUAGUUCCCUUUCACCAAGCAUAUUAGAAACGUAGAUAGCUUUUGAGAGUUAUCCAGACGUUAAAGGAGAAAAAAUG,36,35,24,21,116
4984,33,CP000003.1/587341-587456,UAUGGUACAAUGUAACCGUUGCUUUGCAACCCUUGGUGCUUAGUUCCCUUUCACCAAGCAUAUUAGAAACGUAGAUAGCUUUUGAGAGUUAUCCAGACGUUAAAGGAGAAAAAAUG,36,35,24,21,116
4985,33,CP000425.1/786495-786601,UCUGUUAAAAUAAAAACGUUGCUCAAUUGCGAGUCAACCCUUGAGCCUUCUUCCCUUUGCUCAAGCAUAUUAAACGCGACAUUUUGUCGCCAAAGGAGAGUAUUUUG,30,34,19,24,107
4986,33,CP000387.1/1493003-1492897,UGGGGGAAUCAACUAAUGAUGCUCCUCUCAUGUGAUGCAACCCUUGGCGCUUAGCUUCUUUCGCCAAGCAUAUUACACGCGGUAAAGCCGCUAAAGGAGAAAACAUG,30,26,25,26,107
4987,33,CP000407.1/1534158-1534056,UAUGCUAUACUAAUCAACGUUGUUGAUAAAUUCAAUGACCCUUGGGGCUUGCUCACUUUACCCAAGCAUAUUUUAAGCUUUUUCGCUAAAGGAGAAUUUUAUG,29,38,17,19,103
4988,33,CP000423.1/2043279-2043181,ACACCAAAACUGAAAACGGAAGGCAAUCCUUCCACGACGAUACUUACUUUCCUUUGAUCGUCGUUACUACUGGCAUAGCCACAAAGGAGAACAAACAUG,35,21,17,26,99
4989,33,CP001033.1/966317-966413,UGUGCUAUACUAGUAAGGUUGAAUGAAUCAACCCUUGGUGCUUAGCUUCUUUCACCAAGCAUAUUACACGCGGAUAACCGCCAAAGGAGAAAAGAUG,31,25,21,20,97
4990,33,FQ312042.1/2132413-2132509,UGUGCUAUACUAGUAGGGUUGAAUAAAGCAACCCUUGGUGCUUAGCUUCUUUCACCAAGCAUAUUACACGCGGGCAACCGCCAAAGGAGAAAAGAUG,30,23,23,21,97
4991,33,AE014133.2/1474191-1474095,UAUGCUAUACUGGAUAAGUUGUCUGACAACCCUUGGUGCUUAUUUCCCUUUCACCAAGCAUAUUACAAACGGUAGAUCCGUUAAAGGAGAAACAAUG,30,29,18,20,97
4992,33,CP000114.1/925396-925509,UGUGAUAUACUUAGUAAGUUGUUUUACACAACCCUUGAUGCUUAGUUCCCUUUCAUCAAGCAUAUUACAAACGUUAGAAGUGUUAACUAUCUAAACGUUAAAGGAGAAAUUAUG,38,40,18,18,114
4993,33,FQ312029.1/941296-941392,UGUGCUAUACUAGUAAGGUUGAAUGAAUCAACCCUUGGUGCUUAGCUUCUUUCACCAAGCAUAUUACACGCGGGCAACCGCCAAAGGAGAAAAGAUG,30,24,22,21,97
4994,34,CP001361.1/745943-746008,CGUAUCAUUGUGCCUUAUCCGCAAAAGGCGGGUAGGGCGAUAAGUCCGAAAGAGGGAUGAUAUGAC,19,14,21,12,66
4995,34,GG663535.1/595616-595674,CGUAUCAUUGUGCCUCGCUGGGGAGCGGGGCGAUAAGUCCGAAAGAGGGAUGAUAUGAC,14,12,22,11,59
4996,34,CP001095.1/2361426-2361485,CGUAUCAUUGUGCCUCGCAUCCCGCGGGGCGAUAAGUCCUGAAGAAAGGGAUGAUAUGAC,15,13,18,14,60
4997,34,AE014295.3/2227032-2226973,CGUAUCAUUGUGCCUCGCAUCCCGCGGGGCGAUAAGUCCUGAAGAAAGGGAUGAUAUGAC,15,13,18,14,60
4998,34,GG729831.1/494690-494631,CGUAUCAUUGUGCCUCGCUUUCCGCGGGGCGAUAAGUCCUGAAGAAAGGGAUGAUAUGAC,14,15,18,13,60
4999,34,JGZP01000022.1/25831-25917,CGUAUCAUUGUGCCUCGCCUGCGCCGGAAGUCCCUAGGACAUCCCGCGGCCCGCGGGGCGAUAAGUCCGAAAGAGGGAUGAUAUGAC,18,15,28,26,87
5000,34,JGYS01000022.1/135113-135034,CGUAUCAUUGUGCCCCGCACUUCCGGGCCCGAAGCGGCCGCGUAUGCGAGGCGAUAAGUCCGAAAGAGGGAUGAUAUGAC,18,14,26,22,80
5001,35,AACY023226915.1/901-837,AAUUAAGCCGGGCAGUUGAACCAUAUUGUGCGCCCUGCAUUUGCUUAAGCACUAAAAAGGAGAAA,22,15,15,13,65
5002,35,ABOH01000803.1/30-94,AUUAAAGCCGGGUAUUUGAACCGUAUUGUGCACCCUGCAUUUGCUAAAGCACUAAAAAGGAGAAA,23,16,14,12,65
5003,35,CP000084.1/732850-732787,AAUUGGUAAAGGUAGUUGAACUGUAUUGUGCACCUUGCAUAGAGCUAAAGCACUAAAAAAGUAA,25,17,14,8,64
5004,35,ABVS01000001.1/912548-912482,AUAAUCGGUAGGCAUUUGAACUGUAUUGUGCGCCUAACAUAAAGUUAAAGCACUAAAAAAGGAGUAA,27,17,14,9,67
5005,35,AAPV01000002.1/208413-208345,AUUAUCGGUAGGCGCAUUUGAACUGUAUUGUACGCCUUGCAUAAAGCAAAAGUACUAAAAAAGGAGUAU,25,19,15,10,69
5006,35,CP000084.1/1127423-1127359,AAUUAAGCCGGGCAGUUGAACCAUAUUGUGCGCCCUGCAUUUGCUUAAGCACUAAAAAGGAGAAA,22,15,15,13,65
5007,36,U07843.1/1597-1709,CUUACCGGAGGCGACAUGGACCCUGAACCCACCCCUCUCCCGCGAUGGAGAAUUUUCCUUUUCCGGUAAGCCUGCCUCUGCUGUCUUACCGGUGUGUAAGACAGUGACACAAU,23,28,26,36,113
5008,36,CP000653.1/495640-495750,CUUACCGGAGGCUGUAUGGACCCUGAUCCCACCCCUCUCCCGCGAUGGAGAAUCUCUUUCCGGUAAGCCAGCCCUCGCUGUCUCACCGGUGAUGUGAGGCAGCAACGUCAU,20,25,28,38,111
5009,36,CP000247.1/4704294-4704409,CUUACCGGAGGUUAUAUGGAACCUGAUCCCACGCCUCUCCCUCGACGGAGAUUAAAACUUUUCCGGUAAGCCCGUCUUUUCACGGCGUUACCGGAUGCGUAAGGCCGUGACGUUUU,23,32,28,33,116
5010,36,CP000647.1/5085745-5085861,CUUACCGGAGAUAGUUAUGGACCCCGAUCCCACUCCUCAUCCUCGAUGGAGCAACCUUUCUUUCCGGUAAGCCUGUUUAACACUGCUUUACCGGAAAGCGUAAAGCAGUGACGUCCU,27,31,24,35,117
5011,37,CP011599.1/36880-36951,GGAGCAGCAACGAUGUUACGCAGCAGGGCAGUCGCCCUAAAACAAAGUUAGGCCGCAUGGACACAACGCAGG,23,8,22,19,72
5012,37,CP000650.1/38256-38185,GGAGCAGCAACGAUGUUACGCAGCAGGGCAGUCGCCCUAAAACAAGGUUAGGCCGCAUGGACACAACGCAGG,22,8,23,19,72
5013,37,CP018135.1/1913478-1913552,GGAGCAGCAACGAUGUUACGCAGCAGGGCAGUCGCCCUAAAACAAAGUUAGGCAUCAUGGGUGAAUUUUUCCCUG,21,16,21,17,75
5014,37,CP018839.1/285461-285385,GGAGCAGCAACGAUGUUACGCAGCAGGGCAGUCGCCCUAAAACAAAGUUAGCCGAGAGGAGAAACUAUGUCUGCAAA,27,11,22,17,77
5015,0,AF012801.1/1-340,GAGGAAAGUCCGGGCUCCACAGGGCAGGGUGGUUGCUAACGGCAACCCGGGGUGACCCGCGGGACAGUGCCACAGAAAACAGACCGCCCGGCCGACAGCGGCCGGGUAAGGGUGAAACGGUGGUGUAAGAGACCACCAGCGCCUCGGGUGACCGGGGCGGCUCGGUAAACCCCACCCGGAGCAAGGCCAAGAGGAAGCCCUCGGGCUUCUGCGCAGGCGUUCGAGGGCGGCCCGUCCGAUGCCCGCGGGUAGGCCGCUAGAGCCUGUCGGCGACGGCAGGCCCAGAUGGAUGGUCGCCCAUCGUCCGCCGCGAGGCGGGCGUGGAUAGAACCCGGCGUAG,66,37,132,105,340
5016,0,AF110048.1/1-309,CACAGAGCAACGGUGGUGGCUAACGGCCACCCACGGCGACGUGCGGGACAGUGCCACAGAAAUCAGACCGCCAGCGGCCGCCGCUCCUCGGAGCAGCGGUGCGGGUAAGGGUGAAACGGUGAGGUAAGAGCUCACCAGCGCUCCGGGUGACCGGGGCGGCUAGGUAAACCCCACCGGGAGCAAGACCAAGAGAGUCGCGUGGCGCUUCGGCGGUGCACGGCUUGCGCUGACGGGCUGCUCGUCCGAUGUCAGCGGGUAGGUUGCACGAGGCGUCCAGCAAUGGGCGUCCCAGAUGGAUGGUCGCCCACG,61,40,116,92,309
5017,0,AF110049.1/1-307,CACAGGGCAGGGUGGUGGCCAACAGCCACCCGGGGUGACCCGCGGGACAGUGCCACAGAGAACAGACCGCCGGCUGCUCGGCAGCCGGUAAGGGUGAAACGGUGGUGUAAGAGACCACCAGCGCUCCAGGUGACUGGAGCGGCUCGGUAAACCCCACCCGGAGCAAGUCCAGACAGCGUGUGCACGGCGCCUUCGGGCGUCGAGGAGACCGGCCCGGUCGAGCGCGCGGGUAGGACGCUAGAGCCGGCCAGCAAUGGUCGGCCCAGAUGGAUGGCCGUCGCCGCGCCACCGGUAACGGGGGCGCGGA,61,31,119,96,307
5018,0,AF110036.1/1-281,CACAGGACAGGGUGGUGGCUAACGGCCACCCGGGGUGACCCGCGGGACAGUGCCACAGAGAACAGACCGCCGCUACCCUCCAGGUAGCGGUAAGGGUGAAACGGUGGGGUAAGAGCCCACCAGUCCUCGUGGUGACACGAGGAGCUAGGUAAACCCCACCCGGAGCAAGACCAGACAGCGUACGACGGUGUUAGUUCACUGGGAGGGCGGUCCGCCCGAGUGCGCGGGUAGGUUGCUAGAGGCCAUCGGCAACGAUGGUCCGAGAUGGAUGGUCGCCGACU,63,38,102,78,281
5019,0,L25705.1/1-330,GAGGAAAGUCCGGACAACACAGAGCAACUCACUUCCUAACGGGAAGGCUCCGUUCAGGCGGAGACAGCAAGUGCCACAGAAAAUAUACCGCCUUGUCUUUGAUGAGGUAAGGGUGAAAACGUGAGGUAAGAGCUCACGGUAUUGCAUGGCGACAUGGAUUACGGUAAACCUUGAGUGUUGAAAGACCAAAUAGGUUACGAAACUCGAAGGCUGCUCGUCUUCUUUUACUUCGGUAAGAUUCGUAAUGGGUAGGUUGAUGGAGUCUGUCAGCAAUGGCAGAUCUAGAUAAAUGAUAGAAAACCGAUUUUUCGGUGUACAGAACCCGGCUUA,99,78,90,63,330
5020,0,X97391.1/1-342,GGGGAGGAAAGUCCGGGCUCCCCAAUGGCCAGGCUUGCUGGGUAACGCCCAGUGCGGGUGACCGUGAGGAGAGUGCCACAGAAACACACCGCCGAUGGCUCCGCUUCCGCUGCGGUGGAGACGAGCACAGGCAAGGGUGCAAAGGUGCGGUAAGAGCGCACCAGCAGCAUCGAGAGGUGCUGGCUCGGUAAACCCCGGCCGGGAGCAAGGCCCAGGGACCAACGGUUGGCCAUGACACCGGUCCCGCCCCAAGUGCGCCGCUCGAGGCCGCCGGAGACGGCGGUCCCAGACAGAUGAUCACCCCGGGCAGGGUCCGCCCCACCCGGAACAGAACCCGGCUUA,73,37,121,111,342
5021,0,AJ272219.1/1-333,GAGGAAAGUCCGGGCUCCUAUUUGGCCAGGCUUGCUGGGUAAUUCCCAGUGCGGGUGACCGUGAGGAUAGUGCCACAGAAACACACCGCCUAAUGCUUAAUGGGGAAAUCCCAACAAGCGCGGCAAGGGUGCAAAGGUGCGGUAAGAGCGCACCAGCAGCAUCGAGAGGUGCUGGCUAGGUAAACCCCGGCCAGGAGCAAGGCGAGGGGCACUGGAUGGCCAUAGACCUUGUCCCUGUAGAGAGCCGCUUGAGGCUACCGGUAACGUUAGUCCCAGAUAGAUGAUUACCCAUUCUCUUUCUAAAGAAAGAGGAAAGAACAGAACCCGGCUUAC,90,59,102,82,333
5022,0,U64880.1/1-331,GAGGAAAGUCCGGGCUCCGCAGGGCAGGAUGCUGGGUAAUACCCAGUGGGGGCGACCCUAAGGAUAGUGCAACAGAAAUAUACCGCCUGACACUUAAUAUAUGUAGCUAUAGAUGUUACCAUAUAUUAAGUGCCGGGUAAGGGUGGGAAGGUGAGGUAAGAGCUCACCAGCAGCUAGGCGACUAGCUGGCUCUGUAAACCCCAUCUGGAGCAAGACCAAGUUAGGGACAUAAAAAGGUGGUGGCCCGUCACCGUCCCGGUUGGUAGGUCGCUAGAGCCUAUUGGCGACAAUAGGCGUAGAUAGAUGGCUGUCUAACACAGAACCCGGCUUA,92,66,101,72,331
5023,0,M59354.1/1-402,CCAGUUGGCCGGGCAGCCGCGCCUUACCAAUGUCGAAAGACGGUAAGGUGAGGAAAGUCCGGGCUCCACGGAAAUACGGUGCCGGAUAACGUCCGGCGGGGGCGACCCCAGGGAAAGUGCCACAGAGAGCAAACCGCCAUGCCUUGCAUGGUAAGGGUGAAAGGGUGGGGUAAGAGCCCACCGCGCCGCUGGUGACAGUGGUGGCAAGGUAAACCCCACCGGGAGCAAGACCGAAUAGGGAUGACACGGGGCGGGCGAAAGCCUGUUCACAGCCGGUUUCCGGGCCCGUCAUCCGGGUGGGUUGCGAGAGGCGGCAUGCAAAUGCCGUCCCAGAUGAAUGGCUGCCACGUUCCGGGUCAAACCGGGGCCAUACAGAACCCGGCUUACAGGCCAACUGGCGAA,95,54,142,111,402
5024,0,M59355.1/163-591,CCAGUCGGCCGGAUGGCCGCUCUCCGUCAUCGUCCCCGGGCCACCCCCGAUGGACCGUCGGGGGGAGGAAAGUCCGGGCUCCACGGGAACACGGUGCCGGGUAACGCCCGGCGGGGGCGACCCUAGGGAAAGUGCCACAGAGAGCAAACCGCCGGCCUAUACGGCCGGUAAGGGUGAAAGGGUGCGGUAAGAGCGCACCGCCUGCCCGGCAACGGGGAGGGCAUGGUAAACCCCACCGGGAGCAAGAUCGAAUAGGGACGGCACGCCCCGGUUUUCCGGGGCAAGCGGCGUUUCCGCGCCGCCGUCCGGGUAGUAUCGCGCGAGGCGUCCGGUAACGGGCGUCCCAGAUGAAUGGCCAUCCCCGUCGUCGCGUCCCUUGCGGGAUACGGCCGGCGUGGACAGAACCCGGCUUACAGGCCGUCUGGCGGU,76,55,159,139,429
5025,0,AJ235272.1/10905-10521,CUAAAUGGUCGUGCAGUUGCGUGAUGAUAAUCACGAGGAAAGUCCGGACUCUAUAGAGGUAUGGUGCCGGUUAACAUCCGGCAGAGUAUUAUUACUUUAGGGCUAGUACCACAGAAAAUAUACCGCCGAGUAUUUCGGUAAGGGUGAAAAGGUGUGGUAAGAGCACACCGGUAAGUUGGCAACAAGUUACGCAUGGUUAACCCCACCAAGAGCAAGAUCAAAUAGGCAUUACAGAAUUUAAAUAUUUAUUUAAGUUCCUGGGUUACCUCUAAUCGGAUUGUAAUGCGGGUAGAUCGCUUGAGGUAAACGGUAACGUUUAUCCUAGAUAAAUAACUGCAAUGAAUUAAUAUUCAUACAGAAUCCGGCUUAUAGACCAGAUGAGCAG,124,101,93,67,385
5026,0,M59353.1/255-595,AAAGCAGGCCAGGCAACCGCUGCCUGCACCGCAAGGUGCAGGGGGAGGAAAGUCCGGACUCCACAGGGCAGGGUGUUGGCUAACAGCCAUCCACGGCAACGUGCGGAAUAGGGCCACAGAGACGAGUCUUGCCGCCGGGUUCGCCCGGCGGGAAGGGUGAAACGCGGUAACCUCCACCUGGAGCAAUCCCAAAUAGGCAGGCGAUGAAGCGGCCCGCUGAGUCUGCGGGUAGGGAGCUGGAGCCGGCUGGUAACAGCCGGCCUAGAGGAAUGGUUGUCACGCACCGUUUGCCGCAAGGCGGGCGGGGCGCACAGAAUCCGGCUUAUCGGCCUGCUUUGCUU,73,49,123,96,341
5027,0,BX640434.1/240958-240545,AGGGCAGAUCGGGCAAUCGCGGGGGAUGCAAAUCCUUCGAGGAAGGUCCGGACUCCACAGGGCGGGAUAGCGGCUAACGGCCGUCCGGCGACGCUGGCGGGCUUGCCCGCCGGAAAAGCCGAGGAACAGGGCCACAGAGACGAGUCUGUCAUGAGGGCGCGCCUGGCGCGCACCGGCACGGCCAUCUCCGUGCCGCGCCGUCCGGAAACGGGCGGCGGCAUGACAGGGUGAAACGCGGCAACCUCUAUCCGGAGCAACAUCAAAUAGGCAUGCGUACGGCCGUAAGGCCGGGAAGGGCGGCUCCGUCCAAGCAUGCGGGUAGGUGGCUGGAGCGGUCCAGCAAUGGUUCGCCAAGAGGAAUGAUUGCCCGCCGGGGAAACCCGGCGUACAGAAUCCGGCCUAUAGAUCUGCUCU,88,54,151,121,414
5028,0,M59356.1/53-421,GGAGUCGGCCAGACAGUCGCUUCCGUCCUGGUGACGGGGGAGGAAAGUCCGGGCUCCAUAGGGCAGGGUGCCAGGUAACGCCUGGGGGGCGAGAGUCCACGGAAAGUGCCGCAGAAAAGAUACCGCCGACCCCGUCCUCGGACGGGAGGUAAGGGUGAAAUGGUGCGGUAAGAGCGCACCGCGCUGGUGGCAACAUCAGUGGCAGGGUAAACCCCACCCGGAGCAAGACCAAAUAGGGGAACUCGCGGCUUCGACCGCAGCGCGCGGCCCGCGCGUGUUCCCGGGUAGGUCGCUAGAGGCGUGCGGCGACGCACGUCCCAGAUGAAUGACUGUCCACGACAGAACCCGGCUUAUCGGCCGACUCCCUUC,78,50,132,109,369
5029,0,AF211853.1/1-377,GAAGCUGACCAGACAGUCGCCGCUUCGUCGUCGUCCUCUUCGGGGGAGACGGGCGGAGGGGAGGAAAGUCCGGGCUCCAUAGGGCAGGGUGCCAGAUAACGCCUGGGGGGGAAACCCACGACCAGUGCAACAGAGAGCAAACCGCCGAUGGCCCGCGCAAGCGGGAUCAGGUAAGGGUGAAAGGGUGCGGUAAGAGCGCACCGCGCGGCUGGUAACAGUCCGUGGCACGGUAAACUCCACCCGGAGCAAGGCCAAAUAGGGGUUCAUAAGGUACGGCCCGUACUGAACCCGGGUAGGCUGCUUGAGCCAGUGAGCGAUUGCUGGCCUAGAUGAAUGACUGUCCACGACAGAACCCGGCUUAUCGGUCAGUUUCACCU,88,57,131,101,377
5030,0,M33657.1/1-383,GAAGCUGACCAGACAGUCGCCGCUUCGUCGUCGUCCUCCUUCGGGGGGAGACGGGCGGAGGGGAGGAAAGUCCGGGCUCCAUAGGGCAAGGUGCCAGGUAACGCCUGGGGGGUGUCACGACCCACGACCAGUGCAACAGAGAGCAAACCGCCGAUGGCCCGCGCAAGCGGGAUCAGGUAAGGGUGAAAGGGUGCGGUAAGAGCGCACCGCGCGGCUGGUAACAGUCCGCGGCACGGUAAACUCCACCCGGAGCAAGGCCAAAUAGGGGUUCAUAAGGUACGGCCCGUACUGAACCCGGGUAGGCUGCUUGAGCCAGUGAGCGAUUGCUGGCCUAGAUGAAUGACUGUCCACGACAGAACCCGGCUUAUCGGUCAGUUUCACCU,87,58,133,105,383
5031,0,M19024.1/1-354,AGAGUCGAUUGGACAGUCGCUGCCCUCUAUGAAAAUUAGGGGGGGGAGGAAAGUCCGGGCUCCAUAGGGCGAAGUGCCAGGUAAUGCCUGGGGGGCGUGAGCCUACGGAAAGUGCCACAGAAAAUAACCGCCUAAGCACUUCGGUGCCGGUAAGGGUGAAAAGGUGCGGUAAGAGCGCACCGCACGACUGGCAACAGUUCGUGGCUAGGUAAACCCCACUUGGAGCAAGACCAAAUAGGGUUCCAAGGCGUGGCCCGCGCUGGAACCGGGUAGGUUGCUAAAGAUGUCCAGUGAUGGCCAUCGUAGACGAAUGACUGUUCAAGACAGAACCCGGCUUAUAGAUCGACUCUCCAC,94,62,114,84,354
5032,0,M59357.1/212-571,GGAGUCGGACGGAUCGUCGCCGCGGGGGCAACUCCGGGGAGGAAAGUCCGGGCUCCAAAGGGCAGAACGCUGGAUAACAUCCAGGGAGGGCAACCUCCGGACAGCGCCACAGAAAGCAAACCGCCCGGCCUCGGCCGGGUAAGGGUGAAACGGUGGUGUAAGAGACCACCAGAUGCCGUGGUGACACGGCAUGCUCGGCAUACCCCGUUCGGAGCAAGACCAAAUAGGGAAGGCGGCCGGCCCGGCCGAAGCCUUCCGGGUAGGUUGCUUGAGGGUGUGGGCAACCGCACUCCUAGAGGAAUGACGGUCACACGCGGGCAACCGUGUGGACAGAACCCGGCUUACAGUCCGACUCCCGCA,84,44,127,105,360
5033,0,AF181879.1/575-891,CGCAUUAGAAGAUGGUCGCUAUUUUAGAAUAGAGGAAAGUCCGGGCUACAUUAGACAAAAUUCCAUCUAACGGAUGGCUAGCGCAAGCUAAGGGAAAGUGCCACAGAAAGCAAACCGCCUUUUUAAGGUAAGGGUGAAAGGGUGGGGUAAGAGCCCACCAGAGCUAAAGCAAUUUAGCUUGUUUGGGCAAACCCAAUUUGUAGCAAGAAGUGCAUGGUAAGUCUAAAUUGAUACGCGCUUCGCUUGAGGAAUAUUGCAAAAUAUUUCCCAGAUAAAUGGCCAUCCAUUGACAGAACCCGGCUUAUUCUAAUGCUCAA,104,75,77,61,317
5034,0,BX248358.1/328133-327709,UGAGCCGGCUGGGCGAUCGCGACUUUGCGUACCACAUGCGAUGAACAUGGUGGCGCAAGGACGAGGAAAGUCCGGACUCCACAGAGCACGGUGAUUGUUAACAACAACCCGGGGUGACCCGCGGGCAAGUGCAACAGAAAGUAAACCGCCUAGAAUUUUUCUAGGUAAGGGUGAAACGGUGCGGUAAGAGCGCACCAGCGAGGUAGGUGACUACCUCGGCUAGGUAAACCCCACUGGGAGCAAGGCAUUAGGGCGUACCGUCGUUUCAGACGGUAUGUCUGCACGAACGCUUGAAGGCUGCUCGCCUGAGUUCGUGGGUAGCUGCUUGAGGCGGCCAGUGAUGGUUUCGUCCAGAUGGAUGAUCGCCGCUGAUCUCCGCUUGUCGGGGGUGAGUACAGAAUCCGGCUUAUAUGCUGGCUCAUUCG,96,88,139,102,425
5035,0,X65648.1/164-611,GAGAGUAGGCGUUGGCGGUUGCAGACCAGUUAGCUUAACUGAUUUGAGGAAAGUCCGGACUCCCGAAAGACCAGACUUGCUGGAUAACGUCCAGUGCGAGCGAUCGUGAGGAUAGUGCCACAGAAAAAUACCGCCAAGAUUGGGGACUGGGGACUAGGGGUUGGGGACUGGGGAAGAAACUUCCCAAUCCCUAAUCCCCCAUACCCAAUACCCAACUCUUGGUAAGGGUGCAAAGGUGCGGUAAGAGCGCACCAGCAGUAUCGAGAGGUACUGGCUCGGUAAACCCCGGUUGGGAGCAAGGCCGAAGAACUAUGGUUGGUCUUUUACCAGUUCCGCUAUCAGAGAGCCGCUAGAGGCGUUUGGUAACAAACGUCCCAGAUAGAUAAUCGCCCUCGUGUAAAGCAAUUUACACAGAGAACAGAACCCGGCUUACCACCAACUCUCUCCU,124,89,125,110,448
5036,0,X65649.1/123-579,GAGAGUAGGCGUAGGCGGUUGCAGAUCAGUCACAAAAACUGAAUUUGAGGAAAGUCCGGGCUCCCGAAAGACCAAACUUGCUGGAUAACGUCCAGUGCGAGCGAUCGUGAGGAUAGUGCCACAGAAAGAUACCGCCAAUUAGUCAUUAGUCAUUUGUCAUUAGUCAUUUGGAAAAACACAAAGGACAAAGGACAAAGAACAAAUGACCAAAUUGGUAAGGGUGCAAAGGUGCGGUAAGAGCGCACCAGCAACGUCGAGAGGCGUUGGCUCGGUAAACCCCGGUUGGGAGCAAGGCGAAAGGAACUAUGGUUGGUCUUUUACCAGUUCCGCUAAAACAGAGCCGCUAGAGGCGUUUGGUAACAAACGUCCCAGAUAGAUAACCGCCCUCAUGUAGAGAAGUUACUUGUAACAUUUCUACAUUCGAGAACAGAACCCGGCUUACUACCAACUCUUUCCC,145,94,118,100,457
5037,0,Y16812.1/9-481,AGAAGUAGGCGAGGCGGCUGCGGAUUCGGCGGCGAUGCUGACUGAAUUCGAGGAAAGUCCGGGCUUCCGAAAGACCACACUUGCUGGGUAACGCCCAGUGCGCGUGAGCGUGAGGAUAGUGCCACAGAAAAAUACCGCCCUGGCCCUUCGGGGUUUCGGUGUGGUGGGUCAGGCUCCUGGAGCCGAACCGCUGUCCCUGGAAUCUGUGAGUGAAGGGCUGGGGUAAGGGUGCAAAGGUGCGGUAAGAGCGCACCAGCAGUAUCGAGAGGUGCUGGCUCGGUAAACCCCGGUGGGACGCAAGGUCGGAGGAACUAGGGUUGGUCUUUUUCCCGUUCCGUACAGGGUCAAUCUUCGGGUUGGCGCUGCGGUGUACCGCUAGAGGUGUCUGGUAACAGGCAUUCGAGAUAGAUAGCUGCCCCUAAGUCUGGAGACAGAUGAGGGAACAGAACCCGGCUUAUGUCCAACUUCUUCGU,99,98,166,110,473
5038,0,X73135.1/43-490,AAGAGUAAGCGAGCAGUUGCGAAAUUAGUCUUAAAGUAUAAUGAAAAUUUGCUUUAAGUACGGAUUUUGAGGAAAGUCCGGGCUUCCAAGAAGAUCAGGCUGCUGGAUAACGCCCAGUGCGAGCAAUCGUGAGGAUAGUGCCACAGAAAGAUACCGCCUAACUUCGGUUAGGUAAGGGUGCAAAGGUGUGUUAAGAGCGCACCAGCAGGGUCGUGAGGCUCUGGCUCGGUAAACCCCAGUCGGAAGCAAGGCGAGAGGAAAUAAGCGUUGCGAUCUUCAAUAGACCUUAUUUCCGUGACUUAACUGCGUUUAGUGCGCGAAAGCGUGGCAAGCGUAGUUAAGUGUGUGCCGCAAGAGGUAUUUGGUAACAAAUAUCCCAGAUAGAUAACCGCUAGGGCAGUUGUUAUCAACUCCCAAAACAGAACCCGGCUUAUGUCUUACUCUUUCU,130,107,122,89,448
5039,0,AJ310737.1/2-388,CGGAAGAGUAAGGCAACCGCUUCUUGUACCUUAACUAAGGUAGAUUAAGAGGAAAGUCUGGACUUCAUAAGAAAAGAUACUGGAGAAACUCCAGGGGCCGUAAGGCUACGGAAAGUGCAACAGAAAACAUUCCGCUAUAAAAGGGUCUUUUUAUAGACAGGCUGAAAAUUCCUAUUUUAAGAAUAGGAGCUAUUAAGGUGACUUAGUAGACAUGCAAACCCUAUCUGAAGCAAGAGAAAAAGUUUUUGUUUCUGCAUAAUGAGGGAGGGUAUCCCUCAUGAACUUUUUCAUAAUCGCUUGAGGGAUAUAGUAAUAUAUCCCCUAGAUGAAUGGUUGCCCUCAAGAUGAGUUUUCUCAUCUUGUAGACAGAAYCCGGCUUACUCGCUC,126,104,87,69,387
5040,0,L25703.1/209-594,AAACCGCAAGUGUGCAGUCGCUGUAUGGCUUGACGCUGUGCAGAGGAAAGUCCGAACUUCACAGGGCAGGGUGCCGGUCGAGAACCUGGUUCAAGGCCGGGGGCAGCGGUGCAAACCGUCUGUCACAGAGAGUGCAACAGAAAGCAAACCGCCCCGGCUCCGGCCGGAGUAAGGGUGAAAAGGCGGUGUAAGAGACCACCAGGUGCGUCAGCAAUGCCGUACGCUAUGAAAACCUCCCCGAAGCAAGGCCAAAUAUGGAAGCUUUUUCCGCAAGGAAAGAAGGGUUGCCCGCCCAACGUUUCCGGGUAGGCCGCAUCAGAUAAAUGACUGCAGCUUCAUCACUCGAUGAUGAUUCACAGAAUUCGGCUUACAGCUUCGGUUUCAGC,102,69,115,100,386
5041,0,L25704.1/3-383,AAACCGCAAGUGUGCAGUCGCUGUAUGGUAUAACCAUGCAGAGGAAAGUCCGAACUUCACAGGGCAGGGUGCCGGUCGAGAACGUUUGUUCAAGACCGGGGGCAGCGGCGCAAGCUGUCUGUCACAGAGAGUGCAACAGAAAGCAAACCGCUCCGGCUUAAACCGGAGUAAGGGUGAAAAGGGGGUGUAAGAGACCACCAGGCAGGUCAGCAAUGCCCUGCGCUAUGAAAACCUCCCCGAAGCAAGGCCAAAUAAGGAAGCAUUUCCUGCAAGGGAAGAAGGGUUGCCCGCCCAAUGUUUCCGGGUAGGCCGCAUCAGAUAAAUGGCUGCAACAUCACUACUUGAUGGUGAUGGACAGAAUUCGGCUUACAGCUUCGGUUU,108,69,114,90,381
5042,0,Z15006.1/122-490,CAGGAUAGGGGUGCGGUCGCGCCCGGGGGACUUCCCCCCUGGGUGAGGAAAGUCCGGGCACCAUAGGGCAGGGUGCCAGCUAACGGCUGGGCGGGGCAACCCGACGGAAAGUGCCACAGAGAAGAGACCGCCAGCGGCCGGGGCUUCCCCGGUGCGGGCAAGGGUGAAACGGUGGGGUAAGAGCCCACCGCCUGGCCUGGCAACAGGCUGGGGCACGGCAAACCCCACCCGGUGCAAGGCCCGAUAGGCAGGAAGGGCUUGCCCGGCCCGUUAGAACCUGCGGGAUGGGCCGCUUGAGGCCGGUGGCGACACCGGUCCCAGAGAGAUGACCGCGUAAAACAGAACCCGGCUUACGCCCUAUCCUGGGGA,75,41,141,112,369
5043,0,X60463.1/380-748,CGGGACGAGGGCGCGGUCGCGCCGAGGGCCGAACCCCUCGGGUGAGGAAAGUCCGGGCACCAUAGGGCAGGGUGCCAGGUAACGCCUGGGCGGGGUAACCCGACGGAAAGUGCCACAGAGAAGAGACCGCCAGCGGCCGGGGCUUCCCCCGGUGCGGGCAAGGGUGAAACGGCGGGGUAAGAGCCCACCGCCUGGCCUGGCAACAGGCCGGGGCACGGCAAACCCCACCCGGUGCAAGGCCCGGUAGGCAGGGAGGGCUUGCCCGGCCCGAGAGAACCUGCGGGAUGGGCCGCUUGAGGCCGGUGGCGACACCGGUCCCAGAGAGAUGACCGCGGAAAACAGAACCCGGCUUACGCCUCGUCCCGGAGG,74,32,147,116,369
5044,0,M64709.1/421-758,GGAGAGGAGCAGGCGGUCGCGGGGGCGCACACCUGCGCUUCCCGAGGAAAGUCCGGACUCUGGAGCGGGGUGCCGGGUAACGCCCGGGAGGGGUGACCCUCGGACAGGGCCAUAGAGAAGAAGACCGCCCGUUGAGGGCAAGGGUGGAACGGUGGGGUAAGAGCCCACCAGCGUCGGGGCAACCCGGCGGCUUGGCAACCCCCACCUGGAGCAAGGCCAAGCAGGGGGUUGGGUCGCUCCCCCUAUUCCCCCGGGUUGGCCGCUUGAGGUGUGCGGUAACGCACACCCCAGAUUGAUGACCGCCCACGACAGAAUCCGGCUUAUGCUCCUCUCCCGUG,63,46,125,104,338
5045,0,CP000388.1/820654-821039,GGAGUUGGUCAGGCAAUCGCCGCUUGUUAGAUAUUUCAUUAGGGCUAGUCCCUAGAGUAAUGUGUUAAUAAGGGGAGGAAAGUCCGGGCUCCACAGGGCAGGGUGCCAGGUAACGCCUGGGCGGCGCAAGCCGACGACAAGUGCAGCAGAGAGGAAACCGCCUAAGCGCGCAAGCGCCGGUAAGGGUGAAAGGGUGCGGUAAGAGCGCACCGCACCACUGGUAACAGUGUGUGGCAAGGUAAACUCCACCCGGAGCAAGACCAAAUAGGAUCUCUUAUGGCGUGGCCCACGUUGAGAUCGGGUGUGUUGCUUGAGCCAGCGAGUGAUUGCUGGCCUAGAUGAAUGGUUGUCCACGACAGAACCCGGCUUAUCGACCAACUCCACCU,96,72,125,93,386
5046,0,CR522870.1/276762-277121,UGAAGUGGGCUCAUGAUCGCCCCGACUUUCGCAGUCGGAGAGGAAAGUCCGAACUCCGCAGGGCAAGAUGGUUCGUAACACGAACACUGGGUGACCGGUGGAAAGUGCCACAGAAAAUAGACCGCCUGGUUCGCCAGGUAAGGGUGAAACGGCGAGGUAAGAGCUCACCGCUUUCACGGUGACGUGGAAGGCAGGGCAAACCCCAUCUGGAGCAAGACCAAAUAGAGAGAUGUUUGAGGGCGGCUCCGUCCGAGAUCUCCGGGUAGGUUGCAAGAGGCGUCGGGCAACCGACGUCCCAGUGAAAUGAUCAUGGCUCCCUUCGGGGAGAGACAGAAUUCGGCUUAUAGCCCACUUCGCACA,93,62,115,90,360
5047,0,CP000527.1/1924800-1925156,GGAGUCGGACAGGUCGUCGUCGCGGGUCGCAAGACCCGGGGAGGAAAGUCCGGGCUUCACAGGGCAGGACGCUGGGUAACGCCCAGGGGGAGCGAUCUCCGGAGAGUGCCACAGAGAGCAGACCGCCCGCGUUCGCGCGGGUAAGGGUGAAACGGUGGGGUAAGAGCCCACCAGUUGCGGUGGUGACAUCGCAAGCUAGGAAAACCCCGUCCGAAGCAAGACCAAAUAGGGGAGCGCCAAGGUCGGCCCGACCGAUGCUCCCGGGUAGGUUGCUUGAGGGUGCAGGUAACUGCACUCCUAGAGGAAUGACGACCCCCCGCGAGGGGACAGAACCCGGCUUAUCGUCCGACUCCCACU,80,47,129,101,357
5048,0,ABCE01000008.1/123447-123070,GGAGUCGGCUGAGUGGUCGCUGCGGAUUCUUCGGAAUCCGUGGAGGAAAGUCCGGGCUCCACAGGGCACGGUGGUGGGUAACGCCCACCGUCCGCGAGGACAGGGAAAGUGCAACAGAAAGUAAACCGCCGGGCCAGUUCGCUGGCCAGGUAAGGGUGAAACGGUGCGGUAAGAGCGCACCAGCAGACCGGGUGACCGGUCUGGCUAGGUAAACCCCACCGGGUGCAAGACCAAGCAGGGAGCAGUUCUGGUUCGCCAGAACACGGAUCGGCCCGAUCCGUUACGACUUCCGGGUCGGUCGCGCGAGGCUGCAGGCAACUGCGGUCCCAGAUAAAUGGCCACUCUCGACAUAACCCGGCUUACAGGCUUGCUCCCGCU,82,59,129,108,378
5049,0,CR543861.1/2832237-2831882,GAAGUGGACUGGACGGUCGCUGCUGUGGAGGUCUUCGUGACUGAAACAGGGGAGGAAAGUCCGGGCUUCAUAGGGCAGGGUGCCAGGUAACGCCUGGGCGGUGAAAGCCGACGGAAAGUGCAGCAGAGAGUAGACCGCCUCAUUCGUGAGGUAAGGGUGAAAGGGUGCGGUAAGAGCGCACCGCGUGUCUGGUAACAGUUCACGGCAUGGUAAACCCCACCAGAAGCAAGACCAAAUAGGAAUCCUGAGGUACGGCCCGUACUGGAUUCGGGUAGGUCGCUUGAGCGUAUGAGUGAUUGUACGCCUAGAGGAAUGAUCGUCCUCGACAGAACCCGGCUUACAGGUCCACUUCACCA,89,65,121,81,356
5050,0,AAKL01000009.1/106867-107210,GAAGCGGACCAGGCAACCGCUGCUUCCACGUGUUCGCACGACGGAAGGGGAGGAAAGUCCGGACUCCACAGGGCAGGGUGAUGGCUAACGACCAUCCACGGUGACGUGCGGAAUAGGGCCACAGAGACGAGUCUUCGCCCGCGGCUUCGGCCGGGGCGAAGGGUGAAACGCGGUAACCUCCACCCGGAGCAAUCCCAAGUAAGCAGGCGAUGAAGCGGCCCGCCGAGCCUGCGGGUAGGGAGCUUGAGCUGGUCGGCAACGGCCGGUCUAGAGGAAUGGUUGUCACGCCGCGCGGUGUCAUGCCGCGCGGCGCACAGAAUCCGGCUUAUCGGUUCGCUUCGCGU,70,50,124,100,344
5051,0,CP000608.1/759203-759541,AAAGUCAGUCGGACAGUCGCGCUUAUAAUGAGUGAGGAAAGUCCGGGCUUUACAGAGCAAGAUGCCAGAUAACGUCUGGGAGGCGUGAGCCUACGGAAAGUGCAACAGAAAAUAUACCGCCUUAUUUUUUAAGGUAAGGGUGAAAAGGUGUGGUAAGAGCGCACCGCAUUGGUGGUAACACUCAAUGGCAUUGUAAACCCCAUCUAAAGCAAGACCAAAUAGUGCCACUAUGAUGUUGCUCGCAUCGUGGCAGGGUAGGUCGCUUGAGCUUAUUGGUGACAAUAGGCCUAGAUAAAUGACUGUCUAUUACAGAACCCGGCUUAUAGACUGGCUUUGUAU,100,82,92,65,339
5052,0,CP000738.1/2151542-2151145,CCAGUUGGCCGGGCAGCCGCGCCCCGCAAGUGCCGAAAGGCCGCGGGGCGAGGAAAGUCCGGGCUCCACGGAAACACGGUGCCGGAUAACGUCCGGCGGGGGCGACCCCAGGGAAAGUGCCACAGAAAGCAGACCGCUCCGCUUGCGGAGUAAGGGUGAAAGGGUGGGGUAAGAGCCCACCGCGGACAUGGCGACAUGGACGGCACGGCAAACCCCACCGGGAGCAAGACCGAAUAGGGACGACACGGGCGCGCAAGCGUCCAGCCGGUUUCCAGGCGCGUCGUCCGGGUGGGUUGCACGAGGCUGCGCGCAAGCGCAGUCCCAGAUGAAUGGCUGCCACGUUUCGUCUCCUCGGAGGCGGAGCCAUACAGAACCCGGCUUACAGGCCAACUGGCUUU,86,46,144,122,398
5053,0,AP007255.1/4237307-4237707,UCAGACGGCCGGACGGCCGCCCUCGGAUUCACCUCCGGGGGAGGAAAGUCCGGGCUCCACGGAAUACACGGUGCCGGAUAACGUCCGGCGGGGGCGACCCUAGGGAAAGUGCCACAGAAAGCAAACCGCCCGCUCCCAGGCCUUCGGGUUUGGCAGCUGGUAAGGGUGAAAGGGUGCGGUAAGAGCGCACCGCGCGACCGGCAACGGAAGCGGCACGGUAAACCCCACCGGGAGCAAGACCAAAUAGGGACGGCACUGUUCUUCUUCGGAAGGACGAAACGCGUUUCCGCGUCGCCGUCCGGGUCGGUCGCGAGAGGCGUCCGGUAACGGACGUCCCAGAUGAAUGGCCGUCACCCGCUUUCGGGCGGGGACAGAACCCGGCUUACAGGCCGUCUGACGCA,85,53,140,123,401
5054,0,BA000008.3/606614-607013,CGGAAGAGAAAGGCAACCGCUGUUUAUAUUUCUCAAAAAAUAUAAAGAGAGGAAAGUCUGGACUUCAUAAGAGAAGAUACUGGAGAAAUUCCAGGGGCCGUAAGGCUACGGAAAGUGCAACAGAAAACACUCCGCUAUAAAAUUUAUUUUAUAGACAGGCUGAAAAUUCCUACUUUAGGAGUAGGAGCCAUUAAGGUGACUUAAUAGGCAUGCAAACCCUAUCUGAAGCAAGAGAAAAAAGCUUUUUGUGUCUGCAAAUGUGAGAGGAAUUCCUCCCAUAGGCUUUUUCGAAAUCGCUUGAGGGAUCUAGUAAUAGCUCCCCUAGAUGAAUGGUUGCCCUUAGGAUAGUUCGCAAGAGCUAUCUUAUAGACAGAAUCCAGCUUACCCUCUCUUCCGAUAU,134,103,88,75,400
5055,0,AF056379.1/1-407,UCGGAGAGUAAGGCAACCGCUGAAACCAGCUUUUUAAAAAAGAUGAGUACCAGAGGAAAGUCCGGACUUUAUAAGAAAAGAUGCUGGAGAAAUUCCAGGGGCCGUAAGGCUACGGAAAGUGCAACAGAAAACACUCCGCUAUAAAUUGUAUAAUUUAUAGACAGGCUGAAAAAUCUUACUUUAGGAGUAAGAGCUGCUAGGGAAACCUAGCAGACUUGUAAACCCCAUCUGAAGCAAGAGAAAAAGUUAUUUGUUUCUGCAAACAACCUUUCUAACGAAAGGCACAGGCUUUUUCAUAAUCGCUUGAGGAGUACAGUAAUGUGCUCCCUAGAUGAAUGGUUGCCCGCAAGCAAGAACUUCCGUUCGUGCUUGUCGACAGAAUCCGGCUUACUCGCUCUUCCGAGCUU,133,98,93,83,407
5056,0,AE017180.1/3388229-3387862,CGAAGCAGAACAGAUGGCCGCCCUUCGCGUGCGGGGGGAGGAAAGUCCGGGCUCCACAGGGCAUGGUGCUGGAUAACGUCCAGCGGGGGCGACCCCAGGGAUAGUGCCACAGAGAGAAGUCCGCCCGCUCAGGCGGGUAAGGGUGAAAGGGUGAGGUAAGAGCUCACCGGGUUCGGCGGUGACGUCGGAUGCCAGGUAAACCCCACCAGGAGCAAGGCCGAAUAGGGAAGCGUCAAGGAUGGCCCGUCCGUGCUUCCGGGUUGGCUGCUUGAGGCCGUCGGUAACGGCGGUCCCAGAGGAAUGGUCAUCGCCCGCCAAGGGGUAACCCGCGGCGGGAACAGAACCCGGCUUAUGGGCUGCUUCGACCA,78,51,139,100,368
5057,0,AAVS01000005.1/163696-164059,CGAGUCAGCCAAGAUAAUCGCUGCCUGUGACGAAAAUGAUCAGGGGGAGGAAAGUCCGGGCUCCACAGGGCAGAGUGCCAGCUAACGGCUGGGGGGCGUGAGCCCACGACAAGUGCAGCAGAGAGAAGACCGCCAACUUCGGUUGGUAAGGGUGAAAGGGUGCGGUAAGAGCGCACCGGGCCGCUAGUAAUAGUCGGUUGCAAGGUAAACUCCACUCGGAGCAAGACCAAAUAGGGUUCCUUAUGGCGUGGCCCACGUUGGAACCGGGUAGGUUGCUUGAGCCAUAGAGCGAUUUAUGGCCUAGACGAAUGAUUAUCACUUUCUUCGGAAAGGACAAAACCCGGCUUAUAGGCUGACUCACUCA,97,67,116,84,364
5058,0,CP000316.1/1076869-1077209,GAAGCCUGCCAGACCGCCGCUGGUGCAAUCUGGGAAACCAGGCACUGGAGGAACGUCCGGACUGCACAGGACAGCGUAGGAGGUAAUACCUCUCCACCGUGAGGUGAGGAUCAGAGCAACAGAGACGAGUCGCUUUUGGGUAACUCAAAAGCGGGUGAAACGGGCAAUCUCUACGCGCAGCAAUACCAAGUAGGCCAGCGUUGAUGUAGCUCCGCAGAGCUGGCGGGUAGGUAGCACCGAGCCGGGUGGGCGACCCCCGGCCCAGAUUAAUGGCGGUCACACCGGGUUUGCCGCAAGGCACAUCCGGCGCACAGAAUCCGGCUUAUCGGCGGGCUUCACAC,82,52,111,96,341
5059,0,CP000323.1/441081-441444,UUGGUAGACUAGGCAAUCGCCGCUGCACACUGGCAACAGACAUGCAGGGGAGGAAAGUCCGGGCUACAUAGGGCAGCGUGCCAGCUAACGGCUGGGCAGGGUAACUUGACGACCAGUGCAGCAGAGAGUAGACCGCCUUUAGUGUCUGACACUAUCGGUAAGGGUGAAAGGGUGCGGUAAGAGCGCACCGCGUGGCUGGCAACAGUUCACGGCAUGGUAAACUCCACGCGUAGCAAGACCAAAUAGGCAUCGGCAUGGCGCGGCCCGCGUUCGAUGCGGGUAGGUUGCUUGAGCGUAUUAGCGAUGAUACGCCUAGAGGAAUGAUUGUCCACGACAGAACCCGGCUUAUCGGUUUACCAACCUU,90,68,117,89,364
5060,0,AAUA01000001.1/1382814-1382421,GAAAGCAGGCGAGGUGAUCGCGAUCAGGGCAUCGGUGGCUUCGGCCCCGAGGCGCUUGGUUGAGGAAAGUCCGGGCUCCCCGAUGGCCAGGCUUGCUGGGUAACGCCCAGUGCGGGUGACCGUGAGGAGAGUGCCACAGAAACACACCGCCGAUGGCCGGCUUGCCGGCACAGGCAAGGGUGCAAAGGUGCGGUAAGAGCGCACCAGCAGCAUCGAGAGGUGCUGGCUCGGUAAACCCCGGCUGGGAGCAAGGCCGAGGAACGACGGUUGGCCAUCAACCCCGUUCCGCUGAUGUGCGCCGCUCGAGGUCGCCGGUAACGGCGAUCCCAGAUAGAUGAUCACCCCCCUUCUUUGGAAGGGAGAACAGAACCCGGCUUAUGUCCUGCUUUCACCC,81,62,136,115,394
5061,0,AACK01000018.1/26603-26989,UGAGUUGGUUAGACAAUCGCUGGUUUAUUGAAGCCCUUAAUUGUUCGCAAGAACGACCUAGCGGGACAAGUAAACGAGAGGAAAGUCCGAGCUACACAGGGCAGAGUGCCAGAUAACGUCUGGGCGGUGUGAACCGACGACCAGUGCAACAGAGAGCAAACCGCCGAUGUGCAUUAGCGCAGGUAAGGGUGAAAGGGUGCGGUAAGAGCGCACCGCGUGGGUGGCAACAUUCCACGGCACGGUAAACUCCACUCGUAGCAAGACCAAAUAGGAACUCAAUGGAUGGCCCGUCCAGAGUUCGGGUAGGUUGCUUGAGCUUGUGUGUGAAUGCAAGCCUAGAGGAAUGAUUGUCCGCGACAGAACUCGGCUUAUCGACCAACUCACUUU,107,76,117,87,387
5062,0,CP000510.1/1469372-1469738,GGAGUUGGCCAGAUCGUCGCCGCUUUUAUUGCUUGCAAUAAGAGGGGAGGAAAGUCCGGGCUUCAACAGGGCAGGGUGCCAGGUAACGCCUGGGUAGCGUGAGCUAACGACAAGUGCAGCAGAGAGGAAACCGCCGAUGUGUUUAUGUAAAUAAAUGCAGGUAAGGGUGAAAGGGUGCGGUAAGAGCGCACCGGCCAUCUAGUAAUAGUUUGGUGCAAGGUAAACUCCACCCGAAGCAAGACCAAAUAGGCUUCCUGAGGUAUGGCCCAUACUGGAAGCGGGUAGGUUGCUUGAGCCUGUGAGUGAUUGCAGGCCUAGACGAAUGACGAUUCAACGACAAAACCCGGCUUAUAGGCUGACUCUAUUA,101,76,115,75,367
5063,0,CP000514.1/2749725-2749375,CGAGCUCGCCAGACAGUCGCCGCCGGUUGAUCCGGGGGAGGAAAGUCCGGGCUCCGCAGGGCAAGGUGCCAGGUAACGCCUGGGCGGCGUGAGCCGACGGAAAGUGCAACAGAAAGUAUACCGCCUAAGCGCUUUCGGGCGCCGGUAAGGUUGAAAUGGUGCGGUAAGAGCGCACCGCGUGGCUGGCAACAGUCCACGGCGAUGGUAAACCCCACCUGGAGCAAGACCAAAUAGGAAUCCAAUGGCGUGGCCCGCGCUGGAUUCGGGUAGGUUGCUUGAGGCCUGUGGUGACGCAGGCCCUAGAUGAAUGACUGUCCAAGACAGAACCCGGCUUAUCGGCGAGCUCGCCUC,78,55,122,96,351
5064,0,BA000040.2/7288564-7288990,UCAGUCGGCCGGACGGCCGCUCCGGCAACGGUCGAAAGGCCGCCGGGGAGGAAAGUCCGGGCUCCCUUGACAUACGGUGCCGGAUAACGUCCGGCGGGGGCAACCCCAGGGAAAGUGCCACAGAGAACGAACCGCCCUGCUUCGCCUUCGGGCUUCGCUGGGUAAGGGUGAAAAGGUGCGGUAAGAGCGCACCGCGGCUGCGGCAACGGAGCCGGCAUGGUAAACCCCACCGGGAGCAAAACCGAAUAGGGACGGCGUAGCGGGCUGUUCGCGCAAGCGAUAACGCCGCGGGGCGAUGUCAGGCCCGCCGUCCGGGUAGGUUGCUCGAGGCCAUGUGCAAACAUGGCCCCAGAGGAAUGGCCGUCACGUAUCGUGCGCGCAAGCGAACGGUGCCCUACAGAACCCGGCUUACAGGCCGGCUGAUGUC,89,56,153,129,427
5065,0,AP008229.1/4089958-4089609,GGAGUCGGCCAGACAGUCGCGUCACUCGCAAGAGUGCCGAGGAAAGUCCGGGCUCCAUAGGGCAAGGUGCCAGGUAACGCCUGGGCGGCGCAAGCCGACGGACAGUGCAACAGAAAGAUACCGCCUACGUUCCUUUCGGGGAGCCGGUAAGGGUGAAAUGGUGCGGUAAGAGCGCACCGCGAGUCCGGUAACGGACCGGCACGGCAAACCCCACCUGGAGCAAGACCAAAUAGGGAUCCAUUGGCGUGGCCCGCGCUGGAUCCGGGUAGGUUGCUUGAGCGCUGCGGUGACGUGGCGCCUAGACGAAUGACUGUCCACGACAGAACCCGGCUUAUCGGCCGGCUCCGCCG,77,50,122,101,350
5066,0,AAEW02000009.1/28314-28685,CGAAGAAGGACAGACGGUCGCCGGUUUCGCAAGAAACGGGAGGAAAGUCCGGGCUCCGCAGAGCAGGAUGGUUCCUAACGGGAACCGGGGGUGACCCCAGGGACAGUGCCACAGAGAGAAGACCGCCUGCUUUGGCAGGUAAGGGUGAAAGGGUGAGGUAAGAGCUCACCAGCUCUGGUGGUGACAUCAGAGGCUCGGUAAACCCCAUCUGGAGCAAGGCCAAAUAGGGAAGCGUUUGAGAGCGGCUCGCUCGAAGCUUUCGGGUUGGCUGCUUGAGGCCGUCGGCAACGGCGGUCCUAGAGGAAUGAUCGUUGCCCGUCUCCGGGUAACCGGAUUCGGGUACAGAACCCGGCUUACGGCCUUCUUCGACCA,86,63,130,93,372
5067,0,CP000444.1/286633-286986,CGAGUUGGCCAGACAGUCGCUGCGCUCGCAAGAGCGGGGAGGAAAGUCCGGGCUUCAAAGAGCGGGGUGCCAGGUAACGCCUGGGCGGUGCGAACCGACGACAAGUGCAACAGAGAGGAGACCGCCAUCAUAGCCUCGGCUAAGGUGGUAAGGGUGAAAGGGUGCGGUAAGAGCGCACCGUGCGGCUAGCAAUAGUCCGUAGCAAGGUAAACUCCACCCGAAGCAAGACCAAAUAGGGUUCCGUAUGGCGUGGCUCGCGUUGGAACCGGGUAGGUCGCUUGAGCCUGCGAGCGAUUGCAGGCCUAGAUGAAUGACUGUCCAAGACAGGACCCGGCUUAUCGGCCAACUCAUUAA,89,56,121,88,354
5068,0,CP000758.1/1818931-1819358,UCAGUCGGUCGGGCAGCCGCGCUUGUCAUAUGCCGAAAGGCGGCAGGUGAGGAAAGUCCGGGCUCCAUGGAAACACGAUGCCGGGUAACGCCCGGCGGGGGUGACCCCAGGGAAAGUGCCACAGAAAGCAGACCGCCCCGUCUUCCGUACCGUUGCGCAACGAAACGGCAGGGAUGACGGGGUAAGGGUGAAAGGGUGGGGUAAGAGCCCACCGCGUCUGCAGCAAUGCAGACGGCACGGUAAACCCCAUCGGGAGCAAAACCGAAUAGGGACGGCGCGCUGGCUCGCAAGGGCCGGCAAUCGGUUUCCGGAUCAGCCGUCCGGGUGGGUUGCACGAGGCGGGUGGCGACAUCCGUCCCAGAUGAAUGGCUGCCACGUCGGGCGAAAGCCCGGCCAUACAGAACCCGGCUUACAGACCGACUGACAAU,99,56,151,122,428
5069,0,L42023.1/1746806-1746430,CGAGUUGGUUAGACAAUCGCUGGUUUAUUGAAGCCCUUAACCGUAUUUAUACGACCUAGUGGGACAAGUAAACGAGAGGAAAGUCCGAGCUACACAGGGCAGAGUGCCGGAUAACGUCCGGGCGGCGUGAGCCGACGACCAGUGCAACAGAGAGCAGACCGCCGUGUAAACGGUAAGGGUGAAAGGGUGCGGUAAGAGCGCACCGUGCCGUUGGUAACAACGUGCAGCAGGGUAAACUCCACUCGUAGCAAGACCAAAUAGGAACUCAAUGGGUGGCCCGUCCAGAGUUCGGGUAGGUUGCUUGAGCGGCAGAGUAAUUUGUCGCCUAGAGGAAUGAUUGUCCACGACAGAACUCGGCUUAUCGACCAACUCAAAAC,106,70,115,86,377
5070,0,AAWG01000068.1/5641-6042,GGAGUUGACUGGGUAGUCGCUGCCUUAUUGACGUCCCUUGGCCUAUCGCCAGGGAGACUGAUAAGGGGGAGGAAAGUCCGGGCUCCAUAGAGCAGGGUGCCAGGUAACGCCUGGGGGGCGCAAGCCUACGACAAGUGCAACAGAGAGCAAACCGCCGAUGGCCUCUCCUUCGGGAUGGGAUCAGGUAAGGGUGAAAGGGUGCGGUAAGAGCGCACCGUGCGACUGGCAACAGUUCGUAGCAGGGUAAACUCCACCCGGAGCAAGACCAAAUAGGCCUCCACAUAGCGUUGCUCGCGUUAGGAGGCGGGUAGGUUGCUUGAGCCAGUGAGUGAUUGCUGGCCUAGAGGAAUGGCUACUACCGCGCAAGCGGAACAGAACCCGGCUUAUACGUCGACUCCACCU,95,71,135,101,402
5071,0,AAKW01000074.1/145450-145799,AGAGUGGAUUGGACAGUCGCUGUCGCGCAAUAGCGCGGUGGAGGAAAGUCCGGGCUCCAUAGGGCAGAGUGCCAGGUAACGCCUGGGAGGCGCGAGCCUACGGAAAGUGCCACAGAAAAUAACCGCCUAAGCGCAACAGCGCCGGUAAGGGUGAAAAGGUGCGGUAAGAGCGCACCGCACGGCUGGCAACAGUGCGUGGCUAGGUAAACCCCACUCGGAGCAAGACCAAAUAGGAAUCCAUUGGCGCGGCCCGCGUUGGAUUCGGGUAGGUCGCUUGAGGCGUACAGUGAUGUGCGUCCCAGAGGAAUGGCUGUCCUCGACAGAACCCGGCUUAUAGAUCGACUCUCCCA,87,55,118,90,350
5072,0,CP000356.1/1827933-1827551,CCAGAGGGUCGGGCGAUCGCCGCUUUCGCAAGAAAGGGGAGGAAAGUCCGGGCUCCACGGAAACCACGGUGCCGGAUAACAUCCGGCGGCCUCCGCAAGGAGGUCAGGGAAAGUGCCACAGAGAGCAGACCGCCCACGGCUUCGGCCCGGCGAAAGGUGAAAGGGUGCGGUAAGAGCGCACCGCGCGGACGGUAACGGACGCGGCACGGCAAACCCCACCGGGAGCAAGGUCGAAUAGGGAUGGCACGGGAAACCAGGGCUGGUUCCGGCCCCGCCGUCCGGGUUGACUGCUUGAGCGUUCGGGUAACCGUCCGCCUAGAGGAAUGAUCGCCCAUCCCCGGCAACGGGGUGGACAGAACCCGGCUUACAGACCCUCUGGCAUC,86,45,136,116,383
5073,0,AAQF01000433.1/856-1224,CGGGGCGGGCGCGUGGUCGCCGUCGACGGCGGGCCGCAGGUCCGUCGCCGGCGGAGGAAAGUCCGAACUCCACCGGGCAGGGAGGUUCGUAACGCGAACCGGGGGCAACCCCAGGGAAAGUGCCACAGAAAAGAUACCGCCGGCAUUGCCGGUAAGGGUGAAAUGGUGAGGUAAGAGCUCACCGCUUGCCUGGUGACAGGCAAGGCAGGGUAAACCCCUCCCGGAGCAAGAUCAAAUAGGGAAACGCUUGAGGGCGGCCCGUCCGAAGUUUCCGGGUAGAUCGCAAGAGACGCCGGGCAACCGGCGCCCCCAGAUAAAUGACCACGGCCCGCAAGGGUACAGAAUUCGGCUUAUAGCCCGCCCCGCUUC,85,46,129,109,369
5074,0,CP000095.2/1668077-1668480,GAAAGCAGGGGAGGUGAUCGCAAUUGAACUUCAGCAAAAAGCUGAAGAAUUCUAUUGAGGAAAGUCCGGGCUCCUAUUUGGCCAGGCUUGCUGGGUAAUUCCCAGUGCGGGUGACCGUGAGGAUAGUGCCACAGAAACACACCGCCUAACGCUUAAUGGGGAUAUCCCAACAAGCGCGGCAAGGGUGCAAAGGUGCGGUAAGAGCGCACCAGCAGCAUCGAGAGGUGCUGGCUAGGUAAACCCCGGCCAGGAGCAAGGCGAGGGGCACUGGAUGGCCAUAGACCUUGUCCCUGUAGAGAGCCGCUUGAGGCUAGCGGUAACGUUAGUCCCAGAUAGAUGAUUACCCAUUCGCUUUCUAAAGAAAGAGGAAUGAACAGAACCCGGCUUAUGACCUGCUUUCACUU,111,78,121,94,404
5075,0,CP000524.1/988732-988347,UCAGUCGGCUGGGCAGCCGCGCUUGUCUCAUGUUAAGAUAGGUGAGGAAAGUCCGGGCUCCAUGGAAAAACGGUGCCGGGUAACACCCGGCGGGGGUGACCCUAGGGAAAGUGCCACAGAAAGCAAACCGCCUAUUUUUAUAGGUAAGGGUGAAAAGGUGAGGUAAGAGCUCACCGCGCACGCAGUAAUGGGUGUGGCAAGGUAAACCCCACCGGGAGCAAGACCAAAUAGAAAUGACGUGCAAGGUUUGGCUUGCAGCCAGUUUCCAGGUGAGUCAUUUGGGUAGGUUGCACGAGGCGGAUGGUAACAUCCGUCCUAGAUGAAUGGUUGCCAUGUAAAGUAUAAGCUUUACCAUACAGAACCCGGCUUAUAGGCCGACUGAUAUU,105,80,119,82,386
5076,0,AAOH01000003.1/223452-223841,CGAGUUGGCCGAGAUAAUCGCUGCCUGUGACGAAAAUGAUCAGGGGGAGGAAAGUCCGGGCUCCACAGGGCAGGGUGCCAGUUAACGACUGGGGGGCGCGAGCCUACGACAAGUGCAACAGAGAGCAAACCGCCGAUGGCCUUCUUGUAAGGAUCAGGUAAGGGUGAAAGGGUGCGGUAAGAGCGCACCGCGCGGCUGGUAACAGUCCGUGGCACGGUAAACUCCACCCGGAGCAAGACCAAAUAGGGUUCUAUCAUUUUAAAUAAUGAACGCGUGGCCCACGUGAGAACCGGGUAGGUUGCUUGAGCCUAAGAGCGAUUUUAGGCCUAGACGAAUGAUUAUCACUUUCUUCGGAAAGCACAGAACCCGGCUUAUUGGCCGACUCACCAA,105,72,121,92,390
5077,0,AB047584.1/531-872,GGAGACUGACAAAGGGGAGGAAAGUCCGGGCUUCAUAGAGCAAGGUGCCAGGUAACGCCUGGGGGGCGCAAGCCUACGACAAGUGCAGCAGAGAGAAGACCGCCGAUGGCCCGCAAGGGAACAGGUAAGGGUGAAAGGGUGCGGUAAGAGCGCACCGGACGACUAGUAAUAGUUCGUAGCAGGGUAAACUCCACCUGAAGCAAGACCAAAUAGGCCUCCACAUUGCGUUGCUCGCGUAAGGAGGCGGGUAGGUUGCUCGAGCCAGUGAGUGAUUGCUGGCCUAGACGAAUGGCUACCGCCGCGCAAGCGGAACAGAACCCGGCUUAUGUGUCGGCUCCACCU,91,51,117,83,342
5078,0,CP000453.1/2510108-2509745,GGAGUCGGCCGGGCAGCCGCUGCGGCCCGGGUCGCGAGACCCGGUGCGCGGAGGAAAGUCCGGGCUCCACAGGGCAGGGUGCCAGGUAACGCCUGGGGGGCGUGAGCCCACGGAAAGUGCCACAGAAAACAAACCGCCGAUGGCCCUUCGGGGCACAGGUAAGGGUGAAACGGUGCGGUAAGAGCGCACCGCGCGACUGGUAACAGUUCGCGGCACGGUAAACCCCACCCGGAGCAAGACCAAAUAGGGGAGCAAUGGCGUGGCCCGCGCUGCUCCCGGGUAGGUUGCUAGAGGCAGGUGGUGACACCUGUCCCAGAGGAAUGGCUGUCCCCGACAGAACCCGGCUUACAGGCCGACUCCACCU,78,43,133,110,364
5079,0,CP000544.1/2306477-2306833,UGAGUCGGCCGGAUGGCCGCUGUGUCGCAAGGCGACACGGAGGAAAGUCCGGGCUCCACAGGGCAGGGUGCCAGGUAACGCCUGGGGGGCGUGAGCCCACGGAAAGUGCCACAGAAAACAGACCGCCGAUGGCCGCCGCUAGGCGGCACAGGUAAGGGUGAAAAGGUGCGGUAAGAGCGCACCGCGCGACCGGCAACGGUUCGCGGCACGGUAAACCCCACCCGGAGCAAGGCCAAAUAGGGGAGCGAUGGCGUGGCCCGCGCCGCUCCCGGGUAGGCCGCUAGAGGCGUGCGGAGACGCACGUCCCAGAGGAAUGGCCAUCCUCGACAGAACCCGGCUUACAGGCCGACUCACCCU,79,37,131,110,357
5080,0,CP000606.1/242457-242816,CGAGUUGGCCAGACAGUUGCCGCGCUCAAUAGAGCGGGGAGGAAAGUCCGGGCUUCAUAGAGCAGGGUACCAGGUAACGCCUGGGCGGUGUGAACCGACGACAAGUGCAGCAGAGAGAAGACCGCCAGUCUUCGGAUUGGUAAGGGUGAAAGGGUGCGGUAAGAGCGCACCGUGCGGCUGGUAACAGUCCGUAGCAAGGUAAACUCUACCCGAAGCAAGACCAAAUAGGGUUCCACUAUUCUUAGGAAUUAAUGCGUGGCUCGCGUUGGAACCGGGUAGGUCGCUUGAGCCUGUGAGCGAUUGCAGGCCUAGAUGAAUAACUGUCCACGACAGGACCCGGCUUAUCGGCCAACUCAACAC,93,65,116,86,360
5081,0,CP000096.1/1526478-1526882,AAACCGCAAGUGUGCAGCCGCUCUGCGCCUUUGGGCGCAGGGAGGAAAGUCCGAACUUCACAGGGCAGGGUGCCGGUCGAGAUCCCCGAAAGGGAAUCAAGCCCGGGUAUGGCGGUGCAAACCGUCCAUAACAGAGAGCGCAGCAGAAAGCAGACCGCUCCGGGAAACCGGAGUAAGGGUGAAACGGCGGUGUAAGAGACCACCAGGCAUUCCGGCAACGGAAUGCGCUAUGCAAACCUCCCCGAAGCAAGGCUGAAUAGGAAAGCUUUUCCCGUAAGGGAAAGAGGGCGGCCCGCCCGAUUCCGCAAGGAGAGUUUUCGGGUAGGCCGCAUCAGAUAAAUGGCUGCAGUUUUAUCCGGCACGCCGGAUAAUUCACAGAAUUCGGCUUAUAUCUUCGGUUUCGGC,106,67,127,105,405
5082,0,CP000155.1/6015382-6015017,AGAGCUUGUUAGGCAGUCGCUGUUUCGCAUCCUUUAUUGGGCGCGAGAUGGAGGAAAGUCCGGGCUCCACAGGGCAAAGUGCCAGGUAACGCCUGGGCGGCGCGAGUCGACGGAAAGUGCAACAGAAAGUAUACCGCCUAAGUCUGCUUCGGCAGACCGGUAAGGUUGAAAUGGUGCGGUAAGAGCGCACCGCAUGGCUGGUAACAGUCCAUGGCGAUGGAAAACCCCACUCGGAGCAAGACCAAAUAGGGACCCAAUGGCGUGGCCCACGCUGGGUCCGGGUAGGUCGCUAGAGGUGCAUGGCGACAUGCAUCCCAGAUGAAUGACUGUCCACGACAGAACCCGGCUUACAGACAAGCUCUUCUU,91,66,116,93,366
5083,0,CP000285.1/2476039-2475686,GGAGCCGGCCGGACAGUCGCCGCCGUGCCAUGCACGGGGGAGGAAAGUCCGGGCUCCAUAGGGCAGGGUGCCAGGUAAUGCCUGGGCGGCGCGAGCCGACGGAAAGUGCAGCAGAGAGUAGACCGCCUAAGCGGGCGUCAGCCCGCCGGUAAGGGUGAAAGGGUGCGGUAAGAGCGCACCGCGCGCCUGGUAACAGUGCGUGGCAAGGUAAACCCCACCCGGAGCAAGACCAAAUAGGAACCCAAAGGCGUGGCCCGCGCUGGGUUCGGGUAGGUUGCUUGAGGGUCGCGGUGACGCGGCCCCUAGAGGAAUGGCUGUCCUCGACAGAACCCGGCUUACAGGCUGGCUCCCAUU,74,46,134,100,354
5084,0,AATS01000016.1/15472-15831,GGAGUGGCUCGGAUGGUCGCGGCAGGUUUAACCUGUCGAGGAAAGUCCGGGCUGCACAGGGCAGAGCGCCGGAUAACGUCCGGUGGGGGUGACCCCGGGAAAGUGCCACAGAAAACAGACCGCCGCGGCAUGCCGCGGUAAGGGUGAAACGGUGCGGUAAGAGCGCACCGCCCGGUGCGGUAACGGACCGGGGCACGGUAAACCCCGCUCGCAGCAAGGCCAAAUAGGGAAGCGCCAAACGUGGCCCGCGUUUGCUUCCGGGUAGGCUGCUCGAGCCUGUCAGUAAUGGCAGGCCCAGAUGAAUGACCAUCUCCCCGCUCCGGCGGGAGACAGAACCCGGCUUACAGAGCCACUCCGCAU,79,48,127,106,360
5085,0,ABCQ01000029.1/38223-38598,GGAGUUGGUCAGACAAUCGCCGCUUUAUGACUCGGUAUUUAUAUCGAGGUUAUAGAGGGGAGGAAAGUCCGGGCUCCACAGGGCAGGGUGCCAGGUAACGCCUGGGAGGCGCAAGCCUACGACAAGUGCAGCAGAGAGAAGACCGCCGAUGGCUUUUUCGGAAGCACAGGUAAGGCUGAAAGGGUGCGGUAAGAGCGCACCGGACGACUAGUAAUAGUUCGUUGCAGGGUAAACUCCACCCGGAGCAAGACCAAAUAGGCUUUCUAUAGGCGUGGCCCACGCUGAAAGCGGGUAGGUUGCUUGAGUCUGUGAGUGAUUGCAGACCUAGAGGAAUGAUUGUCCACGACAAAACCCGGCUUAUCGACCAACUCCAAGA,101,72,119,84,376
5086,0,AAMR01000081.1/12435-12061,GAAACUGACGUUGAAGUCCUUCGGGAGACUGGUAGAGGGGAGGAACGUCCGGGCUCCAUAGAGCAGGGUGCCAGAUAACGUCUGGGGGGCGCGAGCCCACGACAAGUGCAGCAGAGAGAAGACCGCCGAUGGCCUCAUUUCUUCGGAAGGGGCACAGGUAAGGCUGAAAGGGUGCGGUAAGAGCGCACCGUGCGACUGGCAACAGUUCGUAGCAAGGUAAACUCCACCCGGAGCAAGAUCAAAUAGGCCCUCGCAUUGCGCUGCUCGCGUAUGGGGGCGGGUAGAUUGCUUGAGCCUGUGAGCGAUUGCAGGCCUAGACGAAUGGUUACCGCCGCGCAAGCGGAACAGAACCCGGCGUAUGUGUCAACUCCACCU,91,62,128,94,375
5087,0,CP000249.1/1735135-1734723,CGAGUUGGCCGGGCGGCCGCGUCGGCGCCGGCCGGUCCGGCGUCGCCGAGGAAAGUCCGGGCUCCACAGGGCAGGGCGGUGGGUAACACCCACCCGGGGUGACCCGCGGGACAGUGCCACAGAAAACAGACCGCCGGUGCCGGUCCCGGCGCCGGUAAGGGUGAAACGGUGCGGUAAGAGCGCACCAGCGCCCAGGGUGACCUGGGCGGCUCGGUAAACCCCGCCCGGAGCAAGGUCAGAAGGCCCGUGGCCGUCACAGGUCGCGGACCGCGCAGGCGUUCGAGGGCUGCCCGCCCGAGCCUGCGGGUGGACCGCUGGAGGCUGCCGGCAACGGCAGCCCGAGAGAGAUGGUCGCCGCCGGCGAGCCGUGAGGCGAGCCGGUACAGGACCCGGCUUAUAGGCCACCUCGUCCG,68,41,165,139,413
5088,0,BA000035.2/2267229-2266802,UGAGUCGGUCAAGGUGAUCGCGUCUGAUGAACCAAGGUGACUGGAUCACCCAGGCAUCAGCCGAGGAAAGUCUGGACUCCACAGAGCACGGUGGUUGUUAACGGCAACCCGGAGUGAUCCGCGGGAAAGUGCAACAGAAAGUAGACCGCCACCGGUUUUGGCCGGUGGUAAGGGUGAAAGGGUGCGGUAAGAGCGCACCGGCAGGCCAGGUGACUGGUCUGGCCAGGUAAACCCCACCGGGAGCAAGGCAUGAGGACGCACUCCAAUGGGUGUGUCUGUGCAGGCGUUUUAAAGGCUGCUCGCCGAGUCUGCAGGUAGCUGCUGGAGGCAGUCAGCAAUGGCUGUCCGAGAUGGAUGUUCACCGCCCGCGGGUAGGGUUUCGGCCCGGCCCGCGGGAACAGAAUCCGGCUUAUGCACCGGCUCAUUCG,93,76,150,109,428
5089,0,AAMN01000002.1/922597-922223,CGAGUCAGUCCGACGGUCGCGGCGUGGGCAACCAUGUCGAGGAAAGUCCGGGCUCCACAGGGCGCGGUGGUGGCCAACAGCCACCCGGGGUGACCCGCGGGACAGUGCCACAGAAAACAGACCGCCUCCCGACUCCGGUCGGGCGGUAAGGGUGAAACGGUGGUGUAAGAGACCACCAGCGGUUCCGGUGACGGAGUCGGCUAGGUAAACCCCACCCGGAGCAAGCUCAGACAGUGUGCGUUCGAGGGCGGCCCGCCCGAGUACACGGGUAGAGCGCUGGAGGCCACUGGCAACAGUGGUCCGAGAUGGAUGACCGUCAGCGUGACCCGGGCAACCGGCCACGCGACAGAACCCGGCUUAUGACUGACUCGUCCG,79,47,134,115,375
5090,0,AAVW01000028.1/42861-43300,GGGAGUAGGCGCAGGCGGUUGCAGAUCAGUCAGAGUGACUGGUUUGAGGAAAGUCCGGACUCCCGAAAGACCAAACUUGCUGGGUAACGCCCAGUGCGAGCGAUCGUGAGGAUAGUGCCACAGAAAGAUACCGCCAUCUUCAGUGAACAGUGAACAGUGAACAGUGAACAGUCAAAACCUGAUAACUGAUAACUGAUAACUGAAAAUGGUAAGGGUGCAAAGGUGCGGUAAGAGCGCACCAGCAGCGUCGAGAGGCGCUGGCUCGGUAAACCCCGGUAGGGAGCAAGGCCAGAGGAAACUACGGUUGGUCUUUUACCAGUUUCCGUGCAUUAGAGCCGCUAGAGGCGUUUGGUAACAAGCGUCCCAGAUAGAUAACUGCCCUCAAAGGUGUUUUUAAACAUUGGCGAGAACAGAACCCGGCUUAUGUCCGACUCUCUCCC,125,86,129,100,440
5091,0,CP000384.1/3537274-3536871,CGAGUUGGCCGGGCGGCCGCGGACCGGAAACGGUUCGAGGAAAGUCCGGACUUCACAGAGCAGGGUGAUUGCUAACGGCAAUCCGAGGUGACUCGCGGGACAGUGCCACAGAAAACAGACCGCCACCCCUGACGCCUUCGGGCAAAGGGGCGGUAAGGGUGAAACGGUGCGGUAAGAGCGCACCAGCACCCCGGGUGACCGGGGUGGCUCGGUAAACCCCACCCGAAGCAAGGCCAAGAGGCCGCACCCGGUGCGGCUGCGCAGGCGCUCGAGGGUUGCUCGCCCGAGCCUGCGGGUAGGCCGCUCGAGGCACCCGGCGACGGAGUGCCCAGAUGGAUGGUCGCCGCCGCGCCGUCAGCAAUGACGGCGCGGAACAGAAUCCGGCUUACAGGCCAGCUCGUCCG,83,46,148,127,404
5092,0,M64552.3/1392-1795,CGAGCCGGGCGGGCGGCCGCGUGGAGUCCCUCACGGGACUUCCCGAGGAACGUCCGGGCUCCACAGGGCAGGGUGAUGGCUAACGGCCACCCGGGGUGACCCGCGGGACAGUGCCACAGAAAGCAGACCGCCGGAGGCUUCGGCCCCCGGUAAGGGUGAAACGGUGGUGUAAGAGACCACCAGUGCCCAGGGCGACCUGGGCAGCUAGGUAAACCCCACCCGGAGCAAGGUCAAGAAGGAAGCGCCCCGGUGCUUCUGCGCGGACGUUCGAGGGCUGCCCGCCCGAGUCCGCGGGUAGACCGCUGGAGGCCGGUGGCAACGCCGGUCCUAGAUGGAUGGCCGUCGCCGACGGGACCCGCGAGGCCCCGUCGGAACAGAACCCGGCGUACAGCCCGACUCGUCUG,75,45,151,133,404
5093,0,CP000436.1/1012669-1012282,CGAGUUAGUCAGGCAAUCGCUGGUUUGUUGAAAUCUUUAACCGUUUUUAAACGACUUAGAGGCAUAAGUAAACGAGAGGAAAGUCCGGGCUACAUAGGGCAGAGUGCCGGAUAACGUCCGGGAGGCGUGAGUCUACGACCAGUGCAACAGAGAGCAGACCGCCAAUGGCUCGUAAGAGAUCAGGUAAGGGUGAAAGGGUGUGGUAAGAGCACACCGCAUGAAUGGUAACAUUUUAUGGCAUGGUAAACUCCACUCGUAGCAAGACCAAAUAGGAACUCAAUGAGUUGCCCGCUCAGAGUUCGGGUAGGUUGCUUGAGCGUAUGUGUAAAUGUACGCCUAGAUGAAUGAUUGUCCAAGACAGAACCCGGCUUAUCGACUAACUCAACAU,116,86,109,77,388
5094,0,AAOU01000016.1/100989-100601,GGAGUAGGUCAGGUAAUCGCUGCUUCAUUGAUGUCCUUUGGGAGACUGAUGAAGGGGAGGAAAGUCCGGGCUCCACAGGGCAGGGUGCCAGAUAACGUCUGGGGGGCGCAAGCCCACGACAAGUGCAGCAGAGAGCAAACCGCCGAUGGCCUAUUGCUUGCAAUAGUGCACAGGUAAGGGUGAAAGGGUGCGGUAAGAGCGCACCGCGCAGCUAGUAAUAGUUUGUGGCAGGGUAAACUCCACCCGGAGCAAGACCAAAUAGGUCCCUAAUGGCGCGGCCCGCGUUGGGGACGGGUAGGUUGCUUGAGUCUGUGAGCGAUUGCAGACCUAGACGAAUGAUUGCCGCCGCGUAAGCGGAACAAAACCCGGCUUAUCGACCGACUCCCUAC,96,70,130,93,389
5095,0,AAOA01000002.1/350631-351049,GAAGUUGGCCAGACGAUCGCGGUAUUCCCUGUUUCAGGGGGUACGGAGGAAAGUCCGGGCUCCAUAGGGCAGGGUGCCAGGUAACGCCUGGGGGGUGUGAGCCCACGGAAAGUGCAGCAGAAAGGAAACCGCCUUUCUCCAAGACCGCUCAGGGCUGUUAAUGCAAUGGCUCGGACGUCUUGGCAGGACCUCUCAACGAUGUCCUGUGAAGGGUAAGGGUGAAAAGGUGCGGUAAGAGCGCACCGCGCGGCUGGUAACAGGCGCGGCGAUGGUAAACCCCACCUGGAGCAAGACCAAAUAGGAAUCCACCAGCUGCGGCCCGCAGUGGAUUCGGGUAGGUCGCUAGAGGCGGGCGGCGACGCUCGUCCCAGAUGAAUGAUCGUUCUCGACAGAACCCGGCUUAUCGGCCAACUUCUUUA,96,74,141,108,419
5096,0,CP000716.1/1281435-1281114,UGAGUGGAGCGAGGAGGCGCGGCUAAAGCCGAGGAAAGUCCGGACUCCAGGGGCAAGGUACCGGAUAACGUCCGGAGGGAGUGAUCCCUGGAUAGGGCCAUAGAAAAGAAAACCACCUUAAUGGUAAGGGUGGAACGGUGAGGUAAGAGCUCACCAGGUAUGGAGUAAUCCAUACGCUUGGUAACCCCUACCUGGAGCAAGGUCAAGCAGAGCUUGGGUGGCCCGCCCUAUAGCUCGGGUAGACCGCUUGAGGAAUUUGGUAACAAAUUCCCCAGAUAGAUGCCUCCAAAAACAGAAUCCGGCUUACUGCUCCACUCGAUUA,91,58,98,75,322
5097,0,CP000109.2/627864-628230,CAAGAAGGUUGGGCAGUCGCGAGAUUUUUUCUCGAGGAAAGUCCGGGCACUAUAGAGCAGAAUGCCAGCUAACGGCUGGGCGGUGAAAGCCGACGGAAAGUGCAGCAGAGAGUAGACCGCCAAUUUGAUUGGUAAGGGUGAAAGGGUGCGGUAAGAGCGCACCGCGCAACGGGUAACCGUUUGUGGCAAGGUAAACCCCAUUCAGUGCAAGACCAAAUAGGGAAACGCGUUCAAGCUUUGCUUGGGCAAGGUGCGGCUCGUACCUGGUUUCCGGGUAGGUUGCUUGAGGGAAGUAGUGAUGCUUCUCCUAGAUGAAUGAUUGUCACCAGCAAUGGUACAGAACCCGGCUUAUAGAUCUUCUUGCAUU,95,81,116,75,367
5098,0,AM412317.1/3122781-3122425,CGAGUAAGCCAGACAAUCGCUGCCGUACAUUGUACGGGAGAGGAAAGUCCGAGCUCCAUAGGGCAGGGUGCUGGGUAAUACCCAGUGGAGGCGACUCUAAGGAAAGUGCAACAGAGAUAUACCGCCAGGUUUAUCUGGUAAGGGUGGAAAGGCGAGGUAAGAGCUCACCAGCGUAUAGGUGACUAUACGGCUAUGUAAACCCCAUCUGGAGCAAGAUCGAAUAGGAGAGCAGGAAAUUUUGGUUUCCAGGGGUGGCCCGUCCCGCUCUCGGGUAGUAUCGCUGGAGCCUAUUGGUAACAAUAGGCCUAGAUAGAUGAUUGUCUAACACAGAACUCGGCUUAUAGGCUUGGUCGUGCC,96,76,110,75,357
5099,0,CP000607.1/801943-801538,AAACCGCAAGUGUGCAGUCGCUGCAGGGCCAAUGGCCCUGCAGAGGAAAGUCCGAACUUCACAGGGCAGGGUGCCGGUCGAGAGCGCCGAAAGGUUCUCAAGCCCGGGCAGGUCGGCGCAAGCCGGUCCUGACAGAGAGCGCAGCAGAAAGCAGACCGCUCCGGGAAACCGGAGUAAGGGUGAAACGGCGGUGUAAGAGACCACCAGGCAUUCCGGUAACGGAGUGCGCUAUGCAAACCUCCCCGAAGCAAGGCCGAAUAGGAAAGCUUUUCCCCAAAGGGAAAGAGGGCGGCCCGCCCGAUUCCGCAAGGAGAGUUUUCGGGUAGGCCGCAUCAGAUAAAUGACUGCAGUUUCUUCCGGCACGCCGGUUGAUUCACAGAAUUCGGCUUACAUCUUCGGUUUCGGC,102,64,130,110,406
5100,0,CU207211.1/2797087-2796765,GAAGCAGGCCAAGACAACCGCUGGCUGUCAUUUCGGUGAUGGCGGGAGGAAGGUCCGGACUCCAUAGAGCAGGGUGACGGUUAACGGCCGUCCGCCGCGAGGCGAGGAAUAGGGCCACAGAGACGAGCGUAUUAAGUUACGGUGAAACGCGGUAACCUCCACCUGGAGCAAUUUCAAAUAGGCACGCGUUGACGUUGCUCGCGGAGCGUGCGGGUAGAAAGCUUGAGCCGUGGAGUAAUUCACGGCCUAGAGGAAUGGUUGUCAUAGCAAAUGGGCUUGCUCAUUUGCCGUAACAGAAUCCGGCCUAUCGGCUUGCUUCAACU,78,64,105,76,323
5101,0,CP000301.1/2380838-2380410,UCAGUCGGCCGGACGGCCGCUCUCGCUACGGUCGAAAGGCUGCGAGGGAGGAAAGUCCGGGCUCCAUCGACAUACGGUGCCGGAUAACGUCCGGCGGGGGCGACCCCAGGGAAAGUGCCACAGAGAACGAACCGCUCGGCGAAGUCCGCAAGGACGAAGCGGAGUAAGGGUGAAAAGGUGCGGUAAGAGCGCACCGCGUUUCCGGCAACGGAAACGGCAGGGUAAACCCCACCGGGAGCAAAACCGAAUAGGGGCGGCAACGCAGAGCGUUCGCGCAAGCGAUAACACUGCAGGGCGAUGUCAAGCUCGCCGUCCGGGUAGGUUGCUAGAGGCAGCGUGCAAACGUUGUCCCAGAGGAAUGGCCGUCGCGUAUCGCUCGUGCAAGCGGGCGGUGCCCUCCAGAACCCGGCUUACAGGCCGGCUGAUAUU,101,56,152,120,429
5102,0,AAVT01000007.1/10464-10087,CGAGUCAGCUAGGCAGUCGCCGUUCAUUCUUAUUCGUAAGCGUGAAGGGAGGAAAGUCCGGGCUCCAUAGGGUAGGACGCCAGGUAACUCCUGGGGGGCGCAAGCCUACGGAUAGUGCAGCAGAGAGUAGACCGCCGAUGGCUUCCUCUAUUUCGGUAGAAGAAGCACAGGUAAGGGUGAAAGGGUGCGGUAAGAGCGCACCGCACGACUGGUAACAGCUCGUGGCAUGGUAAACCCCGUUCGGAGCAAGACCAAAUAGGAACUCUAUAGGCGUGUACCCGCGCUGAGUUCGGGUAGGUUGCUAAAGUGUUGCGGUGACGUAACGCGUAGAUGAAUGACUGUCCACGACAGAACCCGGCUUAUCGGUUGGCUCAAAUA,95,75,122,86,378
5103,0,AAWL01000004.1/135246-134887,AUGAGUACGAAAGAUGGUCGCGAAUGCCGGAGGGCAUUCGAGGAAAGUCCGAGCUCCGCAGGGCAGGGUGCUGGAUAACGUCCAGCGAGGGCGACCUCAGGGAAAGUGCCACAGAAAUGUAGACCGCCGGGCGCUUUCGCGUUCGGUAAGGAUGGAACGGUGCGGUAAGAGCGCACCAGCAGCCAGGCGACUGGCUGGCUAGGUAAACCCCACCCGGAGCAAGACCGAAUAGGGAAGGAAUGAGGCGGCCCGCUGACCUUCCGGGUUGUGUCGCUUGAGCCGUCAGGCAACUGGCGGCCUAGAUAGAUGACCAUCACCGCGUGAGCGGAACAGAACUCGGCUUAUUGACUACUCAUAGCU,88,57,123,92,360
5104,0,AAOW01000035.1/17820-17459,GGAGUUUGCCAGGCAGUCGCUGCCCUUUCGGGGGUGGAGGAAAGUCCGGGCUCCAAAGGGUAGAGUGCCAGAUAACGUCUGGGCGGCGCGAGUCGACGGAAAGUGCAGCAGAAAAUAUACCGCCUACGUAUCUCGAUUUUCGGAUCGGGAUGCCGGUAAGGUUGAAAUGGUGCGGUAAGAGCGCACCGCGUGGGUGGCAACAUUCCACGGCAUGGUAAACCCCACUCGGAGCAAGACCAAAUAGGGUUCCUAUAGGCGUGACCCGCGCUGGAACCGGGUAGGUUGCUUGAGGCCUGUAGCGAUGCAGGUCCUAGAUGAAUGACUGUCCACGACAGAACCCGGCUUACCGGCAAACUCCUCAU,85,69,118,90,362
5105,0,AE017143.1/1340084-1339700,UGAGUUAGUUAGGCAAUCACUGGUUUAUUGAAGCCUAAAGUGUUCUUUAGAACAAACUAGUGGGACAAAUAGACGAGAGGAAAGUCCGAGCUACAAAGGGCAGAGUGCCAGAUAACGUCUGGGAGGCGUGAGCCUACGACUAGUGCAACAGAGAGCAGACCGCCUGUGAUUAAAACACAGGUAAGGGUGAAAGGGUGUGGUAAGAGCACACCGCGUGAAUGGUAACAUUUCACGGCACGGUAAACUCCACUCGUAGCAAGACCAAAUAGGAAUCCAAUGAGUCGCCCGUUCAGGAUUCGGGUAGGUUGCUUGAGCUUGUGUGUGAAUACAAGCCUAGAGGAAUGAUUGUCCACGACAGAACUCGGCUUAUCGACUAACUCAGUUC,118,83,108,76,385
5106,0,AAUW01000011.1/86086-85664,UCAGUCGGCCGGACAGCCGCUGCCGCAAGUGCCGAAAGGCCGCGGGGGAGGAAAGUCCGGGCUCCAUGGAAACACGGUGCCGGGUAACGCCCGGCGAGGGCGACCUUAGGGAAAGUGCCACAGAAAGCAAACCGCCCCGGCCAGAUCGAGAGAUUUUCCCGGGGUAAGGGUGAAAGGGUGGGGUAAGAGCCCACCGCGCAACUGGCAACAGCGGCGGCAUGGUAAACCCCACCGGGAGCAAAACCGAAUAGGGACAGCGCGGACCGGAGCAAUCCGGUCCAGGCCGGUUUCCAGGCCAGUUGUCCGGGUUGGUUGCGAUAGGCGUCUGGCAACAGGCGUCACAGAUGAAUGGCUGUCACGUCCGCGUCAGGUCUCGUAUCUGGCCGGGCCAUACAGAACCCGGCUUACAGGCCGGCUGGCUCU,94,58,149,122,423
5107,0,AE004969.1/1924437-1924796,CGGGACGGGCAGACAGUCGCCGCGUAUCGCGUAAGGCAUACGGGGAGGAAAGUCCGGGCUCCGCAGGGUAGAAUGCCGGUUAACGGCCGGGCGCGGUAACGCGACGGAAAGUGGAACAGAAAGCAAAACCGCCGAUGGCUGCUUUGGCAGCACAGGCAAGGGUGAAAAGGUGCGGUAAGGGCGCACCGCGCAUUUGGUAACAAUAUGCGGCAGGCCAAACCCCAUUCGGAGCAAGACCAAACAGAACGCAAUGACGCUGCCCGCCGAGCGUUCGGGUAGGUUGCUUGAGCAUACCGGCAACGGUAUGCCUAGAGGAAUGACUGUCCGAGACAGAACCCGGCUUACCGCCUGUCCGGUGUG,91,51,124,94,360
5108,0,CP000302.1/312051-312435,CGAGUUGGCCAGACAGUCGCCGCGUUCUUCGGAACGGGGAGGAAAGUCCGGGCUCCACAGAGCAGGGUGCCAGGUAACGCCUGGGCGGUGCGAACCGACGACAAGUGCAGCAGAGAGGAGACCGCCAUUUUAAGCUUCGGCUAUAAAUGGUAAGGGUGAAAGGGUGCGGUAAGAGCGCACCGUGCGGCUAGUAAUAGUCCGUAGCAAGGUAAACUCCACCCGGAGCAAGACCAAAUAGGGUUCCAGUGCUUACUUAGGUAAGCUGAUGCGUGGCUCGCGUUGGAACCGGGUAGGUUGCUUGAGCCUGUGAGCGAUUGCAGGCCUAGAUGAAUGACUGUCGCUCCUCACGGAGAGACAAGACCCGGCUUAUAGGCCAACUCACCUC,94,71,126,94,385
5109,0,AE002160.2/810850-811252,CGGAAGGGUAAGGCAACCGCUGAGCCAGUUUUAGAAAAACUGCGUAUCAGAGGAAAGUCCGGACUUCGUAAGAAAAGAUGCUGGAGAAAUUCCAGGGGCCGUAAGGCUACGGAAAGUGCAACAGAAAACAUUCCGCUAUAAAUGAUAUCAUUUAUAGACAGGCUGAAAAAUCCUACUUUAGGAGUAGGAGCUGCUAGGGAGACCUGGUAGACUUGUAAACCCCAUCUGAAGCAAGAGAAAAAGUUAUUUGUCUCUGCAAAAUCCUUUCUAAUGAAAGGCAUAAACUUUUUCAUAAUCGCUUGAGGAGUACAGUAAUGUGCUCCCUAGAUGAAUGGUUGCCCACAAGUAAGAAUUUCUUAUUCGUACUUGUUGACAGAAUCCGGCUUACUCGCUCUUCCGAGCU,129,102,94,78,403
5110,0,AAPG01000076.1/1039-1399,GGAGUUGGCUAGAUCGUCGCCGCUUUAUUGCUAUUUAUAGUUUAUAGAGGGGAGGAAAGUCCGGGCUUCAUAGGGCAGGGUGCCAGGUAACGCCUGGGUAGCGCAAGCUAACGACAAGUGCAGCAGAGAGAAGACCGCCUGCAAAUUUAUUUGUCGGUAAGGGUGAAAGGGUGCGGUAAGAGCGCACCGGCUAAUGGGUGAUCAUUAGUGCAGGGUAAACUCCACCUGAAGCAAAACCAAAUAGGCUUCCUGAGGUAUGGCCCAUACUGGAAGCGGGUAGGUUGCUUGAGCCGUCGAGUGAUUGGCGGCCUAGAGGAAUGACGAUCCACGACAGAACCCGGCUUAUCGGCCGACUCCAACC,93,75,115,78,361
5111,0,CP000644.1/358018-358404,GGAGUCGGCUGGGCAAUCGCUGCUUCGUCGUUGUGUCCCUCGGGACAGACGGGCGGAGGGGAGGAAAGUCCGGGCUUCAUAGGGCAGGGUGCCAGGUAACGCCUGGGGGGCGUGAGCCCACGACCAGUGCAACAGAGAGCAAACCGCCGAUGGCCCGCAAGGGAUCAGGUAAGGGUGAAAGGGUGCGGUAAGAGCGCACCGCGCGUCUGGUAACAGUUCGUGGCACGGUAAACUCCACCCGAAGCAAGACCAAAUAGGCCCCUAUUGGCGCGGCCCGCGUUGGGGGCGGGUAGGUUGCUUGAGCCAGCGAGCGAUUGCUGGCCUAGAGGAAUGAUUGCUACCCGGGGCAACCCGGUACAGAACCCGGCUUACAGGCCGACUCCGACC,82,58,142,105,387
5112,0,CP000480.1/4393032-4392645,CGAGUUGGCCGGGCGGCCGCGGCAUCAGCCUGAUGUCGAGGAAAGUCCGGACUUCACAGAGCAGGGUGAUUGCUAACGGCAAUCCGAGGUGACUCGCGGGAAAGUGCCACAGAAAACAGACCGCCAGAAAUGGUAAGGGUGAAACGGUGCGGUAAGAGCGCACCAGCACCCCGGGUGACCGGGGUGGCUAGGCAAACCCCACCCGAAGCAAGGCCAAGAAGGCCGCAACUGCGGUUGCGGCCGCGCAGGCGCCCGAGGGUUGCUCGCCCGAGCCUGCGGGUAGGCCGCUUGAGGUACCCGGCGACGGGCUACCCAGAUGGAUGGUCGCCGCCCCACCGCCAGAGAUGGCGGCGGGGAACAGAAUCCGGCUUACAGGCCAACUCGUUCG,86,47,139,116,388
5113,0,CP000667.1/3848228-3847813,CGAGUCGACCGGGCGGUCGCGUCGGCGGGUUCCAGCCCGCCGUCGAGGAACGUCCGGACUCCACAGGGCAGGGUGGUUGCUAACGGCAACCCGGGGUGACCCGCGGGACAGUGCCACAGAAAACAGACCGCCGUUCCCUAACGGGGACGGUAAGGGUGAAACGGUGGGGUAAGAGCCCACCAGCACCCCGGGUGACCGGGGUGGCUCGGUAAACCCCACCCGGAGCAAGGCCAAGAAGGGGCCGUCAUCCGCAGAGACGACGACCCGCGCAGGCGAUCGAGGGCUGCCCGCCCGAUGUCUGCGGGUAGGCCGCUGGAGCCUGUCGGUGACGGCAGGCCGAGAUGGAUGACCGCCGCCGGCGCGAGCCCUCGGGCCCGCGCCGCGCACAGAAUCCGGCGUACAGGUCGACUCGUCCG,77,45,156,138,416
5114,0,AASF01002160.1/1477-1126,GGAGUCGGCCGGACAGUCGCUGCCUCGGCAACGAGGUGGAGGAAAGUCCGGGCUCCACAGGGGCAGGGUGCCAGGUAACGCCUGGGGGACGCAAGUCUACGGAAAGUGCCGCAGAAAAGAUACCGCCUAAGCGCCUUUAGGCGCCGGUAAGGGUGAAAUGGUGCGGUAAGAGCGCACCGCGCUGACGGUAACGCCAGUGGCAGGGUAAACCCCACCCGGAGCAAGACCAAAUAGGGGAGCAUUGGUGUGGCCCGCAUCGCUCCCGGGUAGGUUGCUUGAGGUGCACGGUGACGUGCAUCCCAGAUGAAUGGGCUGUCCUCGACAGAACCCGGCUUACAGGCCGGCUCCCCCU,77,52,125,98,352
5115,0,AE013218.1/93701-93332,GAAGUUGACUAAACAGUCGCUGUUUAGUUUUAAAACUAAAGAGAGGAAAGUCCGGGCUCCAUAGAGCAGGGUGCCAGGUAACACCUGGAAAGCGCAAGCUUAUGACAAGUGCAACAGAAAAAAAACCACCUUAUUUUCUUUUUUUAACUGCAGAUAAUAGGGAAAGGGUGAAAAGGUGUGGUAAGAGCACACCGCAUAAUUGGCAACAAUUUAUGGCAAUGUAAACUCCACCUGGAGCAAAGCCAAAUAUAGGUUAUUAAUAUUGCUCGUAUUUUAAAAAACCUGGGUGGGCUGCUUGAAUUAGUAAGUAAUUACUAAUCUAGAUGAAUGACUGUUAAAACAGAACCCGGCUUAUAGGUCAACUUCUUAA,131,96,81,62,370
5116,0,CP000110.1/152159-151769,GAAAGCAGGCGAGGUGGUUGCGGCCGAUCUCUUUGAGUGUCGGCUGAGGAAAGUCCGGGCUCCCUGAUGGCCAGGCUUGCUGGGUAACGCCCAGUGCGGGUGACCGUGAGGAGAGUGCCACAGAAACACACCGCCGAUGGCCGGUUCGCCGGCACAGGCAAGGGUGCAAAGGUGCGGUAAGAGCGCACCAGCAGCAUCGAGAGGUGCUGGCUCGGUAAACCCCGGCUGGGAGCAAGGCCAAGGAACGACGGCUGGCCAUUGGCCCCGUUCCGCUUGAACGCGCCGCUUGAGGCCGUCGGUAACGGCGGUCCCAGAUAGAUAACCACCCACCCUCUGCAGACCAAACUCUGUGAGGCGUGAACAGAACCCGGCUUAUGUCCUGCUUUCACCA,83,63,131,114,391
5117,0,AM180355.1/3148245-3147911,UAAGUAAGCCAGAUAAUCGCAUGUAAUCUUACAUGAGGAAAGUCGGAGCUCCAUAGAGCAGGGUGCUAGGUAACGCCUAGUGGGAGCGAUCCUAAGGAUAGUGCAACAGAAAUAAACCGCCACUAUUGUGGUAAGGAUGGAAAGGCGAGGUAAGAGCUCACCAGCAGCUAGGCGACUAGUUGGCUAUGUAAACCCCACCUGGAGCAAGACCAAGAUAGGAAUAAAGAGUGCUGCUCGUACUCUCCGGUAGGUAGGUCGCUUGAGCCUAUUGGUGACAAUAGGCCUAGAAAGAUGAUUAUCUAAUACAGAACUCCGCUUAUAGACUUGCUUAAUUA,106,74,89,66,335
5118,0,CP000133.1/2984940-2984543,CCAGUUGGCCGGGCAGCCGCGCUUUACCAAUGCCGAAAGGCGGUAAGGUGAGGAAAGUCCGGGCUCCACGGAAACACGGUGCCGGAUAACGUCCGGCGAGGGCGACCUCAGGGAAAGUGCCACAGAAAGCAAACCGCCUGUCAUGACAGGUAAGGGUGAAAGGGUGGGGUAAGAGCCCACCGCAUCUCCGGCAACGGAUAUGGCACGGUAAACCCCACCGGGAGCAAGACCGAAUAGGGAUGACGCGGCGGGCUGAAAGGUUCUCCGGCCGGUUUCCAGGCCAGUCAUCCGGGUGGGUUGCGUGAGGCAGCGUGCGAGCGCUGUCCCAGAGGAAUGGCUGCCACGUUCCGGUUCACGCCGGAGCCAUACAGAACCCGGCUUACAGGCCAACUGGCAAU,94,56,137,111,398
5119,0,CP000319.1/3179466-3179883,UCAGUCGGCCGGACGGCCGCUCCCGCUGCGGCCGAAAGGCUGCGGGAGAGGAAAGUCCGGGCUCCAUCGACAUACGGUGCCGGAUAACGUCCGGCGGGGGCGACCCCAGGGACAGUGCCACAGAGAACGAACCGCCUCCUCCCCGGAGCAGGUAAGGGUGAAAAGGUGCGGUAAGAGCGCACCGCGUCUCCGGCAACGGAGACGGCAUGGCAAACCACACCGGGAGCAAAACCGAAUAGGGGCGGCAUCGCGAGAGGUUCGCCUUCGGCGAUAACAUCGCAGGGCCAUGUCGGGCCCGCUGUCCGGGUAGGUUGCAUGAGGCAACGUGCAAACGUUGCCCCAGAGGAAUGGCCGUCACGUAUCGCGUGCGCAAGCGCGCGGUGCCCUACAGAACCCGGCUUACAGGCCGGCUGAUAUG,91,53,147,127,418
5120,0,BA000030.3/7093666-7094071,CGAGCCGGGCGGACGGCCGCGUGGGGGUCCUUGAGGACCUCCCCGAGGAACGUCCGGGCUCCACAGGGCAGGGUGGUGGCUAACGGCCACCCGGGGUGACCCGCGGGACAGUGCCACAGAAAACAGACCGCCCGGCGCUUCGGCGCCGGGUAAGGGUGAAACGGUGGUGUAAGAGACCACCAGCGCCUGAGGUGACUCAGGCGGCUAGGUAAACCCCACCCGGAGCAAGGUCAAAAGGAGCCGCUGUGAAAGGCGGCUCUGCGCGGACGUUCGAGGGCUGCCCGCCCGAGUCCGCGGGUAGACCGCACGAGACCGGUGGCAACGCCGGUCCUAGAUGGAUGGCCGUCUCCCCGGCCGCCGCGAGGCGACCGGGCGACAGAACCCGGCGUACAGCCCGACUCGUCUG,76,45,153,132,406
5121,0,CP000492.1/1954779-1955183,AAACCGCAAGUGUGCAGUCGCUGUGUAACUACAGGUUAUACAGAGGAAAGUCCGAACUUCCCAGGGCAGGGUGCCGGUCGAGAGCCCUUGUGGCUCAAGCCCGGGGGCAGCGGUGCAAACCGUUUGUCACAGAGAGUGCAACAGAAAAAAAACCGCUCCGGGAAACCGGAGUAAGGGUGAAAAGGCGGUGUAAGAGACCACCAGACAUUUCAGAAAUGGGAUGUGCUUGGCAAACCUCCCCGAAGCAAGGCUAAAUAGGAAUGCUUUUCCUUUACGGAAAGAGAGUUGCCCGCUCAAUUCUUCUUCGGAAGAGAGUUUUCGGGUAAGCCGCAUCAGAUAAAUGGCUGCAGUUUUAUCCGGAUUCCGGAUAAUUCACAGAAUUCGGCUUACAGCUUCGGUUUUGGC,112,87,115,91,405
5122,0,CP000112.1/1785521-1785161,GGAGCAGGACGAGCUGCCGCUGCGUGUCAUUUGUACACGGAGAGGAAAGUCCGGGCUCCGCAGGGCAAGACGCUGGGUAACCCCCAGGUGAAGUGAUUCACGGACAGUGCCACAGAAAACAAACCGCCUGCCAUGCAGGUAAGGGUGAAACGGUGGGGUAAGAGCCCACCAGAGGUGACGGUGACGGCACCUGCUAGGUAAACCCCGUCUGGAGCAAGACCAAAUAGGAAGGCGCCAAGGCCGGCCCGGCCGAUGCCUUCGGGUAGGUUGCUUGAGGCUGCAGGUAACUGCAGCCCUAGAGGAAUGGCAGCUGCUUCCCUUUAUGGAAGAACAGAACCCGGCUUAUAGUCCGGCUCCCGUC,88,57,119,97,361
5123,0,AE017340.1/438671-439020,AGAGCUGGCCAGACAAUCGCCGCCUGUUUACAGGGGGAGGAAAGUCCGGGCUCCAUAGGGCAGGGUGCCAGGUAACGCCUGGGCGGUGUAAGCCGACGACUAGUGCAGCAGAGAGUAAACCGCCGAUGGCUGCUUGCAGCACAGGUAAGGGUGAAAGGGUGCGGUAAGAGCGCACCGCGCAACUGGUAACAGUUUGUGGCACGGUAAACUCCACCCGGAGCAAGGUCAAAUAGGGGUUCUUUGGCGCGGCCCGCGUUGAACCCGGGUAGACUGCUUGAGGGUCAGGGCAACCUGAUCACUAGAUGAAUGAUUGUCCACGACAGAACCCGGCUUAUCGGCCGGCUCUCCAC,82,60,118,90,350
5124,0,CP000746.1/1834262-1833866,CGAGUUGGUCAGACAAUCGCUGGUUUAUUGAAGCCCUUAAUACCGAAAGGUUAGCCUGAAACAGGUGAUAAGCGGGACAAGUAGACGAGAGGAAAGUCCGGGCUACAUAGGGCAGAGUGCCGGAUAACGUCCGGGGGGCGCGAGCCUACGACAAGUGCAGCAGAGAGCAGACCGCCGUUUUUAAUAAAACGGUAAGGGUGAAAGGGUGCGGUAAGAGCGCACCGCGCGGGUGGUAACAUUCCGCGGCAAGGUAAACUCCACUCGUAGCAAGACCAAAUAGGAACUCAAUGAGUGUGCCCGCUCAGAGUUCGGGUAGGUUGCUUGAGCGACGGAGCAAUUCGUCGCCUAGAGGAAUGAUUGUCCGCGACAGAACCCGGCUUAUCGACCGACUCAUUCA,110,72,125,90,397
5125,0,AM420293.1/1744463-1744869,UGAGUCGGCCGGGCGGCCGCGUCGGGGUGCGUCCCCGUCGAGGAAAGUCCGGACUCCACAGGGCAGGGUGGUUGCUAACGGCAACCCGGGGUGACCCGCGGGAAAGUGCCACAGAAAGCAGACCGCCCGGCGGAGUGCCCAGGCACUCCGGCCGAGCAAGGGUGAAACGGUGGUGUAAGAGACCACCAGCGCCCCGGGUGACCGGGGCGGCUCGGUAAACCCCACCCGGAGCAAGGCCAAGAGGACACCGCCAGGUGUCUGCGCAGGCGUUCGAGGGUUGCCCGCCCGAUGCCUGCGGGUAGGCCGCUGGAGCCUGCCGGCGACGGCAGGCCGAGAUGGAUGGCCGCCGACUGGGAGCGCCGCAAGGCCCCCACGAACAGGAUCCGGCUUACAGGCCGACUCGUCCG,75,43,156,133,407
5126,0,AASE01000025.1/1252-1652,AAACCGCAAGUGUGCAGUCGCUGUGGAGCAUCACGCUUCACAGAGGAAAGUCCGAACUUCACAGGGCAGGGUGCCGGUCGAGAGCCGAAAGGCUCAAGCCCGGGGAUAACGGCGCAAGCCGGUUAUCACAGAGAGUGCAACAGAAAACAGACCGCUCCGGACGGCCGGAGUAAGGGUGAAACGGCGGUGUAAGAGACCACCAGGCAGUGCAGUAAUGCACUGCGCUUGGCAAACCUCCCCGAAGCAAGGCUAAAUAGGAAAACUUUUCCCUCCGGGGAAAGAGAGCGGCCCGUUCAAUUCCGAAAGGAGAGUUUUCGGGUAAGCCGCAUCAGAUAAAUGGCUGCAGUUUUAUCCGGACUCCGGAUAAUCCACAGAAUUCGGCUUACAGCUUCGGUUUCAGC,112,68,119,102,401
5127,0,AE017282.2/2358615-2358258,GGAGUCGGCCAGACAGCCGCUGUCCUUGAAGGGGAUGGAGGAAAGUCCGGGCUCCACAGGGCAGGGUGCCAGGUAACGCCUGGGGGGCGCGAGCCCACGGAAAGUGCCACAGAAAAUAUACCGCCCCGGUGCGUCCGGGGUAAGGGUGAAAAGGUGCGGUAAGAGCGCACCGCGCUGGCGGUAACGCCAAGCGGCAGGGUAAACCCCAUCCGGAGCAAGACCAAAUAGGGGAGCAUUGGGUUCGCCCAGACGUGCGGCCCGCACGGCUCCCGGGUAGGUCGCUCGAGACGUACGGUGACGUAUGUCCCAGAUGAAUGGCUGUCCACGACAGAACCCGGCUUACCGGCCGACUCUUCUU,79,50,127,102,358
5128,0,AM167904.1/3141205-3140801,AAGGCAGAUUGGGCAGUCGCGAUGGUUAGACCAUCGAGGAAGGUCCGGACUCCAUAGGGCAGGAUAGCGGCUAACGGCCGUCCGGUAAGAUGCGCAAGCAUCGAGCCGAGGAACAGGGCCACAGAGACGAGUCUGCGGGGCGGGCGCCUUCAGGGGCGCACCGGCACGGCCAUCUCCGUGCUGCGGCAACUGGUGACAGUUGCCGGCAUCGCAGGGUGAAACGCGGCAACCUCUAUCCGGAGCAACAUCAAAUAGGCAUGCGCACAGCCUUCGGGCUGGAAAGGGCGGCUCGUUCGAGCAUGCGGGUAGGUGGCUAGAGCGUGUCAGCAAUGGCUCGCGUAGAGGAAUGAUUGCCAGUCGGGGAAACCCGGCGUACAGAAUCCGGCCUAUAGAUCUGCUUUGCAC,91,64,143,107,405
5129,0,CP000507.1/3981200-3980843,CGAGUCGACUGGGCAGUCGCUGCGCUCGCAAGAGCGGGGAGGAAAGUCCGGGCUCCAUAGAGCAGGGUGCCAGAUAACGUCUGGGCGGCGUAAGCCGACGACAAGUGCAACAGAGAACAGACCGCCUGCCUUCGGGCCGGUAAGGGUGAAACGGUGCGGUAAGAGCGCACCGCGCGACUGGCAACAGUUCGUGGCAAGGUAAACUCCACCCGGAGCAAGAUCAAAUAGGGUUCCUUAUGGCGUGGCUCGCGUUGGAACCGGGUAGAUUGCUUGAGCCUGCGAGCGAUUGCAGGCCUAGAGGAAUGGCUGCCACUCCUUUCGGGGAGAACAGAACCCGGCUUACAGGUCGGCUCACCAC,83,57,123,95,358
5130,0,AANE01000023.1/29684-29331,CAAGUUGGUCAGGCAGUCGCUGUAAUGCUGUUUCAGUGUUAUGGAGGAAAGUCCGGGCUUCGCAGGGUAAGGUGCCAGGUAACGCCUGGGGGGCGCGAGUCUACGGAAAGUGCAGCAGAAAAAAUACCGCCUAAGCAGUUUACUGCCGGUAAGGUUGAAAUGGUGCGGUAAGAGCGCACCGCGCAUCUGGUAACAGUAUGUGGCAAGGUAAACCCCACCUGAAGCAAGACCAAAUAGGAAUCCAUUGGCGUGACCCGCGCUGGAUUCGGGUAGGUCGCUAGAGGCAUGUAGCGAUACAUGUUCGAGAGGAAUGACUGUCCACGACAGAACCCGGCUUAUCGACCAACUUGCAAU,94,71,110,79,354
5131,0,AAOE01000014.1/15829-15485,GGAGUCAGCCAGACAGUCGCUGCCUGCAUUGCAGGGGGAGGAAAGUCCGGGCUCCAUAGGGUAAGGUGCCAGAUAACGUCUGGGCGGCGCGAGCCGACGGCCAGUGCAGCAGAGAGUAGACCGCCAGGCUUCUGGCCUGGUAAGGGUGAAAGGGUGCGGUAAGAGCGCACCGCGACACUGGUAACAGUGUUGGCAUGGUAAACCCCACCUGGAGCAAGACCAAAUAGGGUUCCUUAAGGCGUGACCCGCGCCGGAACCGGGUAGGUUGCUUGACCUCAGGAGCAAUCCUGCGGCUAGAUGAAUGACUGUCCAUGACAGAACCCGGCUUAUCGGCUGGCUCCCAUU,79,59,117,90,345
5132,0,AANO01000003.1/308359-307949,GAAAGCAGGUGAGGUGGUCGCGAUCGAAGGGAUGACGCCGGCUUCGGCUGGUGGCUCCGGCUUCGGUUGAGGAAAGUCCGGGCUCCCCAAUGGCCAGGCUUGCUGGGUAACGCCCAGUGCGGGUGACCGUGAGGAGAGUGCCACAGAAACACACCGCCGAUGGCCGGGGCCUGGCCCCGCGCACAGGCAAGGGUGCAAGGGUGCGGUAAGAGCGCACCAGCAGCAUCGAGAGGUGCUGGCUCGGUAAACCCCGGCUAGGAGCAAGGCCCAGGGACAACGGUUGGCCAUGACACCCGUCCCGACACAAGUGAGCCGCUCGAGGCCGCCGGUAACGGCGGUCCCAGACAGAUGCCCACCCCGGUCCGCCCCGGCGGGCCGGAACAGAACCCGGCUUAUGUCCUGCUUUCACCC,81,54,146,130,411
5133,0,CP000699.1/68791-69173,CCAGAGGGCCGGGCGGUCGCCGCGCAGCGAUGCGGGGAGGAAAGUCCGGGCUCCAAGGAGUGACGGUGCCGGGUAACGCCCGGCGGGGGCGACCCCAGGGACAGUGCCACAGAAAGCAGACCGCCCGGCGGACCGCCAAGCUCGCUUGGUAUGUUCCGGGCAAGGUCGAAAGGGUGCGGCAAGAGCGCACCGCGGUCCCGGCAACGGGAACGGCAUGGUAAACCCCACCGGGAGCAAGAUCGAAUAGGGACGGCGCAUGGGCUACUCCGCCCGGUCGUCCGGGUUGAUUGCUGGAGGCCGGGCGCGAGCCCGGUCCUAGAGGAAUGAUCGCCCAUCCGGCUUCGGCCGGUGGACAGAACCCGGCUUACAGGCCCUCUGGUUCU,72,47,146,118,383
5134,0,CP000774.1/2603043-2603414,UCAGAUGGCCGGAUGGCCGCUGCGUGCAAGCGCAGAGGAAAGUCCGGGCUCCACGGAAACACGGUGCCGGUUAAUGGCCGGCGGGGGCGACCUCAGGGAAAGUGCCACAGAAAGCAAACCGCCGGUCCUUCGGGGCCGGUAAGGGUGAAAGGGUGCGGUAAGAGCGCACCGCGCGGACGGUAACGGACGCGGCACGGCAAACCCCACCGGGAGCAAAACCAAAUAGGGGCGGCAUUUCAGGCAUUUAGCCUGACAACCCGUUUCCGGGCCGCCGCCCGGGUUGGUUGCUCGAGGCGUCCGGCAACGGGCGUCCCAGAUGAAUGGCCAUCGCCCGCAAGGGCACAGAACCCGGCUUACAGGCCAUCUGACACC,83,46,130,113,372
5135,0,CP000282.1/1090695-1091052,CGAGCCAGCUAGACAAUCGCUUCAUCCUUGUGGUGGGGAGGAAAGUCCGGGCUCCAUAGGGCAGAACGCCAGGUAACGCCUGGGGGGCGCGAGCCUACGGAAAGUGCAGCAGAGAGUAGACCGCCUGUGUUCUUGGCAACAAGAGCAUCGGUAAGGGUGAAAGGGUGCGGUAAGAGCGCACCGCGCAGCUGGUAACAGUCUGUGGCGAUGGUAAACCCCGUUCGGAGCAAGACCAAAUAGGAAUCCUACAGGUGCGGCCCGCACUGGAUUCGGGUAGGUCGCUUGAGGCGUAUGGUGACAUACGUCCCAGAUGAAUGAUUGUCCUCGACAGAACCCGGCUUAUCGGCUGGCUCAUCAU,85,66,119,88,358
5136,0,CP000158.1/471158-470783,CCAGAUGGCCGGGCAGCCGCUGGUAUGCGGGUAACUGCAUACUGGAGGAAAGUCCGGGCUCCAGGUGGACAGGGCGACGGCUAACGGCCGCCCGGCGUGAGCCGAGGGAAAGUGCCACAGAAAGGAAACCGCCCGAAGGCUUCGGCCAGAGGGUAAGGGUGAAAGGGUGGGGUAAGAGCCCACCGCAGCGCUGGCAACAGGGCUGGCAUGGUAAACCCCGCCCGGAGCAAGACCAAGUAGGGGGCACAUAUGGGCUGUCCGCCGCCCGUGCCCCGGGUGCGUCGCGCCGAGGCGUUCAGCAAUGAACGCCCCAGAGGAAUGGCUGCCAGAUCCCGCAAGGGACGAACAGAACCCGGCUUAUUGGCCAUCUGGUCUA,85,46,137,108,376
5137,0,CP000238.1/37827-37463,AAAGUUGACUAGACAGUCGCUGCUUCGCUUUUAUCAAAUAGCGUAGGAGAGGAAAGUCCGGGCUCCAUAGGGCAAGGUGCCAGGUAACACCUGGGGAGUGUAAGCUCACGACAAGUGCAACAGAAAGCAAACCGCCAAUAACCAAUUUUUUGGGAUAAGGUAAGGGUGAAAAGGUGUGGUAAAAGCGCACCACGUAGCUGGUAACAGUGUACGGUAUGGUAAACUCCACCUGGAGCAAGGCCAAAAAGAGGUUAAAAGUGUAGCCCGCAUUUAAACCAGGGUAGGCUGCUGGAACUAGUAUGUGAGUACUAGUCUAGAUAAAUGACUGUCCAAGACAGAACCCGGCUUAACGGUCAACUUCACUC,117,75,99,74,365
5138,0,AAVN02000001.1/251696-251335,UGAGUGGACCAGACGGUCGCGCGAUGUGCUGUUUGCAGUACGCGUGAGGAAAGUCCGGGCUCCAGAGGGCGGGAUGCCGGCUAACGGCCGGGCGGAGUGAUCCGACGGAAAGCGCCGCAGAAAAGAAGACUCCCACCUGCGCCGCAAGGCGUAAAGGGAAAAGCUGAAACGGUGGUGUAAGAGACCACCAGCGUCGUGGCAACACGGCGGCUUGGCAAGCCCCAUCCGGAGCAAGCGCGAAUAGGAACGCUAUGGGCCGGCCCGGUCCGCGUUCGGGUAGCGUGCGUGGAGCUGCACGGUAACGUGCAGACAAGAUAAAUGACCGUUCACGACAGAACCCGGCUUAUAGGCCCACUCAGCAC,88,49,126,99,362
5139,0,CT978603.1/132775-132410,GAAAGCAGGCGAGGUGAUCGCAGUUGCCGCUGCUUGCAGUGGUGGCUGAGGAAAGUCCGGGCUCCCGAAUGGCCAGGCUUGCUGGGUAACGCCCAGUGCGGGUGACCGUGAGGAGAGUGCCACAGAAACACACCGCCGAUGGCCGGCUUGCCGGCACAGGCAAGGGUGCAAGGGUGCGGUAAGAGCGCACCAGCAGCAUCGAGAGGUGCUGGCUCGGUAAACCCCGGCCGGGAGCAAGGCCCAGGGACGAUGGUUGGCCAUUGACCGGUCCCGACAACAGCGCGCCGCUCGAGGCCACCGGUAACGGUGGUCCCAGACAGAUGAUCAUCCAGCGAACAGAACCCGGCUUACGUCCUGCUUUCCGCC,77,52,129,108,366
5140,0,CP000097.1/185956-185566,GAAAGCAGGCGAGGUGGUUGCAAUUGAAUCGUUCGCGAUUCAAUUGAGGAAAGUCCGGGCUCCCCGAUGGCCAGGCUUGCUGGGUAACGCCCAGUGCGGGUGACCGUGAGGAGAGUGCCACAGAAACACACCGCCGAUGGCCGGUUCGCCGGCACAGGCAAGGGUGCAAAGGUGCGGUAAGAGCGCACCAGCAGCAUCGAGAGGUGCUGGCUCGGUAAACCCCGGCUGGGAGCAAGGCCAAGGAACGAUGGCUGGCCAUCUGCCCCGUUCCGCUUUAUGCGCCGCUCGAGGCCGUCGGCAACGGCGGUCCCAGAUAGAUAACCACCCACCCUCUGCAGACCAACCUCUGUGGUGGUGUGAACAGAACCCGGCUUAUGUCCUGCUUUCACCC,84,66,126,115,391
5141,0,AAPI01000003.1/215670-216054,CGAGUUGACCAGGCAGUCGCUGUGUUGAUUUCUCUGAUGUUCGCUUGCGAUCAUUAAGGGUGCAACGCGGAGGAAAGUCCGGGCUCCACAGGGUAGAGUGCCAGGUAACACCUGGGAGGCGAAAGCCUACGGCCAGUGCAGCAGAGAGAAGACCGCCGAUGGUUCGUUCGCGAACACAGGUAAGGGUGAAAGGGUGCGGUAAGAGCGCACCGCGCUGCUGGUAACAGUAGUGGCAAGGUAAACCCCACUCGGAGCAAGACCAAAUAGGUUUCCAUAUGGCGCGUCCCGCGUUGGGAACGGGUAGGUUGCUUGAGGCAAACGGCGACGUUUGUCCCAGAUGAAUGACUGUCCAAGACAGAACCCGGCUUAUCGGUCAACUCACCUA,95,73,124,93,385
5142,0,CP000089.1/575353-575735,AAAGUCGGCCAGGCAAUCGCUGGGCACGUAAGUGCCGGGAGGAAAGUCCGGGCUCCAUUGGGCGGGAUGCCAGUUAACGGCUGGGUGCUAUACGGUCGCAAGACCUAAGGCAACGGAAAGUGCAACAGAGAAUAGACCGCCGAUGGCGUUGUAAGACGCACAGGUAAGGGUGAAACGGCGAGGUAAGAGCUCACCGCGUCCACGGUAACGGCGGACGGCACGGUAAACCCCAUCCGGAGCAAGACCAAAUAGGGAAGCUGAGGCGUGGCCCGCGCUGCUUCCGGGUAGGUUGCUUGAGCCUGUCGGUGACGGCAGGCCUAGAGGAAUGAUUGCCGAACCUCGCAAGAGGGGAACAAAACCCGGCUUAUCGGCCGGCUUUCCAA,97,57,132,97,383
5143,0,CP000283.1/3783877-3784306,UCAGUCGGCCGGACGGCCGCUCCGGCAAGCGCCGAAAGGCCGCCGGGGAGGAAAGUCCGGGCUCCAUCGACAUACGGUGCCGGAUAACGUCCGGCGGGGGCGACCCCAGGGAAAGUGCCACAGAGAACGAACCGCUUCCCCCUCCCCUCGGGGUGGGGGCGAGUAAGGGUGAAAAGGUGCGGUAAGAGCGCACCGCGUCGCCGGCAACGGAGACGGCAUGGUAAACCCCACCGGGAGCAAAACCGAAUAGGGACGGCAUCGCGGACAGUUCGCUUUCGGGCGAUAACUCCGCAGGGCGAUGUCAGGCUCGCCGUCCGGGUAGGUUGCUCGAGGCCAUGUGCAAACAUGGUCCCAGAGGAAUGGCCGUCACGUAUCGGCUGCGCAAGCAGCCGGUGCCCUCCAGAACCCGGCUUACAGGCCGACUGAUACU,92,56,150,132,430
5144,0,X16580.1/131-474,GGAGUGGGCCAGGCGACCGCCGCGGAGCAAUCCGGGGAGGAAAGUCCGGGCUCCAUAGGGCAAGGCGCCGGUUAACGGCCGGGGGGCGUGAGCGUACGGAAAGUGCCACAGAAAAUAUACCGCCAAGCGCGUAAGCGCGGUAAGGGUGAAAAGGUGCGGUAAGAGCGCACCGCAUUUCCGGUAACGGAAAUGGCAGGGAAAACCCCGCCUGGAGCAAGACCAAAUAGGCGUGCGAUACCGUGGCCCGCGGUGCACGCGGGUAGGUUGCUGGAGCCUGUGCGUAAGUGCAGGCCUAGAGGAAUGGUCGUCCACGACAGAACCCGGCUUAUCGGCCCACUCCAAUU,83,46,125,90,344
5145,0,ABCH01000023.1/63801-64207,GAAGUUGACUGGAUAGUCGCUGCUUCGUUGACGUCCCCUUGAGCUUGUCUUGGGGGAGACUGACGGAGGGGAGGAACGUCCGGGCUCCACAGAGCAGGGUGCCAGGUAACGCCUGGGGGGCGUGAGCCCACGACAAGUGCAGCAGAGAGAAGACCGCCGAUGGCUCCAUUUCUUCGGAAGGAGCACAGGUAAGGGUGAAAGGGUGCGGUAAGAGCGCACCGGACGACUGGUAACAGUUCGUUGCAAGGUAAACUCCACCCGGAGCAAGACCAAAUAGGCUUCCACAUUGCGUUGCUCGCGUAUGGAGGCGGGUAGGUUGCUCGAGCCAGUGAGCGAUUGCUGGCCUAGACGAAUGGCUAUCACCGCUUCGGCGGAUACAGAACCCGGCGUACAGGUCAACUUCACCU,93,75,138,101,407
5146,0,AAQH01000027.1/16807-16441,GGAGUUGGCCGCACGAUCGCUGCUUGAAUUUGUUCAAGGAGAGGAAAGUCCGGGCUCCAUAGGGCAGGGUGCCAGAUAACGUCUGGGGGGCGUGAGCCCACGGCCAGUGCAGCAGAGAGUAUACCGCCGAUGGCUAUUUAGGUAGCACAGGUAAGGGUGAAAGGGUGCGGUAAGAGCGCACCGCGCGUCCGGUAACGGUACGCGGCAUGGUAAACCCCACUCGGAGCAAGACCAAAUAGGUUCCCUGAGGUGCGGCCCGCACUGGGAACGGGUAGGUUGCUUGAGCUUUGGAGCGAUCCAAAGCCUAGAUGAAUGAUCGUGACCUUGUUCGCAAGGGACAGAACCCGGCUUAUGGCCAACUCCACUU,86,68,124,89,367
5147,0,ABBZ01003066.1/465-96,AGAGUUAGUCGGGUAGUCGCUAUAUCUUGAAAAUCAGAUAUGGAGGAAAGUCCGGGCUUCACAGGACAAGGUGCCAGGUAACGCCUGGGGGGCGUGAGCCUAUGGAAAGUGCCACAGAAAAUAUACCGCCUAAGUCCAUUAAGGACCGGUAAGGGUGAAAUGGUGCGGUUGGUGAGUUAUCGGCUUAAUGUAAGAGCGCACCGCAUUGAUGGUAACAUCAAUGGCAGGGUAAACCCCACCUGAAGCAAGACAAAUAGGGGAAUUAUAAUGUGGUCCGCAUUGUUCCCGGGUAAGUUGCUAGAGGUGUUUGGUGACAAGCAUCCCAGAUGAAUGACUGCCAUACGGAUGAUUUUUCAAGCCGGCUUUUGAU,104,87,110,69,370
5148,0,AM286690.1/644585-644964,CGGACCGGUUAGACAGUCGCUGGCGGUGGUUCUUUUAAAGAAUGGCCGCUGGAGGAAAGUCCGGGCUCCAAAGGGCAGGGUGCCAGGUAACGCCUGGGGGCCACACUGGGAACGGUGUGGUUACGGCUAGUGCCACAGAGAAGAUACCGCCUUUUCCUUCCUCGCGUUGGAAUCGGUAAGGGUGAAAAGGUGCGGUAAGAGCGCACCGCGCUGCUGGUAACAGUGGUGGCAGGGUAAACCCCACCCGGAGCAAAACCAAAUAGGGAUCCGUUGGCGUGGCCCGCGCUGGAUCCGGGUAGGUUGCUAGAGGUUUGUGGCGACGCAAACCCAAGAUGAAUGACUGUCCACGACAGAACCCGGCUUAUCGACCGGUCCACCUU,85,71,128,96,380
5149,0,CT971583.1/222102-221705,GAAAGCAGGCGAGGUGAUCGCGACCAACCCUGGGCUUCGUGCACAGGCGAGGUUGAGGAAAGUCCGGGCUCCCCGAUGGCCAGGCUUGCUGGGUAACGCCCAGUGCGGGUGACCGUGAGGAGAGUGCCACAGAAACACACCGCCGAUGGCCCCAUGGGAGCAAUCCCUUUGGCACAGGCAAGGGUGCAAAGGUGCGGUAAGAGCGCACCAGCAGCAUCGAGAGGUGCUGGCUCGGUAAACCCCGGCCGGGAGCAAGGCCCAGGAACAACGGGUGGCCAUCAUCCCCGUUCCGCCUUUGUGAGCCGCUCGAGGUCGUCGGUAACGGCGAUCCCAGAUAGAUGAUCACCCCCCUUCCGCGGAAGGGAGAACAGAACCCGGCUUAUGUCCUGCUUUCACCC,87,60,131,120,398
5150,0,CP000509.1/2179161-2178773,UGGGCUGGCCGGGCGACCGCGUGGAGGAGACUCCCCGAGGAAGGUCCGGGCUCCACAGGGCAGAGUGGUGGGUAACACCCACCCGGGGCAACCCGCGGGACAGUGCCACAGAGAACAGACCGCCCCGCCCCGCUCCGGCGAGGAGGGGUAAGGGUGAAACGGCGGUGUAAGAGACCACCAGCGACCGGGGCGACCCGGCCGGCUCGGCAAACCCCACUUGGAGCAAGGUCAAGAAGUCCCGUGCUUGCACGGGACGCGCGCACGUUCGAGGGCGGCCCGCCCGAGUGCGCGGGUAGACCGCUGGAGGGUGUCGGCAACGGCACCCGUAGAUGGAUGGUCGCCCCCCGGCUCGCCGGGGACAGAACCCGGCCUACAGGCCAGCCCAUCCG,74,37,147,131,389
5151,0,AAVV01000010.1/123053-122711,AGAGCUGAUUAGACGAUCGCUGUCGCCUUAGGUGAUGGAGGAAAGUCCGGGCUCCUGAGGUCAGAGUGCCAGGUAACGCCUGGGGGGUGUGAGCCCACGGAAAGUGCAGCAGAAAGGAAACCGCCUGGCUUGCCAGGUAAGGGUGAAAAGGUGCGGUAAGAGCGCACCGCGCGGCUGGUAACAGGCGUGGCGAUGGUAAACCCCACUCGGAGCAAGACCAAAUAGGGAUCCAUUAGCCGUGACCUCCGGCGGAUCCGGGUAGGUCGCUACAGGCGAACGGUGACGUUCGUCGCAGAUGAAUGAUCGUCCAAGACAGAACCCGGCUUAUCGAUCGGCUCAUUCU,83,59,117,84,343
5152,0,CP000117.1/977743-978184,GAGAGUAGGCGUUGGCGGUUGCAGACCAGUUAGUUUAACUGAUUUGAGGAAAGUCCGGACUCCCGAAAGACCAGACUUGCUGGAUAACUUCCAGUGCGAGCGAUCGUGAGGAUAGUGCCACAGAAAAAUACCGCCAAAACAAUUCAAAAUUCAAAAUUCAAAAUUCAAAAUGAAUAAUUUUGGAUUUUGAGUCUUAGUUAUGAAUUCAAUUUUGGUAAGGGUGCAAAGGUGCGGUAAGAGCGCACCAGCAGUAUCGAGAGGUACUGGCUCGGUAAACCCCGGUUGGGAGCAAGGCCGAAGGAACUAUGGUUGGUCUUUUACCAGUUCCGUUAUCAGAGAGCCGCUAGAGGCGUUUGGUAACAAACGUCCCAGAUAGAUAAUCGCCCUCGUGUAAAGCAAUUUACACAGAGAACAGAACCCGGCUUACUACCAACUCUCUCCU,135,106,110,91,442
5153,0,AAPJ01000001.1/686700-686262,CCAGCCGGCUGGACGGCCGCUCCCGUCACAUGUCGAAAGACGGCGGGGGAGGAAAGUCCGGGCUCCACGGAGAAACGGUGCCGGAUAACGUCCGGCGGGAGUGAUCCCAGGGAAAGUGCCACAGAAAACAGACCGCCCCGCCUGCAGUGCGGCUCGCGCGACGAAGCGCGACGGAGCCGCAGUGCUGGCGGGGUAAGGGUGAAACGGUGGGGUAAGAGCCCACCGCGUCUCUGGCAACAGCGACGGCACGGCAAACCCCACCGGGAGCAAGACCGAAUAGGAACGACGCGGUCGGUCCGUCGCAAGACGGGUCGCCAGCCCUCUCCGGGCCGGUCGUUCGGGUAGGUUGCUAGAGGCGGCCCGCAAGGGUCGUCCCAGAGGAAUGGUCGUCCGGCGGUCAAUCCGCUGACAGAACCCGGCUUACAGGCCGGCUGGCACU,91,51,161,136,439
5154,0,AP006861.1/929836-930219,CGGAAGAGAAAGGCAACCGCUUCCUGUAUCUCUAGUAGAUAUGGUAAGAGGAAAGUCUGGACUUCAUAAGAAGAGAUACUGGAGAAACUCCAGGGGCCGUAAGGCUACGGAAAGUGCAACAGAAAACACUCCGCUAUAAUAUAGACAGGCUGAAAAUUCCUACUUUAAGAGUAGGAGCUAUUAAGGUGACUUAAUAGACGUGCAAACCCUAUCUGAAGCAAGAGAAAAAGUUUUUGUUUCUGCAUAAUGAGGAGCUCUGUUCCUCAUAAACUUUUUCACAAUCGCUUGAGGGAUAUAGUAAUAUAUCCCCUAGAUGAAUGGUUGCCCUCAAGAUGGUCUUUGCCAUCUUGUAGACAGAAUCCGGCUUACUCUCUCUUCCGAUAU,122,102,85,75,384
5155,0,CP000088.1/2284408-2284025,GGAGUCGGCCAGACGGCCGCGGCACCGCGCACGCGGUGUCGAGGAAAGUCCGGACUCCACAGGGCAGGGUGGUCGGUAACACCGACCCGGGGUGACCCGCGGGAUAGUGCCACAGAAAACAGACCGCCGUCCCCGUGGGACGGUAAGGGUGAAACGGUGGUGUAAGAGACCACCAGCGGCCGGAGUGAUCCGGUCGGCUAGGUAAACCCCACCCGGAGCAAGGUCAAGAGGGAGACUUCGGUCUCCUGCACGGACGCUUGAGGGCGGCCCGUCCGAUGUCCGUGGGUAGACCGCAUGAGGCCGCUGGCAACAGCGGUCCUAGAUGGAUGGCCGUCACAACCCGUUCAGGGUUGACAGAAUCCGGCUUACCGGCCGACUCCCUGU,79,53,137,115,384
5156,0,CP000781.1/1989320-1989711,CCAGCCGGCCGGGCGGCCGCGGUGUGGGACCUUGCGUCCGCAUCGAGGAAAGUCCGGGCUCCACUCAGACACGGUGCCGGAUAACGUCCGGCGGGGGUGACCCUAGGGAAAGUGCCACAGAAAACAAACCACCCGCGAAGGACUUUCGGGUCCGCGUGGGCCAGGGUGAAACGGUGGGGUAAGAGCCCACCGCGCGACCGGCAACGGGAGCGGCACGGCAAACCCCACCGGGAGCAAAGUCGAAUAGGGACGGCACGGGAAACCACCCCUGUCUGCGGGGCGCCGUCCGGGUUGACUGCUAGAGGCGCCGGGCAACCGGCGUCCCAGAGGAAUGGUCGCCACGCGGGUGCAAGCCCGCCGUACAGAACCCGGCUUACAGGCCGGCUGGUGCA,81,42,144,125,392
5157,0,BA000012.4/1306844-1306445,CCAGCUGGCUGGGCGGCCGCACUCGCAAACGCCGAAAGGCCGCAAGUGAGGAAAGUCCGGGCUCCAUGGAGACACGGUGCCGGUUAAUGGCCGGCGGGGGCGACCCCAGGGAAAGUGCCACAGAAAGCAAACCGCCACGACUUUGUCGGGGUAAGGGUGAAAGGGUGGGGUAAGAGCCCACCGCGCGACUGGCAACAGGAGCGGCACGGUAAACCCCACCGGGAGCAAAACCGAAUAGGGGCGGUGCGAGGGGAAACCCUCGAGGGCUGUUUCCGGCUCACCGUCCGGGUAGGUUGCGUGAGGCGCAUGGCAACAUGCGCCCAAGAUGAAUGGCCGCCACGUUCUCGUCCCGCGAGGGGCGAGGGCCAUACAGAACCCGGCUUACAGGCCAGCUGGCAGU,91,48,146,115,400
5158,0,AAYI02000004.1/1757034-1756671,UCUGCCGGCCGGGCGGCCGCGCGCGGAAACGCUCGAGGAACGUCCGGGCUCCACAGGGCAGGGUGGUGGCUAACAGCCACCCGGGGUAACCCGCGGGACAGUGCCACAGAAAACAAACCACCGACGCGUAUGCGGCGGUAAGGGUGAAAAGGUGAGGUAAGAGCUCACCAGCGGCGCAGGUGACUGCGUCGGCUAGGUAAACCCCACCCGGAGCAAGACCGAGCAGCAGGCAGGGCGGCCCGUCCAAUGCCUGCGGGUAGGUCGCUGGAGGCCGUCGGUAACGACGGUCCUAGAUAGAUGGUCGCCACCGCACGACCGGUAACGGCGUGCGCGACAGAACCCGGCGUACAGGCCGACAGAUGCC,81,39,132,112,364
5159,0,CP000713.1/444808-445211,UUGGUAAACCAGACGAUCGCCGUUUUAAGUUAAAUAUUGAUGCGUUAAGUGUGAUUAUUUAAGACAAAAGGGAGGAAAGUCCGGGCUACAUAAGGCAGCGUGCCAGCUAACGGCUGGGCGGGGUAACCCGACGACAAGUGCAACAGAGAGCAGACCGCCUCAAUUUAAGCUCUACAGCCUAGCUGUAAAGUGGUGAGGUAAGGGUGAAAGGGUGCGGUAAGAGCGCACCGCGUGGCUGGCAACAGUUCAUGGCAAGGUAAACUCCACGCGUAGCAAGACCAAAUAGGUGUCCAUUACUUGUCGCCUGCAGGGGACACGGGUAGGUUGCUUGAGCGUACUGGCAACGGUGCGCCUAGAUGAAUGAUCGUUCACGACAGAACCCGGCUUAUCGGUUUACCAAAAUA,114,84,120,86,404
5160,0,AAOF01000005.1/51333-50979,GAAGUUGGCUGGGCAGUCGCUGUGUCGUUAACGGUGCAGAGGAAAGUCCGGGCUCCGUAGGGCGAGGUGCCAGGUAACGCCUGGGCGGCGUGAGCCGACGGAAAGUGCCGCAGAAAACAGACCGCCGAUGGCCCGACCAACGGGCUCAGGCAAGGGUGAAAAGGUGCGGUAAGAGCGCACCGCGCGGGUGGCAACACUCCGUGGCACGGUAAACCCCACCUGGAGCAAGACCAAAUAGGGAAGCGAGCGUGUGGCCCGCACGGCUUUCGGGUAGGUCGCUUGAGGUGCGCGGUGACGCGUACUCCAGAGGAAUGGCUGCCUUCGACAGAACCCGGCUUAUAGGCCGGCUUCCCGU,76,52,131,96,355
5161,0,AM180252.1/544020-543659,GGAGUCAAGUGGACUGUCGCUGCAUAUCCUUUUAUGGAUUUAUGGAGAGGAAAGUCCGGGCUUCAUAGGGUAAAACGCUGGGUAACACCCAGGAAGAGUGAUCUUCGGCAAGCGCAACAGAAAGUAAACCGCCAUUAUUAAUAAUAGUGGUAAGGGUGAAACGGUGGAGUAAGAGUCUACCAGUCGUUAUAGUGAUAUAGCGAGCUAGGCAAGCCCCGUUUGAAGCAAGACCAAAUAGGGGAACAGGCUGACCCGGCCAAUGUUCCUGGGUAGGUUGCUUGAGAAUAUAGGUAACUAUAUUCCUAGAUGAAUGACAGUCGCCCAUUAGGGUACAGAACCCGGCUUAUAGCUUGACUCCUUUA,107,86,100,69,362
5162,0,CP000513.1/836438-836105,UGAGUUUGCCAGACAAUCGCUGACGAAAGUUGGAGGAAAGUCCGGGCUUUAUAGGGCAAAGCGCUGGGUAACGCCCAGGCAGCGUGAGCUGACGGAAAGUGCCACAGAAAAGAUACCGCCUCGAUUGAGGUAAGGGUGAAAUGGUGCGGUAAGAGCGCACCGCAUUUGCGGCAACGUAAAUGGCAGGGAAAACCCCGCUUAAAGCAAGACCAAAUAGAGAAUCAAUGCGGCGGCCCGUCGUGAUUCUGGGUAGGUCGCUAGAGGCUGGCAGUAAUGUUAGUCGCAGAGGAAUGAUUGUCCACGACAGAACCCGGCUUAUCGGUGAACUCAUCUU,94,63,105,72,334
5163,0,CP000697.1/3151296-3151687,CCAGACGGUUGGACGGCCGCCGUGCCGCUCGCGGCGCGGAGGAAAGUCCGGGCUCCAUGGAAUGACGGUGCCGGCUAACGGCCGGCGGGGGCGACCCCAGGGAAAGUGCCACAGAAAACAUACCGCCGGUACGCCUCGGCCUGCCGGCAAGGGUGAAAAGGUGCGGUAAGAGCGCACCGCGCCGCCGGCAACGGGGGCGGCAGGGAAAACCCCACCGGGAGCAAGACCGAAUAGGGGCGACCGGCGGCAUGAGCGAUCAUGGCCGCGGAGGGAUUCCGCCUCGUCGCCCGGGUUGGUCGCGCGAGGCACGCAGCGAUGCGUGUCCCAGAUGAAUGGCCGUCCAGCAUCCGCGAGGGUGUGGACAGAACCCGGCUUACAGACCGUCUGGCAUU,78,44,149,121,392
5164,0,CP000473.1/5196142-5195786,GCUGCCGGACGGGUAGUCGCUCCCAUUUUUGGGAGAGGAAAGUCCGGUCUCCAUAGGGCAGCGUGCCGGCUAACGGCCGGGCGGAUCGUAAGGUCCGACGGAUAGUGCCACAGAAAAUAUACCGCCUCGCCUUCGGGCGCGGUAAGGGUGAAAUGGUGCGGUAAGAGCGCACCGCGGCAGGAGUAAUUCUGCCGGCAGGGAAAACCCCACGCGGAGCAAGACCAAAUAGGGGAGGAGGGGCGGCCCGUCCCGCUUGACUUCCGGGUAGGUCGCUAGAACCGGUCAGUAAUGGCCGGUCCAGAGGAAUGACUACCGCCCGCAAGGGUACAGGAACCGGCUUACAGUCCGGCAGCUAAU,81,55,125,96,357
5165,0,CP000232.1/651737-652153,UGAGUAAACCGGAUGGUCGCAGGCGCUUGCAAGCGCCUGAGGAAAGUCCGAGCUCCGCAGGGCAGGGUGCUGGAUAACGUCCAGUGGAGGCGACUCCAAGGAUAGUGCCACAGAAACAGACCGCCCAGCACUCAAUUCGACAGUUGAACCCGGCCUGCUAUAAGUAUCCUUAAUUUCAGGUUCGGGCCUCACCUGUCGAGUUGAGUGCUGGGUAAGGGUGGAAAGGUGAGGUAAGAGCUCACCAGCGGUUAGGCGACUAACCGGCUCGGUAAACCCCACCUGGAGCAAGACCGAAUAGGGGGACAAAAGGGGUGGCCCGCCCCGUCCCCGGGUAAGGUCGCUUGAGGCGCCAGGCAACUGGCGUCCUAGAUAGAUGACCAUCCACGACAGAACUCGGCUUACAGGUUUGCUCAAAAG,104,72,131,110,417
5166,0,AE017126.1/1616782-1617172,GAAAGCAGGAGAGGUGAUCGCAAUCGAGAUUUAUCGCGUUUCCGCAAUAAACUCUCGGUUGAGGAAAGUCCGGGCUCCCAGAUGGUCCAACUUGCUGGGUAACUCCCAGUGCGGGUGACCGUGAGGAUAGUGCCACAGAAACACACCGCCGAUGUCUCAUAGAGCACAGGCAAGGGUGCAAAGGUGCGGUAAGAGCGCACCAGCAGUAUCGAGAGGUACUGGCUUGGUAAACCCCGGUUGGGUGCAAGGCAAAGGUUUUAGGAUGACCAUUUUGCCUAUUUCCUAUUUAAAGCCGCUCGAGGCUGUUGGAGACAACAGUCCCAGAUAGAUGAUCACCCACUAACCAAUUUUGGAUAGUGAACAGAACCCGGCUUACUUCCUGCUUUCUUUC,102,89,107,93,391
5167,0,CP000478.1/2009941-2009564,UGGAGUAGCACAAAUGAUCGCCGGUUCCGUACGGGAUCGGAGGAAAGUCCGGGCUCCACAGGGCAGGGUGCUGGGUAACGCCCAGUCCCGGUGACGGGGAGGAUAGCGCCACAGAAAGCAAACCGCCCUGCAUUGCGCAGGGUAAGGGUGAAACGGUGAGGUAAGAGCUCACCAGUCCCGAUGGUGACAUCGGGAGCUAGGCAAGCCCCACCCGGAGCAAGACCGAAUAGGAGAGCGUUUGAGGGCUGCCCGUCCGAGGCUCUCGGGUAGGUUGCUUGAUCCCGCCGGCAACGGCGGGACUAGAGGAAUGAUCAUUGCCUUUCGUCGCCUGCGGGCGUUCGAGGGGAACAGAACCCGGCUUAUGGGCUGCUCCAAAUU,84,62,133,99,378
5168,0,AE017283.1/718289-718669,CGAGCCAUCCGGGUGAUCGCGGCAGCGGUGAGUUGUCGAGGAAAGUCCGGGCUCCAUAGAGCAGGGUGGUGGGUAACGCCCACCCGGGGUGACCCGCGGGAAAGUGCCACAGAGAACAGACUGCCGGUUUCGAGCCGGUGAGGGUGAAACGGUGGAGUAAGUGCCCACCGCGUCAUCGGUGACGGUGACGGCAUGGCAAACCCCACCUGGAGCAAGGCCAAGAAGACCGUGAGGUCGCGGACGCGUUUGAGGGUUGCUCGCUUGAGUGUUCGGGUAGGCUGCGCAGCCGAAAGGCUGGAGGACACCAGCAAUGGUGUUCACAGAUGGAUGAUCACCGGCCCGGCGGGGCUACAGAACCCGGCUUAUAGGAUGGCUCGUCCC,80,60,142,99,381
5169,0,L78818.1/7603-8020,CGAGUUGGCUGGGCGGCCGCGGCUCGUGUCGGUCUGAAAGGCCCGGUAACGAGUCGAGGAAAGUCCGGACUUCACAGAGCAGGGUGAUUGCUAACAGCAAUCCGAGGUGACUCGCGGGAUAGUGCCACAGAAAACAAACCGCCAUCCUCGCGGUGGUAAGGGUGAAACGGUGCGGUAAGAGCGCACCAGCAUCCCGGGUGACCGGGAUGGCUUGGUAAACCCCACCCGAAGCAAGGUCAAGAAGGCUGCACUACAAGUGCGGCCGCGCAGGCGUUCGAGAGCUGCUCGCCCGAGCCUGCGGGUAGGCCGCUUGAGGCACCCGGCAACGGUGUGUCCAGAUGGAUGGUCGCCGCCGCGCCACCGUAGGCAAUGCCGCGUUGGCGGGGAACAGAAUCCGGCUUAUAGGCCAACUCGCCCG,90,62,146,120,418
5170,0,CP000494.1/6425339-6425766,UCAGUCGGCCGGACGGCCGCUCCGGCAGGUGCCGAAAGGCCGCCGGGGAGGAAAGUCCGGGCUCCAUCGACAUGCGGUGCCGGAUAACGUCCGGCGGGGGCGACCCCAGGGACAGUGCCACAGAGAACGAACCGCUUCCUCCCGAAAGGGAGGCGAGUAAGGGUGAAAAGGUGCGGUAAGAGCGCACCGCGGGGCCGGCAACGGAACCGGCAUGGUAAACCCCACCGGGAGCAAAACCGAAUAGGGACGGCCACGCGGAGACAAUCGCCUUUGGCGAUGACGUCCGCGGGAGCGAUGUCAGGCUCGCCGUCCGGGUAGGUUGCCCGAGGUCUCGCGCAAGCGCGAUCCCAGAGGAAUGGCCGUCACGUAUCGUCAUGCGCAAGCAUCACGGUGCCCUACAGAACCCGGCUUACAGGCCGGCUGAUAUG,94,52,153,129,428
5171,0,CP000431.1/1253711-1253273,CGAGUUGGCCGGGCGACCGCGGCACAGGGAACCAGCACUUCAGUGCACAGGCCCUGAGUCGAGGAAAGUCCGGACUCCACAGAGCAGGGCGGUUGUUAACGGCAACCCGAGGUGACUCGCGGGACAGUGCCACAGAAAACAGACCGCCGAUGCCACAUCCUCCGGGGUGUGGCGUCGGUCAGGGUGAAACGGUGCGGUAAGAGCGCACCAGCACCCCGGGUGACCGGGGUGGCUAGGUAAACCCCGCCCGGAGCAAGGUUGAAGGCCGCACCGGUUCCUCCGGGAUCCCGGUGCGGCUGCGCAGGUGUUCGAGGGCUGCUCGCCCGAGCCUGCGGGUGAACCGCUCGAGGUACCCGGCGACGGUGUGCCCAGAUGGAUGGUCGCCACCCGGCGCUUCGGCGCCCGGGGACAGGAUCCGGCUUACACGCCAACUCGUUCG,81,60,159,139,439
5172,0,AAMS01000003.1/69108-69502,GCGGAUGGCUGGAUGGCUGCGGGCCUGUCAUGGGUUCGAGGAAAGUCCGGACUCCACAAAGCACGGUGCCGGGUAACGCCCGGCGGGGGUAACCCCAGGGAAAGCGCCACAGAGAACAGACUACCUCGUAUAGCGGGGAAAAGGUGAAACGGUGGGGUAAGAGCCCACCGCGGGACGGGCAACCGGACCGGCACGGCAAGCCCCACCGGGAGCAAUGCCAAAUAGGGACCGCGCGCGGUGUUGAUCCUGCAAAGGAUAUCAGCCGCAGGGAGGCUUGAGCCCGAGCGGUCCGGGUUGGCAGCUAGAGAGCGUCUGGCAACAGGCGUUCCAGAUGAAUGGUCAUCCAGGGUGGUUCGCCACCUGGACAGAAUCCGGCUUACAGGCCAUCCGCGCAA,92,52,142,109,395
5173,0,CP000115.1/2681927-2682376,UCAGUCGGCUGGACGGCCGCUCCCGCUCGGGCCGAAAGGCUUGCGGGAGAGGAAAGUCCGGGCUCCAUCGACAUACGGUGCCGGAUAACGUCCGGCGGGGGCGACCCCAGGGACAGUGCCACAGAGAACGAACCGCCGCGUCCACUUCUAUUCUCCGCUUGCCGGGGAGAGAACAGUGUGAGCGGUAAGGGUGAAAAGGUGCGGUAAGAGCGCACCGCGCCUCCGGCAACGGAGGCGGCAUGGUAAACCCCACCGGGAGCAAAACCGAAUAGGGACAGCAUAGCGAGGGGUUCGCCUUGGCGAUAACACCGCGGAGCCAUGUCGGGCUCGCUGUCCGGGUAGGUUGCUUGAGGCAACGUGCAAACGUUGUCCCAGAGGAAUGGCCGUCACGCACCGCGUGCGCAAGUGCGCGGUGCCCUACAGAACCCGGCUUACAGGCCGGCUGAUAUC,96,65,157,132,450
5174,0,CP000555.1/489173-489511,GAAGUGGGCCAGACCGCCGCUGGCACACCGGCCGAAAGGCCGUGCUGGAGGAAGGUCCGGACUGCACAGGGCAGCGCAGCAGCCAACGGCUGUCCACCGCAAGGUGAGGAUCAGAGCAACAGAGACGAGUCCGGGCGGCGUAGCCGUCCGGGGUGAAACGGGCAAUCUCUGCGCGCAGCAACACCAAAUAGGCCAGCGUCGAUGUGGCUCCGCGGAGCUGGCGGGUAGGUGGCACCGAGCCGUUCCCGCGAGGGGCGGCCCAGAGGAAUGGCGGUCACGGCCGCGACGCCGCAAGGCGCCGCGGCCGCACAGAAUCCGGCCUAUCGGCCCGCUUCACAC,69,34,126,110,339
5175,0,AP009044.1/2333762-2333355,UGAGGCAACCGGGUGAUUGCGUUCGACGAACUGGGGGAUUGCUCCCAAGCGUCGGCCGAGGAAAGUCCGGACUCCACAGAGCACGGUGGUUGUUAACAACAACCCGGAGCGAUCCGCGGGAAAGUGCAACAGAGAGUAAACCGCCAUCAACUUAGGUUGGUGGUAAGGGUGAAAGGGUGCGGUAAGAGCGCACCGGCAGGUCAGGUGACUGAUUUGGCCAGGUAAACCCCACCGGGAGCAAGGCAUGAGGACGUAUCCAAUGGUAUGUCUGUGCAGGUGUUGAAGGCUGCUCGCCAAGCCUGCAGGUAGCUGCUAGAGGCAGUCAGCAAUGGCUGCGACGAGAUGGAUGAUCGCCGCCGGUUGCUUUUGCAACUGGUACAGAAUCCGGCUUAUAGGUUGGCUCAUUCG,97,79,138,94,408
5176,0,AARG01000014.1/795122-794788,UUGGGUAUUCAGGUUAGUCGCUGUCUUUAUGAUAGAGGAAAGUCCGAGCUCCACAGAGCAAAAGGGUAGCUAACGGCUACUAAAAGUAAUUUUAAGGAAAGUGCCACAGAAAAUAGACCGCCAUUAAGGUAAGGGUGAAAAGGUGGUGUAAGAGACCACCAGUUUUUUAGGAAACUAAAAAAGCUUGGUAAACCCCCUUUGGAGCAAGACUAAAUAGGAAAGAUUAAGGGGUUGCUCGCUCUCUUUCAGGGUAAGUCGCUAGAGAUUAUAAGUGAUUAUAAUUCGAGAAAAAUGAUUAACAAAUACAAAACUCGGCUUAUUGAAUGCCUAAAAAU,121,84,79,51,335
5177,0,AP008231.1/2604107-2603736,GAAAGGAGGCGAGGCAGUUGCGGCUCAGGCUUCGGUUAUGGGCUGAGGAAAGUCCGGGCUCCCAAAAGACCAGACUUGCUGGGUAACGCCCAGUGCGGGUGACCGUGAGGAGAGUGCCACAGAAACAUACCGCCGAUGGCCUGCUUGCAGGCACAGGUAAGGGUGCAAGGGUGCGGUAAGAGCGCACCAGCAACAUCGAGAGGUGUUGGCUCGGUAAACCCCGGUUGGGAGCAAGGUGGAGGGACAACGGUUGGUCUUUUACCUGUUCCGUUUAUGGACCGCUAGAGGUGGCUAGUAAUAGCCAUCCCAGAGAGAUAACUGCCCUCUGUCUUCGACAGAGAACAGAACCCGGCUUAUGUCCUGCUUUCCCUA,87,73,122,90,372
5178,0,AY728386.1/651-1008,AAGAGUUGGCGCGAGAGUUGCGGAUGGGUCAAAUCAACCCAUUCGAGGAAAGUCCGGACUCCCGAAAGACCAGACUUGCUGGGUAACGCCCAGUGCGCGCGAGCGUGAGGAUAGUGCCACAGAAAAAUACCGCCUCUAAUUUUAGAGGUAAGGGUGCAAAGGUUUUGCGGUAAGAGCGCACCAGCAGUAUCGUGAGGUACUGGCUCGGUAAACCCCGGUUGGGAGCAAGGUCGAAGGGGCAAAGGUUGGUCUUUUCCCUGUCCCGUUUUAGGUGUACCGCAUGAGGCGUUUGGUAACAAACGUCCUAGAUAGAUAACUCUCCACUGAACAGAAUCCGGCUUAUGUCCAACUCUUUUCU,91,81,104,82,358
5179,0,CP000554.1/2293497-2293898,GAAAGCAGGUGAGGUGUUCGCGAUCAAGUCGUCAUUGCCCUUGGCAAGACGCGCUUGGUUGAGGAAAGUCCGGGCUCCCCGAUGGCCAGACUUGCUGGGUAAUGCCCAGUGCGGGUGACCGUGAGGAGAGUGCCACAGAAAAACACCGCCGAUGGCCUCAUGGGGUUCUACUCCAGGCACAGGCAAGGGUGCAAAGGUGCGGUAAGAGCGCACCAGCAGCAUCGAGAGGUGCUGGCUCGGUAAACCCCGGUUGGGAGCAAGGCCAAGGGGCGAUGGCUGGCCAUCUGCCACGUUCCACAUAAAUGCGCCGCUUGAGGCCGUCGGUAACGGCGGUCCUAGAUAGAUGAGCACCCACUGCUCUUGAGCAGUGAACAGAACCCGGCUUACGACCUGCUUUCACCC,90,71,131,110,402
5180,0,DQ366728.1/25651-25272,GAAAGCAGGAGAGGCAAUCGCAAGAAAGUUUUAUUUUGGAAACAAAAUAAAACUUUCUUGAGGAAAGUCCGGGCUCCCAAAUGGUCAGGCUUGCUGGGUAAUUCCCAGUGCGGGCAACCGUGAGGAUAGUGCCACAGAAACAUACCGCCUAAUACUGUAUGUAUGGCAAGGGUGCAAGGGUGUGGUAAGAGCGCACCAGCAACAUUGAGAAGUGUUGGCUAGGUAAACCCCGGCUGGGAGCAAGGCUUAGUAGAUUUAUGACCAUUACACAAUCUACUUAGAAGCGCCGCUUGAGACUGUGAAGUAAUUCCAGUCCUAGAUAGAUGAUUGCCCAUCUUAAUUUAGAUGAACAGAACCCGGCUUAUGACCUGCUUUCUAAU,115,91,98,76,380
5181,0,CP000362.1/1906740-1906341,GCGGAGGGCCGGAUGGCCGCGGCACUGGCAACAGGGUCGAGGAAAGUCCGGACUCCAAAAAGCAACGGUGCCGGGUAACGCCCGGGCAAAGCAAUUUGACGGAAAGCGCCACAGAAAACAGACCACCUGUCGUGCAGGUCGGGCAACCGAAACCGCCGACGGGCAAGGGUGAAAAGGUGGGGUAAGAGCCCACCGCGCGGCUGGCAACAGCGGCGGCAUGGCAAGCCCCACCGGGAGCAAUGCCAAAUAGGGACCGCGCGUCGCAAGACGGGGCCGCUUUGGCUCAGCAGGUCCGGGUUGGCAGCUAGAGCCUUGCGGGCAACCGCCGGGCAAGAGGAAUGGUCAUCGAACCGGGGGCAACUUCGGGGAACAGAAUCCGGCUUACAGGCCCUCCGCGCAC,98,41,144,117,400
5182,0,AE016822.1/1018030-1018399,UGGGUCGGCAAGACGGUCGCGUCGGUCUGCGUCAGCGGGCCGCCGAGGAACGUCCGGGCUCCGCAGAGCAGGGCGGUGGGUAACACCCACCCGGGGCAACCCGCGAGAAAGUGCAACAGAGAGCAGACCGCCACGGGCUCCGGCCCGCGGUAAGGGUGAAACGGUGGUGUAAGAGACCACCAGCGGCCGGGGCGACCCGGCCGGCUGGGUAAACCUCGCCCGGAGCAAGGUCAGACAGGGAACGAUGGGGUGGCUCGCUCCGUUCCCGGGUAGACCGCUAGAGGGCGGCGGCGACGUCGUCCCGAGAGAGAUGGCCGUCCACGGCGCGCAAGCGCCGUGACAGAACCCGGCGUAUCAGCCGGCCCAUUCC,71,39,142,118,370
5183,0,AP009247.1/754501-754160,GAAGUUGGUCGGAUGGUCGCUGGAGAUUGAUCUUCAGAGGAAAGUCCGGGCUCCAUAGAGCAAAGUGUUAGUUAACGGCUAGGUAUGGCGACAUAACGGAAAGUGAUGCAGAGAUUUAGACCGCCUAUUUUUAAUAGGUAAGGGUGAGAAGGUGUGGUAAGAGCGCACCGCGGGAUUGGUGACAAUCGUGGCAAGGAAAACCCCACUUGGAGUAAGCUCAAAUAGACUAACGAUAACGUUGCUCGCGAAGUUUGUGGGUAGAGCGCUAAAGCGUUUUGGUAACAAAACACGUAGAUGAAUGACCAUUUAUUACAGAACCCGGCUUAUAGACCGACUUCUUUU,101,83,99,59,342
5184,0,AJ965256.1/262911-263265,CAAGUAGACCGGGUGGCCGCCCGCCUUUAAAGCGGGAGGAAAGUCCGAGCUCCUCCAGACAGGAUGCUGGGUAACACCCAGGGGGGGCGACCCUACGGAAAGUGCAACAGAAACAUACCGCCUGUGAAAAUAGGUAAGGGCGAAAUGGUGAGGUAAGAGCUCACCGGCAGUCCGGGUGACCGGCUGGCCGGGUAAACCCCGUCCGGAGCAAGGCCAAAUAGGGGAACGCAAGGACGUCUGGCCUGUUCCCGGGUUGGCCGCAUGAACCAGACGGUAACGUCUGGUCUAGAUAGAUGGUCAUCACCUUUGCCUUCGGGCAAGGGUACAGAACUCGGCUUACAGGUCUGCUUGGCUU,86,60,117,92,355
5185,0,AE001437.1/1448287-1448628,CGAGUAAGCCAGACAAUCGCUGCUGCAAUUUGCAGGAGAGGAAAGUCCGAGCUCCAUAGGGCAGGGUGCCGGGUAACUCCCGGUCAAGGCGACUUGAAGGAAAGUGCAACAGAGAUAUACCGCCAUUUUAUAAUGGUAAGGGUGGAAAGGCGAGGUAAGAGCUCACCAGCGCAUUGGCGACUUUGCGGCUAUGUAAACCCCAUCUGGAGCAAGAUCAAAUAGGGAAGCGUUUUGGAGUGGCCCGCUCUGCUUCCGGGUAGCAUCGCUUGAAUCUUAUGGUAACAUAAGGUCUAGAUAGAUGAUUGUCGAAUACAGAACUCGGCUUACAGGUUUAGUCGUCCA,94,76,100,72,342
5186,0,CP000009.1/162636-163054,CCAGACGGCUGGACGAUCGCUGUGUGUGCGAUGAGGAUCGCAUACAGGGAGGAAAGUCCGGGCUCCAUGGGAAGACGGUACCGGCUAAUUGCCGGCGGGGGCGACCCCAGGGACAGUGCCACAGAAAACAGACCGCCCGCCGGACUGUGCCUCAUGCGUUCAUUCGCGGGGGAACAUGUUGCGGGUAAGGGCGAAACGGUGCGGCAAGAGCGCACCGCAUCUCCGGCAACGGCGAUGGUCAUGGUAAACCCUACCGGGAGCAAGACCGAAUAGGAACGGCAGGUUUCCGCAAGGAAACCGGGGGUUUCUCGCCCCGUCGUUCGGGUUGGUUGCGUGAGGCCUGCAGCAAUGCAGGUCCCAGAGGAAUGAUCGUCCCGCUUUCGGGCGGACAGAACCCGGCUUACAGGCCGUCUGGCACC,89,66,147,117,419
5187,0,BA000037.2/589369-589746,GGAGACUGACGUUGACGUCCUUCGGGAGACUGACAAAGGGGAGGAAAGUCCGGGCUCCAUAGAGCAGGGUGCCAGGUAACGCCUGGGGGGCGCAAGCCUACGACAAGUGCAACAGAGAGAAGACCGCCGAUGGCCUUGAUUCGCAAGAUGAGAGGAUCAGGUAAGGGUGAAAGGGUGCGGUAAGAGCGCACCGGACGACUGGCAACAGUUCGUAGCAGGGUAAACUCCACCCGGAGCAAGACCAAAUAGGCCUCCACAUAGCGUUGCUCGCGUUAGGAGGCGGGUAGGUUGCUUGAGCCAGUGAGCGAUUGCUGGCCUAGAGGAAUGGCUACCGCCGCGCAAGCGGAACAGAACCCGGCUUAUAUGUCGGCUCCACCC,97,58,130,93,378
5188,0,CP000474.1/2649291-2648900,UGGGUCGACCAGGCGGUCGCGCGUCACGGAAGUGGCUCGAGGAACGUCCGGGCUCCGAAGAGCAGGGUGGUGGGUAACGCCCACUCGGGGUAACCCGCAGGCCAGUGCCACAGAGAACAGACCGCCUGCGCGUCGUGAUGUUUGCAUCGCGGGGCAGCAGGUAAGGGUGAAACGGUGGUGUAAGAGACCACCAGCUCCCCGGGUGACCGGGGAGGCUAGGUAAACCCCACCCGGAGCAAGGCCAGACAGGACACGUUUGAGGGCUGCUCGCCCGAGUGUCCGGGUAGGCUGCUGGAGGGCGUCGGCAACGGCGUUCGUAGAUGGAUGGCCGCUACUCCCUUGCUGGUAACGGCAGGGGAUGACAGAACCCGGCGUAUCGGUCGACCCAUCCA,78,58,146,110,392
5189,0,AY757776.1/311-1,UAAGCCGGGUUCUGUGGGGAGGAAAGUCCGGGCUACACAGGGCAGAGUGCCGGAUAACGUCCGGGGGGCGUGAGCCUACGACCAGUGCAACAGAGAGCAGACCGCCGUUUUCUUCGGAAAAAGGUAAGGGUGAAAGGGUGUGGUAAGAGCACACCGUGCCGGUGGUAACAUUCGGCAGCAAGGUAAACUCCACUCGUAGCAAGACCAAAUAGGAACUCAAUCGGUGGCCCGCCGAGAGUUCGGGUAGGUUGCUUGAGCAUACAAGUAAUUGUGUCCUAGAGGAAUGAUUGUCCACGACAGAACCGGGCUUA,83,57,103,68,311
5190,0,AJ131089.2/7-399,GAGUAAGGCAACCGCUGUUUAUGCUUUUUCACAAUGAAAAAGCAUAAAGAGAGGAAAGUCUGGACUUCAUAAGAAAAGAUACUGGAGAAACUCCAGGGGCCGUGAGGCUACGGAAAGUGCAACAGAAAACAUUCCGCUAUAAAAUGAAAGUUUUAUAGACAGGCUGAAAAUUCCUACUUUAGGAGUAGGAGCUAUUAAGGUGACUUAAUAGACAUGCAAACCCUAUCUGAAGCAAGAGAAAAAAGCUUUUUUGUUUCUGCAAAAUUGAGAAGUUUUCUUCUCAUAAGUUUUUUCAUAAUCGCUUGAGGGAUUUAGAGAUAGAUCCCCUAGAUGAAUGGUUGCCCUCAGGGAGACGUUUGUCCAUCCUGCAGACAGAAYCCGGCUUACUCGCUC,130,104,88,70,393
5191,0,CP000771.1/981758-981428,CAAGAGGGGCGAGCAAGCGCAGGCAGCCGCACAAGGCUGUCCUGAGGAAAGUCCGGACUCCGUGGGCAGGAUGCUAGCUAACGGCUAGGUGGCGUGAGCCACGGAUAGGGCCAUAGAAACGGAAACCGCCUGAAAGGUUAUUCCGAGUAAGGCAAGGGUGGAAAGGUGAGGUAAGAGCUCACCAGCAGUGCAGUAAUGCACUGGCUUGGCAACCCACAUCCGGAGCAAGGUCAAACAGGGGGUUGGGCGGCCCCACUCUAAAUCCCCCGGGUAGACCGCUUAGACAGAUGCUUGCUCAAGACAGAAUCCGGCUUACAGCCCCUCUUGAGCU,87,51,107,86,331
5192,0,CP000116.1/116696-116988,AAAGCGGACCAGGCAACCGCUGCCAUGCGUACGCGUGGGAGAGGAAAGUCCGGGCUCCACAGAGCAGGAUGCCGGCUAACGGCCGGACGCCGCGAGGCGAGGAACAGGGCCACAGAGACGAGCGUAUUCAGUUACGGUGAAACGCGGUAACCUCCAUCCGGAGCAACACCAAAUAGGCAGACGAUGACGCGGCUCGCCGAGUCUGCGGGUAGGUGGCUUGAGCGGGUCAGCAAUGGCCCGCCUAGAGGAAUGGUUGCCCACGACAGAACCCGGCUUAUCGGCCCGCUUUCCCA,70,38,99,86,293
5193,0,BA000039.2/2191681-2192047,AUGAGUUAGCGUGGUGGUUGCGGGAGUCUGCCACUCCUGAGGAAAGUCCGGGCUUCCGAAAGACCAAGCUUGCUGGGUAACGCCCAGUGCGGGUGACCGCGAGGAAAGUGCCACAGAAAUAAACCGCCGAUGGAGGGAAACCUCACAGGCAAGGGUGCAACGGUGCGGUAAGAGCGCACCAGCAACAUCGAGAGAUGUUGGCUCGGUAAACCCCGGCUGGAAGCAAGGUGUGCUAGCGCUAAGGAACCAGGGUUGGUCUUUUCCCCAGUUCUUUGCUAGCCAGAGCCGCUAGAGGCACUUGGUAACAAGUGUCCCAGAUAGAUAACCACCCUUUGAACAGAACCCGGCUUACGUCUAACUCAUUCAU,94,70,110,93,367
5194,0,CP000490.1/1471213-1470846,GCGGAUGGCCGGAUGACCGCGGCGGCAACGUCGAGGAAAGUCCGGACUCCAUGAAGGCACGGUGCCGGGUAACGCCCGGCGGGGGCAACCCCAGGGAAAGCGCCACAGAGAAGAGACCGCCCAUGCAUGCAUGGGCAAGGGUGAAACGGUGGGGUAAGAGCCCACCGCGGGGCUGGUAACAGUCCCGGCACGGCAAGCCCCACCGGGAGCAAUGCCGAAUAGGGACCGCGCGUCGCAAGACAGGGCCGCCUUUGCCCCAGCAGGUCCGGGUUGGCAGCCAGAUCCCGCCGGCAACGGCGGGGCCAGAGGAAUGGUCAUCGAAGGGGGCGACCCCGGAACAAAAUCCGGCUUACAGGCCAUCCGCGCAA,85,34,135,114,368
5195,0,BA000045.2/3542115-3542486,AGGAGUUGGUGCGGUGGUCGCGGGCCGGGCAACCGGCCUGAGGAAAGUCCGGGCUCCCCAACGAGCGGAUUGCUGGGUAACGCCCAGUGCGCGCGAGCGUGAGGAUAGUGCCACAGAAACAUACCGCCGAUGGGGGCGCUUGCGCCCCGCAGGUAAGGGUGCAAAGGUGCGGUAAGAGCGCACCAGCGGCAUCGAGAGGUGCCGGCUCGGUAAACCCCGUCCUGAGCAAGGCGGGGGACACGUGGGUUGCUCGUUGACCGUCCCCCAACACGCCGCUUGAGGCGCCGGGCAACCGGCGUCCCAGAUAGAUGACCGCCCCGCCGCGGCUCUGCUGCGGUGGAACAGAACCCGGCUUACGUCCGGCUCCUCCAC,68,51,135,118,372
5196,0,CP000394.1/500310-499859,CCAGACGGUCGGACGGCCGCUGACCCUCCCGCUUUCGGGCAGAGGGGUUGGAGGAAAGUCCGGGCUCCACGGGAAUACGGUGCCGGCUAACGGCCGGCGGGGGCGACCCCAGGGAUAGUGCCACAGAAAACAAACCGCCCUUCCACCAUGCUUCGGCAUGAUCCGAAGGGCAUGGGUGAAACGGUGCGGUAAAAGCGCACCGCGCCCCCGGCAACGGGGGUGGCAGGGCAAACCCCACCGGGAGCAAGACCGAAUAGGGGCGGCCAGCGAGGCCCGUGUGCUCAGGACCGCAAGGUCAUGGGAUUUCAUGGGCCGGCGCAGGAGCAUUCCCGCUCCGCUGCCCGGGUUGGUCGCGUGAGGCGUGCAGCGAUGUACGUCCCAGAGGAAUGGCCGUCUCAUCCGCUUCUUUGGAAACGGGUGGACAGAACCCGGCUUACAGGCCGUCUGGCGCU,88,64,162,138,452
5197,0,CP000252.1/753012-753385,GGAGUGGAUCAGAUGAUCGCCGGCCUGCAGCAAGCAGACGGGAGGAAAGUCCGAGCUCCAGAGGGCAGGAUGGUCGCUAAUGACGACUGGAGGCGACUCUAAGGAAAGUGCCACAGAAAAUAUACCGCCCGACUCCGUUGGGUAAGGGUGAAAAGGCGAGGUAAGAGCUCACCGUUUUCCGGGUGACCGGAAAAGCAUGGUAAACCCCAUCCGGAGCAAGACCAAAUAGGAGAACAUUUGAGAGUGGCCCGCUCGACGUUCUCGGGUAGCGUCGCUUGAGGCAGCAGGCAACUGCUGUCCUAGAGGAAUGAUCAUCGCCAUACUCCGGGAGAUUGGAAUAUGGAACAGAACUCGGCUUAUGAUCUGCUCCGACU,102,66,118,88,374
5198,0,DQ645411.1/1-316,GCAUUAGAAGAUGGCCGCUAUUUUAGAAUAGAGGAAAGUCCGGGCUACAUUAGACAAAAUUCCAUCUAACGGAUGGCUAGCGCAAGCUAAGGGAAAGUGCCACAGAAAGCAAACCGCCUUUUUAAGGUAAGGGUGAAAGGGUGGGGUAAGAGCCCACCAGAGCUAAAGCAAUUUAGCUUGUUUGGGCAAACCCAAUUUGUAGCAAGAAGCGCAUGGUAAGUCUAAAUCGAUACACGCUUCGCUUGAGGAAUAUUGCAAAAUAUUUCCCAGAUAAAUGGCCAUCCAUUGACAGAACCCGGCUUAUUCUAAUGCUCAA,105,72,76,63,316
5199,0,CP000016.1/65801-66203,GGAGUUAACUAGACAAUCGCUGCUUUUUUGUGUUUACAAGUGAUUAUAUAGUUGUUGUAAUUACAAAUGAAGGGGAGGAAAGUCCGGGCUCCAAAGGGCAGAGUGCCAGGUAACACCUGGGGGAUAUUAAUCUACGACAAGUGCAACAGAAAGAAAACCGCCGAUAAUUAUUUAUAAUAUGUUAUAGAAUAAUAUGGGUAAGGGUGAAAAGGCGUGGUAAGAGCACACCAUCCGAAUUGGUAACAAUUCGCGUUAUGUAAACUCCACUCGGAGCAAGGCUAAAUAGAAGUUCAACAGUAUGGUCCGUACUGAACUUGGGUAAGCUGCUGAAACUAGUGUGUGAAUGCUAGUUUAGAUGAAUGAUUGUCCGAGACAGAACCCGGCUUAUCGGUUAACUCCUUUU,129,108,101,65,403
5200,0,BA000003.2/93359-92987,GAAGUUGACUAAAAACAGUCGCUGUUUAGUUUUUAAAAAUUAAAAAGAGGAAAGUCCGGGCUCCAUAGAGCAGGGUGCCAGAUAACAUCUGGAAAGCGUGAGCUUAUGACUAGUGCAACAGAAAAUAAACCACCUAUUUUGUAAUAUAUAAAAAUAUGGCCAGGGUGAAAAGGCGUGGUAAGAGCACACCGCAUAAUUGGUAACAAUUCAUGGCAUGGUAAACUCCACCCGGAGCAAAGCCAAAUAUAGGAUAAAUUUUUUGUACUGCUCGUACUUCUUAAACCUGGGUAGGCUGCUUGAAUUAGUAAGUGAUUGCUAAUCUAGAUGAAUGACUGUUAAAACAGAACCCGGCUUACACGAGUCAACUUCAAUA,132,95,81,65,373
5201,0,AE016826.1/92349-91999,GAAGCUGACCGGGCAGUCGCUGCUAUUAUGAAAAAUACAUAGAAGAGGAAAGUCCGGACUCCAAGAGGCAAAGGUACCAGAUAACAUCUGGGGAACGUAAGUUCACGACUAGUGCAACAGAAAAUAAACCGCUAAAAAUUAGAAUUAGCAAGGGUGAAAAGGUGUGGUAAAAGCACACCGAAUACUUGGUAACAAGUAUUGACUAGGUAAACUUCUACCUUGGAGCAAGGCCAAAUAAGAGUAUUCGCCCAAUUUUUAAUACUCGGGUAGGCUGCUUGAACUAAUGAGUAAUUAUUAGUCUAGAUAAAUGACUGUCAAAUACUGAACCCGGCUUAUAGGUCAGCUUCAUUA,127,82,80,62,351
5202,0,CP000390.1/2166038-2165598,CCAGCCGGUCGGACGGCCGCACGCGCAAGCGCCGAAAGGCCGCGCGUGAGGAAAGUCCGGGCUCCACGGAAAUACGGUGCCGGGUAACACCCGGCGGGGGUAACCCUAGGGAAAGUGCCACAGAAAGCAGACCGCCCCGCCGGUAAAUCAGCCUUUGAAGCCGGCCUCGGUUCGAAGGCCGAUUUACAGGCGGGGUAAGGGUGAAAGGGUGGGGUAAGGGCCCACCGCGUUUCUGGCAACAGGAACGGCACGGUAAACCCCACCGGGAGCAAGACCGAAUAGGAACGGCGCGAAGGGCAACCUUCAGGGCAUUUCCGGCCCGGCCGUUCGGGUAGGUUGCUUGAGGCCGGCGGCGACGCCGGUCCCAGAGGAAUGGCCGUCACGUCGCGCCGUCUCGGCGGCGCGGCCAUACAGAACCCGGCUUACAGACCGGCUGGUAUU,94,56,158,133,441
5203,0,CP000673.1/950093-950451,UAAGUAAGCCAGACAAUCGCUGCUGUAUAAUUACAGGAGAGGAAAGUCCGAGCUUCAUAGGGCAGGGUGCUGGGUAAUACCCAGUCAGGGUGACCUGAAGGAAAGUGCAACAGAAAUAUACCGCUGAAGCAACAAGAAAUUAUUGCUUCAGUAAGGAUGGAAAGGCGAGGUAAGAGCUCACCAGCGCAUUGGUGACUUUGCGGCUAUGUAAACCCCACCUGAAGCAAGAUCGAAUAGGAAAGCAUAUUAAAAAGUGGCCCGCUUUGCUUUCGGGUAGUAUCGCUGGAGCCUAUUGGUAACAAUAGGCCUAGAUAGAUGAUUGUCUAAUACAGAACUCGGCUUAUAGACUUACUUACCCA,115,81,93,70,359
5204,0,CP000053.1/799414-799765,CAAAAAGAGCAAGGAGUUCACAAGACGAGGAACGGAGCGUAUACUUAAUACGUGAGUACCGUAGUACUUGUAGAACGACGUAGCCAAUUUUUGAAGUUCAUCGAGUAUAUUCGGUAAGGGUGAAAAGGUACGGUAAGAGCGUACCGGUAAGUUGGUAACAAAUUACGCAUGGUAAACCCCACCAAGAGCAAGAUCAAAUAGGCGUUACAGAACUUAUCAAGUUCCCGGGUUAUCUCUAGCCGGCUUGUAAUGCGGGUAGAUCGCUUGAGGUAAACGGUAACGUUUAUCCUAGAUAAAUAACUGCAAUGAAUUUAUAUUCAUACAGAAUCCGGCUUAUAGACCUUAUUGUUAU,116,91,83,62,352
5205,0,AAGP01000051.1/20859-21226,ACAGGUCACCAGACGGUCGCGGCUCUCUCACGAGGGCUGAGGAACGUCCGGGCUCCGCAGAGCAGGGAUGGUGGGUAACACCCACCCGGGGCAACCCGCGGGCCAGUGCAACAGAAAGCAGACCGCCCAGUUUCGACUGGGUAAGGGUGAAACGGUGGUGUAAGAGACCACCAGGGUGUCGGGUGACCGGCGCCGCUGGGUAAACCCCAUCCGGAGCAAGAUCAGACAGACGACGUUCGAGGCUGCUCGCCGAGUCGUCGGGUGGAUUGCUUGAGGCCGGUGGCAACAUCGGUCCCAGAUAGAUGACCGUCCGUCGAGAAGGGUAACCGACUCGAUGACAGAACCCGGCGUAUCGGUGGCCUGUCCUC,80,55,128,105,368
5206,0,CP000721.1/1039561-1039908,CGAGUGAGACGUGCAAUCGCUGCUAGACUUAGAUCUAGGAGAGGAAAGUCCGAGCUCCAUAGGGCAGGGUGCUGGAUAACGUCCAGUCAAGGCGACUUGAAGGAAAGUGCAACAGAGAUAUACCGCCUAAGUUUACUUAGGUAAGGGUGGAAAGGUGAUGGUAAGAGCUCACCAGCGUGAUGGAGACUUCACGGCUAUGUAAACCCCACUUGGAGCAAGACCGAAUAGGGAGGCAAUUAAGGGGCUGCCCGUCCCGCCUCCGGGUGCGUCGCUUGAGCUUACUGGCAACAGUAGGCCUAGAUAGAUGAUUGCUUAAUACAGAACUCGGCUUAUGGCUUAUCUCGCAUA,95,74,104,75,348
5207,0,CP000724.1/3019118-3018723,CGAGUAAGUCAGAUGAUCGCGGCCACAGACUUGUUCUGUGGACGAGGAAAGUCCGAGCUCCGUAGGGCAAGGGUGCUGGGUAAUUCCCAGUGGAGGUGACUCUAAGGAUAGUGCAACAGAGAUAUACCGCCAGAACCCCUACUCAGUAGCAAUACUGGGUAUGUGGUGAGACAGCCUUAGGGCUGUCUGGUAAGGCUGGAAAGGUGCGGUAAGAGCGCACCAGCAGUUAGGCGACUAACUGGCUAUGUAAACCCCAUCCGGAGCAAGACCAAGUAGGGACUAGAAAACGCGGCUGCCCGUCGCGUCCCGUGGUAGGUCGCUUGAGCUAACUGGUAACAGUUAGCCUAGACAGAUGAUCGUCAAAUACAGAACUCGGCUUAUAGACUUACUCGCUUA,106,81,118,91,396
5208,0,AAOB01000003.1/8301-7930,UGGGUCGGCAAGACGGUCGCGUUAUCCGCAAGGGUACCGAGGAACGUCCGGGCUCCGCAGAGCAGGAUGGUGGGUAACACCCACCCGGGGCAACCCGCGAGAACAGUGCAACAGAAAGUAGACCGCCACAGACUUCGGUCUGGGGUAAGGGUGAAACGGUGGUGUAAGAGACCACCAGCGGCCGGGGUGACUCGGUCGGCUAGGUAAACCUCGUCCGGAGCAAGAUCAGACAGAAGACGCUAAGGCUGCUCGCCAAGUCUUCGGGUAGAUCGCUAGAGGUGUGCGGCAACGUACAUCGUAGAUAGAUGACCGUCCAGCACGAAGGUUUCGGCCUCGUGUGAACAGAACCCGGCGUACUAGCCGGCCCAUUCC,90,58,124,100,372
5209,0,AAVP02000015.1/14993-14640,UAAGUAAGACAGACAAUCGCGGAUGUAAGUGCCGAAAGGCAGCAGACGAGGAAAGUCCGGGCUUCAUAGGGCAGGAUGCCGGAUAACGUCCGGUGGAGGUGACUCCCAGGCCAGUGCAACAGAAAUAAACCGCGUCGGAUUCCAUAUCGGCGUAAGGGUGGAAAGGCAGUGUAAGAGACUACCGCCUCUGCGGUAACGGAGAGGGCACAUGUAAACCCCAUUCGAAGCAAGACCGGAUAGAAGCAAUGUGGCGGCCCGUCACGCUUCAGGUAGGUCGCUUGAGCACGGCGGCAACGUCGUGCCUAGAUAGAUGAUUGUCCACGACAUAACCCGGCUUAUCGUUUUGCUUAACAC,98,63,108,85,354
5210,0,CP000542.1/2120942-2120613,GAAGCGCGCCAGACCGCCGCUGGUGCAAUCUGGGAAACCAGGCACUGGAGGAACGUCCGGACUGCACAGGACAGCGUAGCAGCUAACGGCUGCCCACCGCGAGGUGAGGAUCAGAGCAACAGAGACGAGUCGGGGGGCGGCAACGCGCCCCGGGUGAAACGGGCAAUCUCUACGCGCAGCAAUACCAAGUAGGCCAGCGUCGAUGUGGUUCCGCAGAGCUGGCGGGUAGGUAGCACCGAGCCGUGGUGGCGACACCCGGCCCAGAUCGAUGGCGGUCACGCUGCGGGUCACCGCAGCGCACAGAAUCCGGCUUAUCGGCGCGCUUCACAC,73,40,116,101,330
5211,0,CP000284.1/2433638-2433334,GAAGCUGGCCAGGCAGCCGCCGCUCGCGCAAGCGAGGGGAGGAAAGUCCGGGCUCCAUAGAGCAGGAUGACGGCUAACGGCCGUACGCCGUGAGGCGAGGAACAGGGCCACAGAGACGAGUAAGCCGCAAGGUGGACGUGAAACGCGGUAACCUCCAUCCGGAGCAAGGCCAAAUAGGGUAGCGAUGGCGUGGCUCGCGCCGCUACCGGGUAGGUCGCUUGAGCCUGGUGGCAACGCCAGGCCUAGAUGAAUGGCUGCCACCCGCUUUGCGGGGACAGAACCCGGCUUACCGGCCAGCUUCAUUC,68,40,109,88,305
5212,0,AM711867.1/1842831-1843212,UGGGUCGGCAAGACGGUCGCGCCGCGGAGGAUCCCGAGAGGGGGAGACCGCGUCGAGGAACGUCCGGGCUCCGCAGAGCAGGGCGGUGGGUAACACCCACCCGGGGCGACCCGCGAGACAGUGCAACAGAGAGCAGACCGCCCGUCGCGCGAGCGGCGGGUGAGGGUGAAACGGCGGUGUAAGAGACCACCAGCGGCCCGAGUGAUCGGGUCGGCUAUGCAAACCUCGCCCGGAGCAAGGUCGAACAGGGGACGCACAGGCUGCUCGUCCAGUCCCCGGGUAGACCGCUGGAGGGCUGCGGUGACGCAGCUCCGAGAUAGAUGGCCGUCCAUGGUGCCGCGAGGCACCGGGACAGAACCCGGCGUAUCAGCCGGCCCAUCCG,76,39,149,118,382
5213,0,AAVU01000017.1/76609-76170,AGAGUCAGCGAAGGCAAUUGCGGACUCAAUACCUGAGUCUGAGGAAAGUCCGGACUCCCAAAAGACUAAACCUGCUGGAUAACGCCCAGUGCGAGUGAUCGUGAGGAUAGUGCCACAGAAAAAUACCGCCAAGAAUAGGGAACAGGGGACAGGUUACAGGUUACAGGGAAGACCCCUGAGAGCUGAUCACCUAGAACUAAUCAUCUGUUGUUGGUAAGGGUGCAAAGGUGCGGUAAGAGCGCACCAGCAACGUCGAGAGGCGUUGGCUCGGUAAACCCCAGGUGGGAGCAAGGUCGGAGGAACUAAGGUUGGUCUUUUCCCCGUUCCGGUUUAAGAGGUACCGCUUGAGGUGUUUGGUAACAAACAUCCCAGAUAGAUAAUUGCCCUCUUGACUGUAUACAGUUGAGAAAACAGAAUCCGGCUUAUGUCUGGCUCUCUCU,125,93,126,96,440
5214,0,ABDQ01000018.1/32843-32491,CGAGUAAGCCAGAUGAUCGCUGCUACACUAUUAUGUGUAGGAGAGGAAAGUCCGAGCUCCAUAGGGCAGGGUGCUGGGUAACUCCCAGUGGAGGCGACUCUAAGGAAAGUGCAACAGAGAUAUACCGCCAUAAACUUUGUUUAUGGUAAGGGUGGAAAGGUGAGGUAAGAGCUUACCAGCGCAAUGGCGACUUUGCGGCUAUGUAAACCCCAUCUGGAGCAAGAUUGAAUAGAGGGACAUUAAGGAGCGGCCCGUUCCGUCCCCGGGUAAAAUCGCUUGAGUCUAAUGGUAACAUUAGGCCUAGAUAGAUGAUCAUCAAAUACAGAACUCGGCUUAUAGACUUAUCUCGUAUA,104,81,98,70,353
5215,0,CP000568.1/1068190-1067816,UGAGUAAGCCGGAUAGUCGCGGGUACAGUGCCGAAAGGCCGUACACGAGGAAAGUCCGGGCUCCGCAGGGCAGGGUGCCGGGUAACUCCCGGUGAAGGCGACUUCAAGGAAAGUGCAACAGAAAUAUACCGCCUGCUGAAGAUUGAGGUCGAGUGCUUUCGGUUUUCAGCAUGGUAAGGGUGGAAAGGUGAGGUAAGAGCUCACCAGCGGUAUGGCGACUUACCGGCUAUGUAAACCCCACCCGGAGCAACACCGCAUAGAGGGACGUUAAGGUGGCCCGCCAGUCCCGGGUAGGUGGCUUGAGCUAUAUAGAAAUAUAUAGCCUAGAUAGAUGACUAUCCAAGACAGAACCCGGCUUACAGGCUUACUCAAUAU,102,71,116,86,375
5216,0,CP000656.1/3066080-3066491,UGAGCUGGCCGGGCGGCCGCGGCACCCAGAUUCCUGGGGGUCGAGGAAAGUCCGGACUUCACAGAGCAGGGUGAUUGCUAACGGCAAUCCGAGGUGACUCGCGGGAAAGUGCCACAGAAAACAGACCGCCUGCGUCGAGUCUUCGGACGAGGCGCAGGUAAGGGUGAAAAGGUGCGGUAAGAGCGCACCAGCACUCCGGGUGACCGGGGUGGCUUGGUAAACCCCACCCGAAGCAAGGCCAAGAAGGCCGCAACCUGGUUGCGGUCGCGCAGGCGUUCGAGGGCUGCUCGCCCGAGCCUGCGGGUAGGCCGCUCGAGGUACCCGGCGACGGUGUGCCCAGAUGGAUGGUCGCCGCCUCCUCGUCAGAGAUGGCGUCGAGGAACAGAAUCCGGCUUACAGGCCGGCUCAUCCG,84,59,150,119,412
5217,0,CP000031.1/3164292-3163898,GCGGAGGGCCGGAUGGCCGCGUGGGGGGCAACCCCCGCGAGGAAAGUCCGGACUCCAUGAAGCAGCGGUGCCGGGUAACGCCCGGGCGGGGAAACCCGACGGAAAGCGCCACAGAGAACAGUCCGCCGCGCAGGUCGCGGCAAGGGUGAAACGGUGGAGUAAGAGCCCACCGCGCCCCUGGCAACAGGGGCGGCACGGCAAGCCCCACCGGGAGCAAUGCCAAAUAGGACCCCCGCGCGGGACGCGUCGGUUUCGGCCGAUACCUCCGCUAGGCCGCUUCAGCCGAGAGGGGUCGGGUUGGCAGCUAGAGGCGCCUGGCAACAGGCGCACCAGAGGAAUGGUCAUCGAAGGGGGCAACCCUGGAACAGAAUCCGGCUUACAGGCCCUCCGCGCGC,84,37,148,126,395
5218,0,BA000021.3/523133-522804,AAAGUUAGCUAGACAAUCGCUGUUUAAUACAGAGGAAAGUCCGGGCCCUAAAGAGCAAGAUGCCAGGUAAUUCCUGGGAGGAGUGAUCCUACGACUAGUGCAACAGAAAAAAAACCGCCACUUUUGUUGGUAAGGGUGAAAAGGUGCGAUAAGAGCGUACCGCAAUUUAUGGUAACAUAAUUGGCAGUGUAAACUCCAUCUAGGGCAAGGCCAAAUAAAAGCUUGAUUGCUCGUCUUUAAGCUUUGGUAGGCUGCAAGAAUAAAUAUGUGAAUGUUUAUCUAGAUAAAUGAUUGUCCAAGACAGAACCCGGCUUACAGCUAACUUUAUUU,110,84,78,58,330
5219,0,CP000769.1/4353920-4353531,GGAGCCGCUCGGGCGAACGCGUCGGUCUGCAGGAACGGGGGCCGCCGAGGAAAGUCCGAGCACCACAGGGCAGGGUGCCGGUUAACGACCGGUCGGGGCGACCCGCAGGACAGUGCCACAGAGAACAGACCGCCGAACGGCGUCCUGAGCUUGUCGAAGGACGCGCGUGGCAAGGGUGAAACGGUGCGGUAAGAGCGCACCGCGCGCCGGGUGACCGGCGCGGCACGGAAAACCCCACCCGGUGCAAGGGCAAAUAGGGAGGCGACCGGCCCGGUCAUUGCCUCCGGGUAUGGCCCGCUCGAGACGCGCGGCAACGCGCGUCCUAGAGGAAUGUUCGCCGCCGCGGGGAAACCCGCGGGACAGAACUCGGCUUACAGAGCGGCUCCGGCA,80,38,150,122,390
5220,0,AAVL02000025.1/21850-22196,UGAGUAGAGCAGAUGAUCGCAGCUGCUAUUGCCGAAAGGACGCAGGUGAGGAAAGUCCGGGCUUCAUAGGGCAGGGUGCCGGCUAACGGCCGGUGGAGGUGACUCCCAGGAAAGUGCAACAGAAAUAAAACCGCCAGCUUGCUGGUAAGGAUGAAAUGGUAGUGUAAGAGACUACCGCUUCGGUGGUAACAUCGAGGGUCAGUGUAAACCCCACUUGAAGCAAGACCGAGCAGAAAGCAUAUGGUUGCCCGCCAGCUUUCGGGUAGGUUGCUUGAACAUAUUGGUAACGAUAUGUCUAGAUAGAUGAUCAUCCACGACAUAACCCGGCUUACAGCUUUACUCAUUCA,98,73,101,75,347
5221,0,CP000450.1/2649362-2649650,GAAGUCGGUCAGACAGUCGCUGCCUGGUAACAGGGAGAGGAAAGUCCGGGCUCCACAGAGCAGGAUGCCGGUUAACGGCCGGCCGCCGUGAGGUGAGGAACAGGGCCACAGAGACGAGCGUAUUAAGUUACGGUGAAACGCGGUAACCUCCAUCCGGAGCAAGAUCAAAUAGGCAGAUGAUGACGCUGCUCGCCGAGUCUGUGGGUAGAUCGCUUGAGCAUACGGGUAACGGUAUGCCUAGAGGAAUGACUGUCCAUGACAGAACCCGGCUUAUCGACCGGCUUCCCCC,73,49,94,73,289
5222,0,AE005673.1/2774739-2774346,CCAGAUGAUCGGGCGGUCGCGUCGUCUUCGGACGCCGAGGAAAGUCCGGGCUCCACGGUGACAAGGCGGUGGGUAACGCCCACCGGGAGCGAUCCCAGGGAUAGCGCCACAGAAAGCAAACCUCCUCCCUACGGGGCGGGAAGGGUGAAAGGGUGGGGUAAGAGCCCACCGCGGACCUGGUGACAGGGACGGCAUGGCAAGCCCCGCCUGGAGCAAGACCGAAUAGGGAUCCCGCGUCGGCCUCGCGCCGACUAGGCCGUCACUGGCUGAGAGGAUCCGGGUAGGUCGCGAGAGCCGUCCAGCAAUGGCCGGCCUAGAGGAAUGAUCGUCGCCGUCUCCCUGUCUUCGGAUGGGCGGGGCGGAACAGAACCCGGCUUACAGAUCAUCUGGUCCG,80,54,143,117,394
5223,0,AAMD01000020.1/46527-46921,GGAGCGGCCCGGGUGAACGCUGGCCACCGCAGGAACGGGUGGCGGGAGGAAAGUCCGAGCUCCACAGGGCAGGGUGCUGGCUAACGGCCAGUCGAGGUGACUCGCAGGACAGUGCCACAGAAAACAAACCGCCCGUUCCGAAAGGGGCGGGUAAGGGUGAAACGGUGCGGUAAGAGCGCACCGCGCCCGGGGUGACCCGGGCGGCACGGUAAACCCCACCUGGAGCAAGAGCCAAUAGGAGCGCGUCCUCGCGGUUGGGGGACAAGGAUGGCCCGUCCGCUGCGCUCGGGUUGCUCGCUGAUGAGGCCCCUGGGCAACCAGGGCCCUAGACGAAUGUUCGCCGCCCACCUCGAAAGGGGUGGGGACAAAACUCGGCUUACAGGGCCGCUCCGGCU,82,47,149,117,395
5224,0,AAMT01000009.1/94327-93924,GCGGAUGGCCGGACGGUCGCCGGUGGCGGGGGCAACUCCGCUGCGGGAGGAAAGUCCGGACUCCACAAGGCAACGGUGCCGGGUAACGCCCGGCCGGGGCAACCCGAGGGAAAGCGCCACAGAGAACAAACCGCCCGGGUCAAUCGCUGACGCGAUGAACCCCGGGUAAGGCUGAAACGGUGGGGUAAGAGCCCACCGCGGGACGGGCAACCGGACCGGCACGGCAAGCCCCACCGGGAGCAAUGCCGAAUAGGGACCUCGCGCCCCGCGAGGGCAGGGCCGCCUUGGCCCGGAGGUCCGGGUUGGCAGCUCGAGCGGUUCGGUAACGGAUCGCCUAGAGGAAUGAUCGUCGGCACCGGGGCGACCCGGCGUCACAGAAUCCGGCUUACAGGCCGUCCGCGCAU,82,40,153,129,404
5225,0,AAYB01000002.1/573345-573716,GCGGAUGGCUGGAUGACUGCGGCAGCAAUGUCGAGGAAAGUCCGGACUCCAAAAAGCACGGUGCCGGGUAACGCCCGGCGGGGGUAACCCCAGGGAAAGCGCCACAGAGAACAGACUACCUGAUUUCGAUCAGGAAAAGGUGAAACGGUGGGGUAAGAGCCCACCGCGCAAGCGGCAACGCAAGCGGCACGGCAAGCCCCACCGGGAGCAAUGCCAAAUAGGGACCUCGCGUCGCAAGACGGGGAUGCUUGAACCCCAGAUGGUCCGGGUUGGCAGCUAGAGGGCGUCUGGCAACAGGCGCCCCAGAUGAAUGGUCAUCCAUUUGUGGGCAACCACAAAGGACAGAAUCCGGCUUAUAGGCCAUCCGCGCAU,99,48,123,102,372
5226,0,ABCB02000018.1/378881-379228,UGAGCAGGCUGAACAGCCGCGGGCGAUAGCCGAAAGGCUCCGCCUGAGGAAAGUCCGAGCUCCACAGGGCAGGAAUAGCGGUUAACGGCCGCCGGGGGCGACCCUAGGGAUAGUGCAACAGAAAGUUACCGCCGGCUUUGCCGGUAAGGGUGGAAAGGCGAGGUAAGAGCUCACCAGCGCGCAGGAGACUGCGCGGCUGUGUAAACCCUAUUCGGAGCAACACCGCAGAGGAACGUAUCGCGCCGGCCCGGCGUGUUCCGAGAAGGUGGCGUCGAGCCGUGAUGGCAACAUCCGGCCAAGAUAGAUGGCUGUUCACGACAGAACUCGGCUUAUAGGCCUGGUCAUAAC,84,51,120,93,348
5227,0,X65707.1/109-543,GAGAGUUAGGGAGGGAGUUGCGGAUUCCUGUCACAGGGAAUCUGAGGAAAGUCCGGGCUUCCCAAAGGCCAAACUUGCUGGGUAACGCCCAGUGCGCGCGAGCGUGAGGACAGUGCCACAGAAAAAUACCGCCCUUUUUAGAAAACAGCAACCAGUAAACAGUUAACAGGGUUUUUCUGCUGACUAACUGGUAACUGACCACUGAAAAGGGUAAGGGUGCAAAGGUGCGGUAAGAGCGCACCAGCAGUAUCGAGAGGUACUGGCUCGGUAAACCCCGGUUGGAAGCAAGGUCGGAGGGGCAAAGGUUGGUCUUUUUCCUGCCCCAUGAUUGGUGGAACCGCUUGAGGAAUUUGGUAACAAAUUUCCCAGAUAGAUAACUCCCCAAGGGUGCCUCGCAUCCUGGAACAGAACCCGGCUUACGACUAACUCUCUUUU,118,92,125,100,435
5228,0,AAXG02000012.1/129014-129362,CAAGUAAGCUGGACAGCCGCGGAUCGAGGCCGAAAGGCCCGAUAUGAGGAAAGUCCGGGCUCCACAGGGCAAGGAUAACGGGUAACACCCGCCGGGGGCGACCCUAGGAAAAGGGCAACAGAGAUAUACCGCCACGUUCUGCGUGGUAAGGGUGGAAAGGCGGAGGUAAGAGCCCGCCCGACGACUGGGAACUGCUCGUCGCUGUAACCUCUAUCCGGAGCAACGCCGUGGGAGAACAUAUGGCCGGCCCGGCCGUUCUCAGGAGGCGGCUUGAUCGUACCGGCAACGGUACGGCUAGAUAGAUGGCUGUCUUAAAAGACAGAACCCGGCUUACAGGCUUACUUGCCGC,87,52,116,94,349
5229,0,CP000263.1/59969-59622,AAAGUUAGUUGAACAGUCGCUAUUUAAUAUUUCUAUAUUAAAUAGAGGAAAGUCCGGGCUCCGUAAGGCAAGACGCCAGAUAACGUCUGGGAAGAGAAAUCUUACGACUAGUGCCACAGAAAAUAAACUAUCUAUAUAAUUUAAUAGAUACAGGUGAAAAGGUUCGGUAAAAGCGUACCGCAGAAUUGGUAACAAUUUUGGCUAGGUAAACAUCCGUCUGGAGCAAGGCUAAAUAAGAAGAGUAUAGCCUGUACUUAUCUUCGGGUAAGCUGCUUGAAUUAAUAAGUGAUUAUUAAUCUGGAUAAAUGACUGUGUAAACAGAACCCGGCUUAUAAAUUAACUUAUCUU,125,97,73,53,348
5230,0,AJ012176.2/7-394,GAGUAAGGCAGCCGCUGGAGCAGUUUGUUUAAAGCUGAUGUCAGAGGAAAGUCCGGACUUYAUAAGAAAAGAUGCUGGAGAAAUUCCAGGGGCCGAGAGGCUACGGAAAGUGCAACAGAAAACACUCCGCUAUAAAUUGCAAAAUUUAUAGACAGGCUGAAAAAUCCUACUUUAAGAGUAGGAGCUGCUGGGGAGACCCGGUAGACCUGUAAACCCCAUCUGAAGCAAGAGAAAAAGUCUUUUGUCUCUGCAAAGAACCUCUCUAAGGGAAGGUUCAGACUUUUUCAUAAUCGCUUGAGAAGUAUAGUAAUGUGCUUCCUAGAUGAAUGGCUGCCCGCAGGCAAGAAUUUUUAUUCGCGCUUGUUGACAGAAYCCGGCUUACUCGCUC,120,92,98,76,388
5231,0,CP000449.1/2272218-2271830,UCAGGUGGCUGGGCGGUCGCGGCAACUGGGCCGGAAACGGUGUUGUCGAGGAAAGUCCGGGCUCCACGGAGGCAAGGUGCCGGAUAGCGUCCGGCGGGGGUGACCCCAGGGAAAGCGCAGCAGAGAACAGACCGCCGGGCCUUCGGGCCAGGCAAGGGUGAAACGGUGCGGUAAGAGCGCACCGCCCCGACCGCAAGGAAGGGGGCUAGGCAAGCCCCACCUGGAGCAAGACCGAAUAGGGACAGACCGCAGCCUCGGCUGCACGUGCGCCUCCGCAUGCUGUCCGGGUAGGUCGCACCAGGUCGUGCGCAAGCACGAUCGCAGAUGAAUGACCGUCGCCCCGGAUCUGAUCCGGGGGACAAGACCCGGCUUACAGGCCGCCUGAUCAC,82,45,144,118,389
5232,0,CP000237.1/23797-23440,CGAGGUGCCUGAGGUAGUUGCUGCUCUUUUGAUGAUUCAAAAAUUGAGGAGAGGAAAGUCCGGGCUCCACGGGAGAAUGGUAGCGGAUAACUUCCGCCGGGCUUAGCCCAGGACAAGUGCCACAGAAAAUAACCGCCUGUUUUUUUCAGGUAAGGGUGAAAAGGUGCGGUAAGAGCGCACCGCGUUCGCGGCAACGUGGAUGGCAUAGGUAAACUCUACCAGGAGCAAGACCAAACAGAAGAAGAGUGUGCUCUCGCGCGAUAGAUUUUUCGGGUAGGUCGCUUGAAGUGCAUAGUAAUGUGUACCCUAGAUGAAUGACUACCGUAUACAGAACCCGGCUUAUGGGGCACCUCGUUUU,95,81,107,75,358
5233,0,CP000142.2/3127195-3126800,GGAGAGCGCCAGAUGAUCGUCGGCUCGUUCCGUUUCGGCGGUAGCGGGCGGGAGGAAAGUCCGGGCUCCGCAGGGCGGGAUGGUUCUUAACGGGAACCGGGGGUGACCCCAGGGACAGUGCCACAGAAAGCAAACCGCCUGUCGAAGUCGAGGCUUGGGCAGGUAAGGGUGAAACGGUGAGGUAAGAGCUCACCAGUUCCGACGGCGACGCCGGAAGCUAGGUAAACCCCAUCCGGAGCAAGGCCAAAUAGGGAAGUGUUUGAGGGCGGCCCGUCCGAGACUUCCGGGUUGGUUGCUUGAGGCCGUCGGCAACGGCGGUCCUAGAGGAAUGAUCAUCGCCCUCCGUGCGGGUAACCGGCGGGGGGAACAGGACCCGGCUUACGGUUCUCUCCGGCC,80,63,149,104,396
5234,0,AAMO01000002.1/442801-442402,ACGGAGGGCCGGAUGGCCGCGGGCCGGAAGGUCCGAGGAAAGUCCGGACUCCACAAGGCAAAGGUGCCGGGUAACGCCCGGCGGGGGCAACCCCAGGGAAAGCGCCACAGAAAACAGUCCGCCCCGCGGACCGGAGGUUCGCCGAAGGAUCAUCCGCCGGGGUCAGGGUGAAACGGUGCGGUAAGAGCGCACCGCGGGACGGGCAACCGGACCGGCACGGCAAGCCCCACCUGGAGCAAUGCCGAAUAGGGACCUCGCGCGGGCGACCGCAGGGCCGUCUUGGCCCGGAGGUCCGGGUUGGCAGCUUGAGGCGCCGGGGCGAUCCGGCGUCCAGAGGAAUGGUCAUCGAACCGGGGGCGACCCCGGGGAACAGAAUCCGGCUUACAGGCCCUCCGUGCGA,82,37,156,125,400
5235,0,CP000512.1/850110-850447,GAAGCGCGCCAGACCGCCGCUGGUGCACGUGCCGAAAGGCCGCACUGGAGGAACGUCCGGACUGCACAGGACGGCGUAGCAGCUAACGGCUGUCCACCGCGAGGUGAGGAUCAGAGCAACAGAGACGAGUCCGGAAGGAGUGCCGCAAGGCAGACCAGCCGGGGUGAAACGGGCAAUCUCUACGCGCAGCAAUACCAAGUAGGCCAGCGUUGACGUGGUUCCGCGGAGCUGGCGGGUAGGUAGCAUCGAGCCGGGUGGGCGACCCCCGGCCCAGAGUAAUGGCGGUCACGUGCGGGCAACCGCAUGCACAGAAUCCGGCUUAUCGGCGCGCUUCACAC,76,41,121,100,338
5236,0,AATP01000001.1/639443-638994,UCAGCUGGCUGGGCGGCCGCUCCCGUCAUGAGCCGAAAGGCGGCGGGAGAGGAAAGUCCGGGCUCCACGGAGAAACGGUGCCGGAUAACCUCCGGCGAGGGAAACCUCAGGGAAAGCGCCACAGAAAACAGACCGCCCCGCCUUCAGUUCGGCCGAGAGCCAUGGGAACGCAUGGGCGAUAGCCGGCCGCACUGAUGGCGGGGUAAGGGUGAAACGGUGGGGUAAGAGCCCACCGCGUCUUCGGUAACGAAGGCGGCACGGCAAGCCCCACCGGGAGCAAGACCGAAUAGGGACGGCGCGGAUGGCGCAAGCCUUCCAUCAGCUCCGGGACAGCCGUCCGGGUGGGUUGCUCGAGGCGUUCCGCAAGGAACGUCCCAGAGGAAUGGUCGCCGCGCAUGCGCCUUGACGGGUUCAUGCGUACAGAACCCGGCUUACAGGCCGGCUGACGCU,97,56,163,134,450
5237,0,CP000251.1/4138335-4137926,GGAGCCGCCCGGGCGAACGCGUCGGUCCUGCAGGGAAGGGGGCCGCCGAGGAAAGUCCGGGCACCACAGGGCAGCGUGCCGGCCAACGGCCGGUCGGGGCGACCCGCAGGAAAGUGCCACAGAGAACAGACCGCCGAACGGCGCCGGGCGACCGGCGUGCGUGGCAAGGGUGAAACGGUGCGGUAAGAGCGCACCGCGCGCCGGGUGACCGGCGCGGCACGGCAAACCCCACGCGGUGCAAGAGCGAAUAGGGAGGCGUCCCACCCGCGCGAGCGGGAGGGCAAGACCGGCCCGGUCCAGGCCUCCGGGUAUGCUCGCUGGAGACGCGCGGCAACGCGCGUCCGAGAUGAAUGUUCGUCGCCGCGGGGUUUCCCGCGGAACAGAACCCGGCUUACAGGGCGGCUCCGGUC,76,35,165,134,410
5238,0,CP000127.1/3251638-3251285,UGAGACGACCAGACAGCCGCGUUACCUUGAAUUCAGGUAAUGAGGAAAGUCCGGGCUCCAUAGGGCAGGGUGCCAGGUAACGCCUGGGGGGCGUGAGCUUACGGAAAGUGCCGCAGAAAAUAUACCGCCUAAGCGUCUGCGGGCGCCGGUAAGGGUGAAAUGGUGCGGUAAGAGCGCACCGCGCGGGUGGCAACACACCGUGGCAAGGUAAACCCCACUCGGAGCAAGGCCAAAUAGAGGAACAAAGAUGUGGCCCGCAUCGUUCCUGGGUAGGCUGCUUGAGGUGCAUGGUGACAUGUAUCCCAGAUGAAUGGCUGUCCACGACAGAACCCGGCUUAUCGGUCGUCUCAAUCC,88,61,116,89,354
5239,0,BX569689.1/147782-147396,GAAAGCAGGCGAGGUGGUUGCGGUCGAUCUCUUUGAGUGUCGGCUGAGGAAAGUCCGGGCUCCCUGAUGGCCAGGCUUGCUGGGUAACGCCCAGUGCGGGUGACCGUGAGGAGAGUGCCACAGAAACACACCGCCGAUGGCCCCGUGGGGCUUCCCCCAGGCACAGGCAAGGGUGCAAAGGUGCGGUAAGAGCGCACCAGCAGCAUCGAGAGGUGCUGGCUCGGUAAACCCCGGCUGGGAGCAAGGCCAAGGAACGACGGCUGGCCAUUGGCCCCGUUCCGUCUAAACGCGCCGCUCGAGGCCGUCGGUAACGGCGGUCCCAGAUAGAUAGCCACCCACCCUCUUCGGAGGCGUGAACAGAACCCGGCUUAUGUCCUGCUUUCACCC,78,62,131,116,387
5240,0,CP000083.1/4670434-4669999,CGAGUUGACCAGACAAUCGCUGCUUUAUCGUUGUAGUUUAAAUUUCGAUUUGAACUAAACAGAUAGAGGGGAGGAAAGUCCGGGCUCCAAUGAGCAGGGUGCCAGGUAACGCCUGGGCGGCGUGAGCCGACGACAAGUGCAGCAGAGAGAAGACCGCCGAUGGCCGCUUGCGGAACAGGUAAGGCUGAAAGGGUGCGGUAAGAGCGCACCGGAUUGCUGGUAACAGUAAUUGCAGGGUAAACUCCACCUGGAGCAAGACCAAAUAGGGUUUCAUGAUUAUUAAAACGCAAGUUUUGAUAAUAUAAGCGUGGCUCGCGUGGAAACCGGGUAGGUUGCUUGAGCUAUAGAGCGAUUUAUAGCCUAGACGAAUGAUUGUCAUCUCUUUUGCUUUUAGUAAAGGAGCUACAAAACCCGGCUUAUGUGGUCAACUCAACUA,124,101,126,85,436
5241,0,AAVO02000041.1/1066-715,CAAGCAGGUCAGGUGAUCGCGGCUGUACAGACGAAAGGGUGCAGACGAGGAAAGUCCGGGCUUCAAAGGGCAGGAUGCCGGAUAACGUCCGGUGGAGGUGACUCCCAGACCAGUGCAACAGAAAUAAACCGCCUUCUUUAUGGAAGGUAAGGGUGGAAAGGCAGUGUAAGAGACUACCGCCGUUGUGGUAACAGAACGGGCACAUGUAAACUCCAUUCGAAGCAAGACCGAAACGAAAGCAAUACGGCUGCCCGUCGUGCUUUCAGGUGGGUCGCUUGAGCCAUCUGGCAACGGAUGGCCUAGACAGAUGAUCACUCAACGACAUAACCCGGCUUAUCGGUCUGCUUGCAUA,99,64,106,83,352
5242,0,AAQG01000002.1/124283-124671,CCAGAGGGCCGGGCGGCCGCGGCGUGGCGGGUAACUUCCACGGCGAGGAAAGUCCGGGCUUCACGAAAUGACGGUGCCGGCUAACGGCCGGCUGGAGCGAUCCAAGGGACAGUGCAACAGAAAGCAGGUCGCUAAGGCCUAGGCCCAGCGAAAUUGAAAGGGUGCGGUAAGAGCGCACCGCGUCUGCGGCAACGCAAGACGGCACGGUAAACCCCACCGGAAGCAAGACCGAAUAGGGGCGGCGCGCAGCGUCAUGCUGCUAGGCAGAUUUCGGCCGAGACCGCCCGGGUUGGUUGCUGGAGGAACGGAGCAAUCCGUUCCCUAGAGGAAUGGUCGCCCAUCCUUCGCAAGAAGGUGGACAGAACCCGGCUUACAGGCCCUCUGGCAUU,90,52,137,110,389
5243,0,AAXB02000002.1/257265-256914,CAAGUAAGACAGGUAAUCGCAGCUGCAGAUGCCGAAAGGCAGCAGGUGAGGAAAGUCCGGGCUUCACAGGGCAGGAUGCCGGAUAACGUCCGGUGGAGGCGACUCCAAGGAUAGUGCAACAGAAAUAUACCGCCAGGAUAUAAUUCUGGUAAGGGUGGAAGGGCAGUGUAAGAGACUACCGCCUUGCUGGUAACAGCAGGGGCAUAUGUAAACCCCAUUCGAAGCAAGACCGGAUAAAGACAAUGUGGCGGCCCGUCACGUCUUAGGUAGGUUGCUUGAACCCAUUGGUAACGAUGGGUCUAGAAAGAUGAUUACCCAACGACAUAACCCGGCUUAUCGUUUUGCUUGCAAU,103,69,104,76,352
5244,0,AE015927.1/2135036-2134672,CGAGUAAGCCAGACAGUCGCUGCUGUAUAAUUUACAGGAGAGGAAAGUCGGAGCUCCAUAGAGCAGGGUGCUGGGUAACCCCCAGUGGAGGCGACUCUAAGGAUAGUGCAACAGAGAGAUACCGCCAAAGGUCUUGUAGACUUUUGGUAAGGGUGGAAAGGUGAGGUAAGAGCUCACCAGCACACUGGUGACAGUGUGGCUAUGUAAACCCCACUUGGAGCAAGAUCAAAUAGAGAAGCAGGGAGAUUAACUUCCAGGGGCUGCUCGUCCCGCUUCCGGGUAGUAUCGCUAAAGCCUAUUGGCGACAAUAGGCUUAGAUAGAUGACUGUUUAAUACAGGACUCCGCUUAUAGACUUAGUCGCUUA,104,80,106,75,365
5245,0,AAOT01000013.1/60145-60517,GCGGAUGGCUGGAUGACCGCGGGCUUCGGCCCGAGGAAAGUCCGGACUCCGGCAGGCACGGUGCCGGGUAACGCCCGGCGGGGGCGACCCCAGGGACAGCGCCACAGAGAACAGACCGCCCCGCAUGCGGGGUAAGGGUGAAACGGUGGGGUAAGAGCCCACCGGGGACCGGGCAACCGGGCCCGCAUGGCAAGCCCCACCGGGAGCAAUGCCGAAUAGGGGCCUCGCGCGGGGAAACCCGCAGGGACGCCUGCACCCGAGAGGCCCGGGUUGGCAGCUGGAGGCGCGUCGGCAACGGCGCGUCGAGAGGAAUGGUCAUCCAUCCGGGGGCGACCCCGGGGGACAGAAUCCGGCUUACAGGCCGUCCGCGCAC,72,32,149,120,373
5246,0,CP000248.1/3267249-3267659,CCAGGGGGCCGGGCAGCCGCGUCAUCUCACGAUGCCGAGGAAAGUCCGGGCUCCACGAAACAAGGGUGGCGGGUAACGCCCGCCGGGUCGGGCAACCGAUCAAGGGAAAGUGCCACAGAGAGCAGACCGCCGCUCCGGUCUUCGGACCCAGGCGGCAAGGGUGAAAGGGUGCGGCAAGAGCGCACCGCGCGACCGGCAACGGAAGCGGCACGGCAAACCCCACCCGGAGCAAGAUCGAAUAGGGACUGCGCGCCCAGCAAUGGGCAGGCCGGUUUCGGGCCAGCAGUCCGGGUUGAUUGCUUGAGCGUUCCGGCAACGGUCCGCCUAGAGGAAUGGCUGCCAGCGGCGAUACGGUCCACUCGUGGGAUACCGUCGGCGCUACAGAACCCGGCUUACAGGCCCCCUGGCACU,87,48,146,130,411
5247,0,ABCG01000012.1/35715-35319,CCAGGGGGCCGGGCAGCCGCGUGAUUUCGAUUGCGAGGAAAGUCCGGGCUCCACGAAACAAGGGUGGCGGGUAACGCCCGCCGUGGGCAACCACAGGGAAAGUGCCACAGAGAGCAUACCGCCGAUGGCCCGUUCACGGGAUCAGGCAAGGGUGAAAGGGUGCGGUAAGAGCGCACCGGGGCUUCGGUAACGCGGUCCGCAUGGCAAACCCCACCCGGAGCAAGGCCGAAUAGGGGCGGCGCGCUGGCAACAGCAGGUGCGUUUCGCAUCGACCGCCCGGGUUGGCUGCUCGAGCCCUGGAGCAAUCCAGGGCCCAGACGAAUGGCUGCCGCCGCGCGGCUGGUGUGGAAGCAUACCGCGUGCGGAACAGAACCCGGCUUACAGGCCCCCUGGCACU,82,49,145,121,397
5248,0,CP000157.1/276357-276760,CCAGGGGGCCGGGCAGCCGCUCCUUCGACAAGCUCAGGAUGAGCGGGUUGUUAGGAGAGGAAAGUCCGGGCUCCACGAAGCAAGGGUGGCGGGUAACACCCGCCCGGUGACCCCGGAUUACGUCCGGGGGAGCCGAGGGACAGUGCCACAGAGAGCAGACCGCCUGAUCCGUCAGGCAAGGGUGAAAGGGUGCGGUAAGAGCGCACCGGGGGGCUGGCGACAGUCUCCGCAUGGCAAACCCCACCCGGAGCAAGGCCAAAUAGGGACCUCGCGCCGAAAGGCAGGAACGCUUCGUUCCGAGAGGUCCGGGUUGGCUGCUUGAGCGCGCGAGCAAUCGCUCGCCCAGAUGAAUGGCUGCCCCUGCAUCAGCAGGACAGAACCCGGCUUACAGGCCCCCUGGCACU,87,51,144,122,404
5249,0,AAYW02000004.1/35153-34803,UGAGCUGGACAAGUGAUCGCGGCUGUCAUAUGACAGGUGAGGAAAGUCCGGGCUUCGCAGGGCAGGGUGCCGGAUAACGUCCGGUGGAGGAAACUCCCAGGCUAGUGCAACAGAAAUAAACCGCCAUGUACAUGGUAAGGGUGGAAAGGCGAGGUAAGAGCUCACCGCUGCUUCUGGUAACAGAACAGGCUCUGUAAACCCCACUCGAAGCAAGACCAAAAAAGCAGCUUCGGCUGUGAGACGAAUGGCUGCCCGUCAAGUCUCAGGUAGGUCGCUUGAGCUUUAUGGUAACAUAAAGCCUAGAUAGAUGAUCACUCUCGACAUAACCCGGCUUAUCGUCCAGCUUUUAUA,98,71,100,82,351
5250,0,CP000529.1/3654859-3654532,GAAGCCUGCCAGACCGCCGCUGGUGCAAUUUCCGAAAGGAAGCACUGGAGGAACGUCCGGACUGCACAGGACAGCGUAGGAGGUAAUACCUCUCCACCGUGAGGUGAGGAUCAGAGCAACAGAGACGAGCCGAUUCAGUUCGGGUGAAACGGGCAAUCUCUACGCGCAGCAACACCAAAUAGGCCAGCGUUGACGUGGUUCCGCGGAGCUGGCGGGUAGGUGGCACCGAGCCGGGCAGGCGACUCCCGGCCCAGAUUAAUGGCGGUCACACCGGGCAACCGAAAGGAAGCCAGGCGCACAAAAUCCGGCUUAUCGGCGGGCUUCACAC,83,45,107,93,328
5251,0,AAMQ01000001.1/822672-822270,UCAGAGGGCCGGGCGGCCGCUGCUGCGAGAGGGGAAACCCUGCAGGAGAGGAAAGUCCGGGCUCCAUGGAGGCAAGGCGCCGGGGAAAUCCCGGCGGGCCGGUUCGCCGGUUCAGGGACAGCGCCGCAGAAAUCAGACCGCCGCACUCAGGUGCGGCAAGGGUGAAACGGUGGGGUAAGAGCCCACCGCCCCGACCGCAAGGAAGGGGGCACGGCAAGCCCCGCCUGGAGCAAGACCGAAUAGGGACCCGCGCUGUGCUUCGGCGCAGCAGACGCGCCUCCGCGUCGAGGUCCGGGUAGGUUGCUGGAGGCGUCGUGCAAGCGGCGUCCUAGAGGAAUGGUCGCCCCCGGUCAUCACAUGGGAUGACAUGGGACAGAACCCGGCUUACAGGCCCUCUGAUCCU,81,48,152,122,403
5252,0,CP000481.1/999499-999917,CGAGCCGGCCGGGCGGCCGCGUCGGGCCACGGUGCGCCGUGGACCCGCCGAGGAAGGUCCGGGCUCCACAGGGCAGGGUGGUGGGUAACACCCACCCGGGGCGACCCGCGGGAUAGUGCCACAGAAAACAGACCGCCGCGCAGCCGGCGCCUGCCGCUGCGCGGUAAGGGUGAAACGGCGGUGUAAGAGACCACCAGCGCCCGGGGUGACCCGGGCGGCUCGGCAAACCCCACCCGGAGCAAGGUCAAGAGGCGGCGGACGCCGAUGGGCGGCCGCCGCUGCGCAGGCGCUCGAGGACGGCCCGUCCGAUGCCUGCGGGUGGACCGCUGGAGGUUGCCGGCAACGGCAGCCCAAGAGAGAUGGCCGCCCGUCGCGGAUGACCGCGACGACAGAACCCGGCCUACAGGCCGACUCGCCCG,73,34,165,147,419
5253,0,EU020111.1/1-345,UCGGGAUCCGGGGAGGAAAGUCCGGGCUCCAUGGAAAAACGGUGCCGGGUAACACCCGGCGGGGGUGACCCUAGGGAAAGUGCCACAGAAAGCAAACCGCCUAUUUCAUAGGUAAGGGUGAAAGGGUGGGGUAAGAGCCCACCGCGCACUCAGUAAUGAGUGUGGCAAGGUAAACCCCACCGGGAGCAAGACCGAAUAGAAAUGACGUGCAAGAUUUUACUUGCAGCCAGUUUCCAGGUGAGUCAUUUGGGUAGGUUGCACGAGGCGGAUGGUAACAUCCGUCCCAGAUGAAUGGUUGCCAUGUAGAGUGUAAACUUUACCAUACAGAACCCGGCUUACGAAUUC,96,65,107,77,345
5254,0,AAUX01000001.1/371828-372118,CAAGUUGACUAGACAGUCGCUAUAUAUGCAAAUAUAUAGAGGAAAGUCCGGGCUCCAUAGAGCAAAGUGAUGGCUAACAGCCAUACGCCGUGAGGCGAGGAAUAGGGCCACAGAGACGAGCGUAUUAAGUUACGGUGAAACGCGGUAACCUCCACUUGGAGCAAGGCCAAAUAGGGUAGCAUUGGCACGGCUCGUGUCGCUACCGGGUAGGCUGCUUGAGUGCAUAAGUAAUUGUGCAACUAGAUGAAUGACUGUCCACGACAGAACCCGGCUUAUCGGUCAACUUAACCU,86,60,81,64,291
5255,0,AP006618.1/1794140-1794557,CGAGUUGGUCGGGCGGCCGCGGCGACGGGAACGGGCACGCUGGUGUCGCAGCCCGGCGCCGAGGAAAGUCCGGACUCCACAGAGCAGGGCGGUUGCUAACGGCAACCCGGGGUGACCCGCGGGACAGUGCCACAGAAAACAGACCGCCCACGGCCCUGCGGGGCCGUGCGGUGAGGGUGAAACGGUGCGGUAAGAGCGCACCAGCGCCCCGGGUGACCGGGGCGGCUCGGUAAACCCCGCCCGGAGCAAGGUCGAAGGUCGCAUUCGUUCGCGAGUGCGGCUGCGCAGGCGCUCGAGGGCUGCUCGCCCGAGCCUGCGGGUGGACCGCUCGAGGCACCCGGCGACGGUGUGCCCAGAUGGAUGGCCGCCACCCGGUGCGAACCGGGGACAGGAUCCGGCUUACAGACCAACUCGUCCG,72,46,164,136,418
5256,0,CP000471.1/942511-942148,GAAGCGGGUUGGGUGAUCGCCGGUGUUCCUUGGAACACGGGAGGAAAGUCCGGGCUCCGUUAAAAGGGUGCCGGGUAAUCCCCGGCGGGGGAAACCCCAGGGAAAGUGCCACAGAGAGCAGACCGCCGGCCAGGAGCAAUCCGCCGGUAAGGGUGAAAGGGUGCGGUAAGAGCGCACCGCGUGCACCGGUAACGGUCACGGCAUGGUAAACCCCACCUGGAGCAAGGCCAAAUAGGGGGCGCUUGACGCCCCGGGUAGGCUGCUUGAGACCUACGGUAACGUAGGUCCUAGAUGAAUGAUCACCGCUGCGCCCUCCUGGGAACAGGGCGCAACACAGAACCCGGCUUACAGACCCGCUUCGGCC,84,50,127,103,364
5257,0,AAYC01000006.1/234663-234257,GCAGAAGGCUGGACGGCCGCUUUCAGAGGGUCACCCUUUGCGAGAGGAAAGUCCGGACUCCAUAAAGCAACGGUGCCGGGUAACGCCCGGGCGGGGGAACCCGACGGAAAGCGCCACAGAAAUGAAACCGCCUGCUUUUGCAGGUAAGGGUGAAACGGUGGAGUAAGAGACCACCGCGCCCCUGGCAACAGGGGUGGCAAGGCAAGCCCCACCGGGAGCAAUGCCAAAUAGGGUCCCCGCGCGGGCAGGUCGGAGCAAUCCGAAACCGCCGCUAGGCGCGCUUUAGCCGAGAGGGACCGGGUUGGCAGCUAGAGGUGCAUAGCAAUGUGCAUCGCAGAUGAAUGGUCGUCGAUCCCGGAGCCAUGGCUCCGGGGGGACAAAAUCCGGCUUACAGGCCUUCUGCGCAG,97,55,142,113,407
5258,0,CP000679.1/2264216-2263857,CGAGCAGGUCGAACGGCUGCGCAAGGUGAAAGUUUUUCACCUUGUGAGGAAAGUCCGAGCUCCGCAGGGCAGGGUGCCGGGUAACACCCGGUGGAGGCGACUCCAAGGAAAGUGCAACAGAAAAGAACCGCCAUCCACAUUUUUGGUGGGUGGUAAGGGUGAAAAGGUGAGGUAAGAGCUCACCAGCAGUUAGGCGACUAACUGGCUGUGCAAACCCCACCUGGAGCAAGACCAAAUAGGGGAACAAUGCAGUGGCCCGCUGCGUUCCCGGGUUGGUCGCUUAUGAGUCUGAUGGUAACAUCAGACCAAAAGAGAAAUAGCCGUUCUCGACAGAACUCGGCUUACAGACCUGGUCGCACU,98,65,111,86,360
5259,0,AANB01000016.1/41201-41624,GCAGAAGGCUGGACGACCGCGCUAAGGGCUUGCCCCUUGCGAGGAAAGUCCGGACUCCCUAAAGCAACGGUGCCGGGUAACGCCCGGGCGGGGUAACUCGACGGAUAGCGCCACAGAAACAAACCGCCAUGCCGCGGGGGCCUUCGGGCAACCGUAUCCGGUUUGGUAAGGGUGAAACGGUGGGGUAAGAGCCCACCGCGCCGCUGGCAACAGGGGUGGCAAGGCAAGCCCCACCGGGAGCAAUGCCAAAUAGGGUCCCCGUGUGGGAGAGAGCGGCGUUGGCCGAUCUCGCCACUAGGCUUGCUUUAGCCGAGAGGGACCGGGUUGGCAGCUAGAGGUGCAUAGCAAUAUGUACCGCAGAGGAAUGGUCGUCUAAGGAGCGAAAGCUCUGGGACAAAAUCCGGCUUACAGGCCUUCUGCGCAU,97,64,148,115,424
5260,0,AE014295.3/328247-327873,UGAGACCUCUUGAUGGCCGCGGCCGUGAUCUUCAUUGGGAUCGGCUGAGGAACUUCCGGGCUCCAUAGAGCACGAUGGCGGAUAACGUCCGCCCAGGGUGACCUGAGAGAUAGCGCAACAGAGAACAGACCGCCCGUCCUCGACGGGUAAGGGUGAAACGGCGGUGUAAGAGACCACCGGGCCUCUGGUAACAGUAGGUCGCAUGGCAAGCCUCAUCGGGAGCAAGGCCAAGCAGAUGGCGGUAAGGGCUGCUCGCCCGUGUCAUCGGGUAGGCUGCUAGAGCCUGGCGGUAACGUCAGGUCGAGAUGGAUGGCCAUCCGUGCCGUGCGUUCGCGCACGGCACGACAGAACCCGGGGUAUAAGAGGUCUCAUUUU,81,66,129,99,375
5261,0,CP000325.1/1422068-1422493,CGAGUUGGCUGGGCGGCCGCGGCUCGGGUUGGGCUCGUGUUGUCACGAGUUCAGCGCCGAAUCGAGGAAAGUCCGGACUUCACAGAGCUGGGUGAUUGCUAACAGCAAUCCGAGGUGACUCGCGGGAAAGUGCCACAGAAAACAGACCGCCACCCUCGCGGUGGUAAGGGUGAAACGGUGCGGUAAGAGCGCACCAGCACCCCGGGUGACCGGGGUGGCUAGGCAAACCCCACCCGAAGCAAGGUCAAGAAGGCCGUACCGUAGGUGCGGCUGCGCAGGCGUUUGAGGGCUGCUCGCCCGAGUCUGCGGGUAGGCCGCUCGAGGUACCCGGCAACGGUGUGCCCAGAUGGAUGGUCGCCGCCGCGCCGCCGCUGGUUCAGCCGCGGCGGUGUGGAACAGAAUCCGGCUUACAGGCCAACUCGUCCG,82,65,155,124,426
5262,0,AP009256.1/1270382-1270746,UGAGACCUCUUGAUGGCCGCGACCGAUUUUGUCGGUUGAGGAACUUCCGGGCUCCAUAGAGCACGAUGGCGGAUAACGUCCGCCCAGGGCGACCUGAGAGAUAGCGCAGCAGAGAAUAGACCGCCUUACCGGUUUCGGCCGGUGGGUAAGGGUGAAACGGCGGUGUAAGAGACCACCGGGCCGCUGGUGACAGUUGGCCGCAUGGCAAGCCUCAUCGGGAGCAAGGCCAAGCAGAAGGCGUUCGAGGACUGCUCGUCCGAAGCCUUCGGGUAGGCUGCUAGAGCCUGACGGCAACGCCAGGUCGAGAUGGAUGGCCAUCCGUGCCGUUGGCACGACAGAACCCGGGGUAUAAGAGGUCUCACUCU,79,63,126,97,365
5263,0,AE017125.1/560403-560066,UAGGCAUAGUAGGUGGUUGCUUUUGAUUACAAAAGAGGAAAGUCCGAGCUACAAAGACAGGAUUCCAUUUAACGAAUGGCUAGGGUAACCUAAGGGAAAGUGCAACAGAAAAUUACCGCCUUAUAGAAUCUUAAGAUCUUAAGGUAAGGGUGAAAAGGUGAGGUAAGAGCUCACCGGUCUUUCAGCAAUGUUAGGCGUCUAUGCAAACCCAAUUCGUAGCAAGAAGAAUAUGGUUAAAGUCUUAAGAUAAUAAAUUCUUCGCUUGAGAUAUGUUGUGAAACAUAUCCUAGAUAAAUAGCCACCCACGACAGAACUCGGCUUAUCGCUAUGCCUAUUUU,115,89,76,58,338
5264,0,CP000143.1/890735-891132,GCGGGUGGCCGGAUGACCGCGAGCCUUCGGGCGCGAGGAAAGUCCGGACUCCAUGGGACAAGGGUGCCGGGUAACGCCCGGCCGGGGCAACCCGAGGGAAAGCGCCACAGAGAACAGACCGCCCCACCGGCCUUCGGGCCCGGGGCAAGGGUGAAACGGUGGGGUAAGAGCCCACCGCGGGACUGGCAACAGGACCGGCAUGGCAAGCCCCACCCGGAGCAAUGCCGAAUAGGGGUUCCGCGCGGGCCUGAUCCUUCCGGGGAUAUCGCCGCAGGGACGUCUCAGCCCGAGGAACCCGGGUUGGCAGCUCGAUCCCGUCGGCAACGGCGGGGCCAGAGGAAUGGUCAUCGAAGGGGGCAACCCCGGAACAGAAUCCGGCUUACAGGCUGCCCGCACAA,84,40,148,126,398
5265,0,AE014184.1/342276-342626,GAGGGCUUGCGGGCGGUCGCGGUGUCUAUUGGUACCGAGGAACGUCCGGGCUCCGUAGAGCAAGGCGGUGGGUAACGCCCACCCGGGGUGACCCGAGAGCUGAGUGCCACAGAAAAUAACCGCCGUUACGGUAAGGGUGAAAAGGUGGUGUAAGAGACCACCAGGGAUUGGGGUGACCCAAUCUGCUGGGUAAACCUCGCCUGGAGCAAGAUCAAGCAGGGAACUUAGGCUGCUCGUUUAGUUCCCGGGUAGAUCGCUAGAGCCUGUUGGCAACAACAGGUCAAGAUGGAUGGCCGCCUCGUUGGUUUUUAAUCCAACGAACAGAACCCGGCGUAUAGCAAGCCCUCGUUC,82,67,116,86,351
5266,0,BX572604.1/165137-165616,CAGUCGGCCGGACGGCCGCUCCGGCAAGUGCCGAAAGGCCGCCGGGGAGGAAAGUCCGGGCUCCAUCGACAUACGGUGCCGGAUAACGUCCGGCGGGGGCGACCCCAGGGAAAGUGCCACAGAGAACGAACCGCCCGCCUUCGCAGCUUCGCUGCUUCGGCGCGGCAAGCCCUCGGGCUCGCUGCGCCAUAACCCGCAAGGGUGAAGGCGAGUAAGGGUGAAAAGGUGCGGUAAGAGCGCACCGCGUCGCCGGCAACGGGGACGGCAUGGUAAACCCCACCGGGAGCAAAACCGAAUAGGGACGGCAUCGCGGAUAGUUCGCUGCUCGCAGCGAUAACUCCGCAGGGCGAUGUCAGGCUCGCCGUCCGGGUAGGUUGCUCGAGGCGCUGUGCAAACAGUGUCCCAGAGGAAUGGCCGUCGCGCAUCGCCUCCGCAAGGAAGCGGUGCCCUCCAGAACCCGGCUUACAGGCCGGCUGAUAC,100,61,168,151,480
5267,0,CP000551.1/1546351-1546728,AAAGCAGGAGAGGCAAUCGCAAGAAAGUUUUAUUUUGUUUCCAAAAUAAAACUUUCUUGAGGAAAGUCCGGGCUCCCACAUGGUCAGGCUUGCUGGGUAAUUCCCAGUGCGGGCAACCGUGAGGAUAGUGCCACAGAAACAUACCGCCUAAUACUUUAUGUAUGGCAAGGGUGCAAGGGUGCGGUAAGAGCGCACCAGCAACAUUGAGAAGUGUUGGCUAGGUAAACCCCGGCUGGGAGCAAGGCUUAGUAGAUUUAUGACCAUUACAAAAUCUACUUUUAAGCGCCGCUUGAGACUGUGAAGUAAUUCCAGUCCUAGAUAGAUGAUUGCCCAUCUUUAUUAAGAUGAACAGAACCCGGCUUAUGACCUGCUUUCUAA,111,95,94,78,378
5268,0,AALY01000001.1/401433-401027,GCGGAGGGGCGGAUGGCCGCGGGGUCUGGCAACAGGCCGCGAGGAAAGUCCGGACUCCACAAGGCAACGGUGCCGGGUAACGCCCGGCCGGGGCAACCCGAGGGAAAGCGCCACAGAGAACAGACUGCUCCGGCAUGCCGGAGUGAGGGUGAAACGGUGGGGUAAGAGCCCACCGGGGGGCUGGUAACAGUCCCCGCAUGGCAAGCCCCACCGGGAGCAAUGCCGAAUAGGGAUCGCGCGCGGGGCCGGUCGGGCAACCGAUACCGCCCGCAGGCCGCCUUGGCCCAGCAGAUCCGGGUUGGCAGCUAGAGGCCGCAUGGCAACAUGUGGCCAAGAUGAAUGGUCAUCUCGGGCAGCGUCUUUGGCGCUGUCUAUGACAGAAUCCGGCUUAUAGCCCCUCCGCGCAU,84,51,150,122,407
5269,0,ABCL01000002.1/247411-247824,GCGGAGGGCCGGAUGGCCGCGGCACCUGCAAGGGUGUCGAGGAAAGUCCGGACUCCACAAGACAACGGUGCCGGGUAACGCCCGGCUGGGGUAACCCAAGGGAAAGCGCCACAGAGAAGAGACCGCCCCAGAGUGAUCUGAGGUAAGGGUGAAACGGUGGGGUAAGAGCCCACCGCGGGACGGGCAACCGGACCGGCACGGCAAGCCCCACCGGGAGCAAUGCCAAAUAGGGACCGCGCGCGGGGGCUGGUCCUGGACCCUGGUCCGGGAUACCGCCCGCAGGCACGUCUUGGCCCGGCGGUCCGGGUUGGCAGCUAGAGGGGCGUUGGCAACAGCGUCCCAAGAGGAAUGGUCAUCCAGCCUCGGAUUACGGUCCGGGGUGGACAGAAUCCGGCUUACAGGCUCUCCGCGCCC,87,48,155,124,414
5270,0,CP000377.1/2017757-2017331,GCAGAGAGCCGGAUGGCCGCGUUGGGGCAUCUGCCCCCGCGAGGAAAGUCCGGACUCCCUGAAACGACGGUGCCGGGUAACGCCCGGGCAGGGCAACCUGACGGAAAGCGCCACAGAAAAGAGACCGCCUCGCCGCUCUGGAGGUUCGCCAAAGGAUGCGACGGGGUAAGGAUGAAACGGUGGGGUAAGAGCCCACCGCACCGCUGGCAACAGGGGUGGCACGGCAAGCCCCACCGGGAGCAAUGCCAAAUAGGGCCUCCGCGCGGGCAGGUCGGGCAACCGAAACCGCCGCUAGGGAUGUUUCACCCGAGAGAGGCCGGGUUGGCAGCUAGAGAUGUCCGGCAACGGGCAUCCCAGAAGAAUGGUCAUCGAACCCUGUCUUUUGGGGCAGGGGGAACAAGAUCCGGCUUAUAGGCUCUCUGCGCAA,99,54,151,123,427
5271,0,AAMV01000002.1/534098-534529,GCGGAGGGCCGGAUGGCCGCGGCAUCCCCCAAAGGGGUGACGAGGAAAGUCCGGACUCCACAAGACAACGGUGCCGGGUAACGCCCGGCUGGGGUAACCCAAGGGAAAGCGCCACAGAGAAGAAACCGCCCGUCGCACCUGCGGUUCGCCAAGGGAGACUGCGCACGGGUAAGGGUGAAACGGUGGGGUAAGAGCCCACCGCGGGACGGGCAACCGGACCGGCACGGCAAGCCCCACCGGGAGCAAUGCCAAAUAGGGACCGCGCGUGGGGACAGGUCGGGCAACCGAUACCGCCCGCAGGCACGUCUUGGCCCGGCGGUCCGGGUUGGCAGCUAGAGGGGCGUUGGCAACAACGUCUCAAGAGGAAUGGUCAUCCAACCCCGGAUCACGGUCCGGGGUGGACAGAAUCCGGCUUAUAGGCCCUCCGCGCGC,97,45,158,132,432
5272,0,BX248583.1/58173-58588,GAAGCUGACCAGGCAAUCGCUGCUUUUCUAGACUGUUUUAUUUUUAUACUAUGAAAAUUGGAGUAUGUUGAUAGUUAGUAAGUAUAGAGAAAGGAGAGGAAAGUCCGGGCUCCGUAGGACAAAGUGCCAGGUAACUCCUGGGAGAUGUGAAUCUACGACAAGUGCAACAGAAAAAAACCGCUAAAUGUUAUUAUGAAAUUAAUAAUAAAAGUAAGGGUGAAAAGGUGUGGUAAGAGCGCACCAUACAAUUGGUAACAAUUUGUAGUAAUGUAAACUCCACUUGGAGCAAGGCUAAAUAGAAGUUCUAUAGUAUAGUCCGUACUGAACUUGGGUAAGCCGCUGUAGUUUUUAUGUGAAUAAAAACAUAGAUGAAUGAUUGCCCGUGACAGAACCCGGCUUAUAGGUCAGCUUAUAUA,144,113,99,60,416
5273,0,AAMW01000001.1/77138-77556,CAGGGAGCCGAGGCAACCGCGUGGUUUCGACCGCGAGGAAAGUCCGGGCUCCACGAAGCAAGGGUGGCGGGUAACGCCCGCCGGGUGAGGCUUUCGGGCUGAGCUCAGGGAAAGUGCCACAGAGAGUAUACCGCCGAUGGAGGUCGAACCUCACAGGCAAGGGUGAAAGGGUGCGGCAAGAGCGCACCGGGGGUCUGGCAACAGGCUCCGCAUGGCAAACCCCACCCGGAGCAAGGCCAAAUAGGGGCCUCGCGCCCGACCAGAUACGGUCAGGGCAGGAGCGCUUCGCUCCGAGAGGCCCGGGUUGGCUGCUUGAGCCGCGUGGCAACAUGCGGCCCAGAUGAAUGGUUGCCGCCGCGGCGCUGGUCGAAAGAUACCGGUCGCGGAGACAGAACCCGGCUUAUGACGCUCCCUGAUGC,89,54,154,122,419
5274,0,AALZ01000008.1/147793-148204,GCGGAAGGCUGGAUGGCCGCGGUCUUGGCAACAGGGUCGAGGAAAGUCCGGACUCCCAGAAGAAACGGUGCCGGGUAACGCCCGGGCGGGGUAACCCGACGGAAAGCGCCACAGAAAACAGACCGCCGCUUCGACGGGUCGGGCAACCGAUACCACCGGGGAGGUAAGGGUGAAACGGUGCGGUAAGAGCGCACCGCGGAGGUGGUAACAUCUCUGGCAAGGCAAGCCCCACCGGGAGCAAUGCCAAAUAGGGACCGCGCGCCGCGUCUGGCAACAGGCAAGGCGGGGCCACUUCUGCCCCAGCAGGUCCGGGUUGGCAGCUGUAGCUGUGCAGGCAACUGCAUGGUCAGAGGAAUGGUCAUCCCCUGUCGCAAGGCGGGGACAAAAUCCGGCUUAUAGGCCUUCCGCGCAU,95,53,147,117,412
5275,0,AATQ01000007.1/49807-50210,GUGGAGGGCUGGGCGGCCGCCGCCUUCGGGGUGACCCGUCGGGGGAGGAAAGUCCGGACUCACCGAAGCGCCGGUGCCGGGUAACGCCCGGGCAGGGCAACCUGACGGACAGCGCCACAGAGAACAGACCGCCGUCCUUCGGGGCGGUAAGGGUGAAACGGUGGAGUAAGAGACCACCGGGGGACGGGCAACCGGACCCGCAUGGCAAGCCCCACCGGGAGCAAUGCCAAAUAGGGACCUCGCGCGGGCAUGAUCCUUCGGGAUAUCACCGCAGGGCUGCUUCGGCCCGAGAGGUCCGGGUUGGCAGCUUGAGCGCGCGGGCAACCGCGGGCCUAGAGGAAUGGUCGCCGAGGGGCGGGGAGACCCGCUCUGAACAGAAUCCGGCUUACAGGCCCUCCACGCAU,80,46,155,123,404
5276,0,CP000448.1/742047-741624,UAAGUAAAUCAGAUAGUCGCAGGCAUUUAUUUGCCUGAGGAAAGUCGGAGCUCCAUAGGGCAGGGUGCUGGAUAACAUCCAGUGGGGGUGACCCCAAGGAAAGUGCCACAGAAAGAAACCGCCGGAAAUGGAGACCAGAGCGGAGGACGGAAGUCGGAUGUCGGAAGACCGAUGUUUGAUUACGGAAGAAGGAAUUCCGGGUUCUGGUCUCCGUUUUCGGCAAGGGUGGAAAGGUGAGGUAAGAGCUCACCAGCAUUCAGGCGACUGAAUGGCUCGGCAAACCCCACCUGGAGCAAGACCGAAUAGGGGAACAAUGAGGCGGCCCGUCUCGUUCCCGGGUUAGGUCGCUUGAGGUAGCAGGUAACUGCUGUCCCAGAUAGAUGACUAUCUAAUACAGAACUCCGCUUAUAGAUUUACUUACUUU,117,87,130,90,424
5277,0,AATR01000031.1/8560-8909,GCGGAUGGCUGGGCGGCCGCGCGAAAGCGAGGAAAGUCCGGACUCUUUACAGCAAUGGCGGCGGGUAACACCCGCCUGGGGUAACCCAAGGGAAAGCGCCACAGAAAAUAAACCGCUCACUAAACGUGAGUAAGGGUGAAACGGUAGGGUAAGAGCCUACCGCAGUAUUGGUAACAAUAUUGGCAUGGCAAGCCCCGUCAGGAGCAAAACCAAGUAGGAACCGCGUGCCCUUAUGGGCGGGGUCGCUGAAGCCCCAGCAGGUUCGGGUGGUUGCUAGAGCAUUAUGGUAACAUAAUGCGCAGAUGAAUGGUCGCUCACGACAAAAUCCGGCUUAUAGGCCAUCCGCAUUG,96,59,110,85,350
5278,0,CP000264.1/1178594-1178183,GUGGAGGGCUGGAUGGCCGCGAGGCUCUGUUUUUCGGAAUGGGGUGUCGAGGAAAGUCCGGACUCCCUGAAGACAAGGUGCCGGGUAACGCCCGGGCCUGGCUGUUUGGGGCUUGCCCAGAACGGCUGGGACGGAAAGCGCCACAGAAAACAAACCGCUUCCGCGCCCUCCGGGACGCAGGAGCAAGGGUGAAACGGUGGGGUAAGAGCCCACCGGGGGGCUGGCAACAGCACCCGCAUGGCAAGCCCCACCUGGGAGCAAUGCCGAAUAGGGACCGCAUCAUGGGGCGCUUCACCCCUGCGGUCCGGGUUGGCAGCUAGAGUUUGCGGGCAACCGUAGACCGAGAGGAAUGGUCAUCCAGGCUGGGGUUACCCCGGCUGGACAAAAUCCGGCUUACAGGCUCUCCACGCAU,86,63,147,116,412
5279,0,AAYA01000002.1/458457-458060,GUGGAGGGCCGGACGGCCGCCUUGGGGAAACCCCGGGAGGAAAGUCCGGACUCGCCAAAGCACCGGUGCCGGGUAACGCCCGGGCAGGGCAACCUGACGGAAAGCGCCACAGAAAACAGACCGCCUGUCGCCUGUCGGCAGGUAAGGGUGAAACGGUGGGGUAAGAGCCCACCGGGGGGAUGGCAACAUCGCCCGCUUGGCAAGCCCCACCGGGAGCAAUGCCGUGUAGGGACCUCGCGUCCGACUGAUCCCGCUUGCGGGAUAUCGGGACAGGGCGGCUUUGGCCCGAGAGGUCCGGGUUGGCAGCUAGAGCCGCGCGGCAACGUGCGGCCCAGAGGAAUGGUCGUCUGAGGGGGCAACCCCGACAACAGAAUCCGGCUUACAGGCCCUCCGCGCAU,82,48,147,121,398
5280,0,AP009389.1/933770-934210,UGAGUAAAUCAGGUGAUCGCGGGUGCCGGUCAGGACGGCGCCUGAGGAAAGUCCGAGCUCCGCAGGGCAGGGUGCUGGGUAAUACCCAGUGGGGGCGACCCCAAGGAAAGUGCCACAGAAAUGCAGACCGCCCGGAACAGAAGCCGGAUGCCAAAUGCCGGAGGAUCUUUGGGCUGAAGGCAACUCCUUCCCCAAUUAGAUCUGCCGGCUGUCAGGCUCCCUGCUUUUGUUACGGGCAAGGGUGGAACGGUGCGGUAAGAGCGCACCAGCGGCCGGGCGACCGGCCGGCUAGGUAAACCCCACCUGGAGCAAGACCGAAUAGGGGAGCGUGUGCGGCGGCCCGUCGUUGCUCCCGGGUCAGGUCGCUAGAGGCGGCUGGCAACAGCCGUCCCAGAUAGAUGAUCACCCACGACAGAACUCGGCUUACGAUUUGCUCACUAU,97,71,149,124,441
5281,0,AAWO01000052.1/3266-2896,AAAGAUGGGCAGGUGGCCGCCCGGUCUAUCCGGGAGGAAAGUCCGAGCACCAUAGGGCAAGGCGCUGGGUAACUCCCAGUCCCGGUGACGGGAAGGAAAGUGCCACAGAAAAAAAACCGCCCGAGAAAUCGGGUAAGGGUGAAAAGGCGAGGUAAGAGCUCACCGCGUUUCUGGUGACAGAAACGGCAUGGUAAACCCCGCCCGGUGCAAGACCAAAUAGGGGGGCUUUUCCGUUGUUCGGAAAGGAAUCGGCCCGGUUCGUGCCCCCGGGUAAGGUCGCUUGAGGCCUCGGGUAACCGUGGUCCCAGAGUAAUGGUCGCCACUGCCGGAAGAUGGCAGGACAGAACUCGGCUUAUGUCCUGUCUUUCGCA,91,62,124,94,371
5282,0,M64290.1/94-492,CGAGCCGGGCGGGCGGCCGCGUGGGGGUCUUCGGACCUCCCCGAGGAACGUCCGGGCUCCACAGAGCAGGGUGGUGGCUAACGGCCACCCGGGGUGACCCGCGGGACAGUGCCACAGAAAACAGACCGCCGGGGACCUCGGUCCUCGGUAAGGGUGAAACGGUGGUGUAAGAGACCACCAGCGCCUGAGGCGACUCAGGCGGCUAGGUAAACCCCACUCGGAGCAAGGUCAAGAGGGGACACCCCGGUGUCCCUGCGCGGAUGUUCGAGGGCUGCUCGCCCGAGUCCGCGGGUAGACCGCACGAGGCCGGCGGCAACGCCGGCCCUAGAUGGAUGGCCGUCGCCCCGACGACCGCGAGGUCCCGGGGGACAGAACCCGGCGUACAGCCCGACUCGUCUG,73,45,150,131,399
5283,0,ABCR01000003.1/366725-366320,GCGGAAGGCUGGAUGGCCGCGGGGGUCCGCCCCCGAGGAAAGUCCGGACUCCACAAGACAACGGUGCCGGGUAACGCCCGGCCGGGGAAACCCGAGGGAAAGCGCCACAGAGAACAGACCGCCCCGCAGCUGCGAAAGCGUCUGCACGGGUAAGGGUGAAACGGUGGAGUAAGAGCCCACCGCGGGGCUGGCAACAGCCCCGGCAUGGCAAGCCCCACCGGGAGCAAUGCCGAAUAGGGAUCGCGCGCGGGGGUCUGGUCGGGCAACCGAUACCGCCCGCAGGGACGUCUUGCCCCAGCGAUCCGGGUUGGCAGCUUGAGGUGUCGUGGCAACACGGCGCCCAGACGAAUGGUCAUCCAAGGGGGCGACCCCUGGACAGAAUCCGGCUUACAGGCCUUCCGCGCAU,87,44,147,128,406
5284,0,AE008923.1/912011-912437,GGAGUCGGCCAGACAGUCGCGUCACUCGCAAGAGUGCCGAGGAAAGUCCGGGCUCCAUAGGGCAAGGUGCCAGGUAACGCCUGGGCGGCGCAAGCCGACGGAAAGUGCAACAGAAAGAUACCGCCUACGUCCCUCGUCACCCCUUUGCCGCCACUGAAACGUGCCAGCGAUGCCUCGCAUCGCCAAGCGCGCUCGGAGGCCGCAAAGGGGUGGCGAGGGGCCGGUAAGGGUGAAAUGGUGCGGUAAGAGCGCACCGCGAGUCCGGUAACGGACCGGCACGGCAAACCCCACCUGGAGCAAGACCAAAUAGGGAUCCAUUGGCGUGGCCCGCGCUGGAUCCGGGUAGGUUGCUUGAGCGCCGCGGUGACGUAGCGCCUAGACGAAUGACUGUCCACGACAGAACCCGGCUUAUCGGCCGGCUCCGCCG,93,57,146,131,427
5285,0,CP000020.2/2483732-2483324,UGAGCUGACUCGGUAAUCGCUGCUUCAUUGAUGUCCUUAGGGAGACUGGUGGAGGGGAGGAAAGUCCGGGCUCCAUAGAGCAGGGUGCCAGGUAACGCCUGGGGGGCGCAAGCCUACGACAAGUGCAGCAGAGAGGAAACCGCCGAUGGCUUAAUCUUCUUUUAUUCUUCGGAGUAGAGAAGUAAGCACAGGUAAGGGUGAAAGGGUGCGGUAAGAGCGCACCGGACGUCUAGUAAUAGUGCGUUGCAAGGUAAACUCCACCCGGAGCAAGAUCAAAUAGGCCCUCGCAUAGCAUUGCUCGUGUUUGGGGGCGGGUAGAUUGCUUGAGCCUGUGAGCGAUUGCAGGCCUAGACGAAUGGUUACCACCGCGCAAGCGGGACAGAACCCGGCUUAUAUGUCGGCUCUAACU,100,85,134,90,409
5286,0,CP000927.1/3973535-3973136,CCAGAUGGUCGGGCGGCCGCGGUCUUCGCAAGAAGAUCGAGGAAAGUCCGGGCUCCACGGUGACAAGGCGGCGGGUAACGCCCGCCGGGAGCGAUCCCAGGGAUAGCGCCACAGAAAGCAAACCUCCUCCCUUCGGGGCGGGAAGGGUGAAAGGGUGGGGUAAGAGCCCACCGCGGACCUGGCAACAGGGACGGCAUGGCAAGCCCCGCCUGGAGCAAGACCGAAUAGGGACCCCGCGCCGGCCUCGCGUCGGAUAGGCCGUCACUGGCUGAGAGGGUCCGGGUAGGUCGCGAGAACCGUCCAGCGAUGGACGGUCCAGAGGAAUGGCCGUCUCGCGGUCGUCUUUCCUUCGGGAGGGGCGGACGUCAGACAGAACCCGGCUUACAGACCAUCUGGUCCA,83,51,147,119,400
5287,0,ABED02000025.1/24408-24071,CGAGUGGAACAUACGGCGGCGGGGCGGCUUUGACCGCUCUGAGGAAAGUCCGGGCCUCACAGAGCACGGUAACUGCUAACGGCAGCCGAGGGUGACCUUAGGGAAAGUGCAACAGAAAACAAACCGCCGCAGCAAUGCGGUAAGGAUGAAACGGCGAGGUAAGAGCUCACCAGCGCAUGGGUGACCAUGCGGCUUUGUAAACCCUACCGGAAGCAACGCCUAUAUGGGACGUACAGCGCUGCUCGCGUGUCCCGAAGGCGGCACGAGCCUGUCAGCAAUGGCAGGCCUAGACAGAUCGUCGUUUAAUACAGAACCCGGCUUACGGUCUAUCUCGUUUU,86,57,105,90,338
5288,0,CP000847.1/661512-661911,UAAACAGGUCGUGCAGUUGCGUGAUGAUAUAGCAAAGCUGUAGAUCACGAGGAAAGUCCGGACUCUAUAGAGGUAUGGUGCCGGUUAACCUCCGGCAAAGUAUUAUUACUUUAGGGAAAGUACCACAGAAAAUAUACCGCUGAAUUGUACGUAAGUACUCGGUAAGGGUGAAAAGGUACGGUAAGAGCGUACCGGUAAGUUGGUAACAAAUUACGCAUGGUAAACCCCACCAAGAGCAAGAUCAAAUAGGCAUUACAGAACUUAUCAAGUUCCCGGAUUAUCUCUAGCCGGCUUGUAAUGCGGGUAGAUCGCUUGAGGUAAACGGUAACGUUUAUCCUAGAUAAAUAACUGCAAUGAAUUUAUAUUCAUACAGAAUCCGGCUUAUAGACCUUAUUGUCAU,130,103,94,73,400
5289,0,ABEE02000017.1/499481-499149,UAAGUAAAACAGACAAUCGCGUGAGAUAAUCACGAGGAAAGUCCGUGCACCAUAGAGUAGAAUGCUGGAUAACGUCCAGUGGGGGCGACCCUAAGGCUAGUGCAACAGAGAUAUACCGCCAUUUAUAAUGGUAAGGGUGGAAAGGUGAGGUAAGAGCUUACCAGCAUAUAGGAGACUAUAUGGCUAUGUAAACCCCAUUCGGUGCAAGAUCAAGAUUGAACUUUUGUAGUUGCUCGCUACGUUCAUAGGUAGAUUGCUUGAACAAAUUGGCAACAAUUUGUCUAGAUAGAUGAUUGUCUAAUACAGAACACGGCUUAUAGUUUUGCUUAAUAU,108,87,82,56,333
5290,0,CP001101.1/1048460-1048077,AAACCAAAGUGUGCAGUCGCCGUAUAUCUUUGAGGAUAUGCGGAGGAAAGUCCGAACAUCACAGGACAGGGUGCCGGCCGAGAGUAUUACUCAAGACCGGGAGUAGUGGCGCAAGCUCCUGCUACAGAGAGUGCAACAGAAAGUAUACCGCCCCGGCUACCGGGGUAAGGGUGAAACGGGGGUGUAAGAGACCACCAGACAUGUCAGUAAUGACCUGUGCUAUGAAAACCUCCCCGAUGCAAGGCUGAAUAGGGAAACUUUUCCGAAAGGGAGAAGAGCUGUCCGCUCAAUUUUUUGAGUUUCCGGGUGAGCCGCAUAAGAUAAAUGACUGCAGUCUUGUCGAAAGGCAAGGAACAGAAUUCGGCUUACAGCUUUGGUUUCUUU,110,81,111,82,384
5291,0,CP000908.1/5193807-5193404,UCAGCCGGCCGGGCAGCCGCUCCGUCGUCAGACGGGGAGGAAAGUCCGGGCUCCAUGGAGAGGCGGUGCCGGAUAACCUCCGGCGGGGGCGACCCCAGGGACAGUGCCACAGAGAGCAGACCGCCUUGCAAGGCCCGUCCUUCGCAAGGUCAGGGUGAAAGGGUGCGGUAAGAGCGCACCGCGGACGCGGCAACGCGGACGGCACGGCAAACCCCACCGGGAGCAAAACCGAAUAGGGGCGACACGCCUUCUCCGCGAGGAGGGGGCAGGCCCUCUCUCCAGGCUCGUCGCCCGGGUUGGUUGCUCGAGGCGGCCGGUAACGGACGUCCCAGAGGAAUGGCUGCUACGUCCGUGAGUUCAUCUCGCGGGCCCUACAGAACCCGGCUUACAGGCCGGCUGAUCCA,78,50,146,130,404
5292,0,CP001098.1/1331603-1331257,UAAGUUGGCCGAAUGGUCGCGGCUAUAUAUAUAGCCGAGGAAAGUCCGAGCUUCACAGGGCAGGGUGCUGGGUAACACCCAGUGGAGGUGACUCCCAGGAAAGUGCCACAGAAACAAACCGCCUUACCUGUUUAAUGGUAAGGUAAGGGUGAAAAGGUGAGGUAAGAGCUCACCAGUGCCCAGGUGACUGGGUAGCUAGGUAAACCCCACCCGAAGCAAGUCCAUGUAGGGGGAGUUAAGGGUGGCCCGCCCGUUCCCCGGGUCUGGACGCUAAAGGUACCAGGCGACUGGUAUCUCAGAUAGAUGACCAUUCAAGACAGAACUCGGCUUACAGGUCAACUUAUACU,95,67,104,81,347
5293,0,CP000923.1/1357072-1357421,UGAGUAAGUCGGAUGGCCGCGUGCGAUUUUCGCACGAGGAAAGUCCGAGCUCCACAGGGCAGGGUGCCGGGUAAUACCCGGUGGAGGCGACUCCAAGGAAAGUGCAACAGAGAUAUACCGCCUGGCACUCAACUUGCUGAGUGCUGGGUAAGGGUGGAAAGGUGAGGUAAGAGCUCACCAGGGACCAGGCGACUGGUCUGCUCUGCAAACCCCACCCGGAGCAAGGCGAAUAGGAGGGAGUAGGUGGCCCGCCGUUUCCCUCGGGUUAUGCCGCUGGAGGUGUCAGGCAACUGACCCCCUAGAUAGAUGGCCAUCCUCGACAGAACUCGGCUUACAGACUUGCUCACAUG,82,62,115,91,350
5294,0,CP000849.1/247812-248205,AAAUAGGUCGUGUAGUUGCGUGAUUUUUAAAAAAUUACGAGGAAAGUCCGGACUCUAUAGAGGUAUGGUGCCGGGUAACGCCCGGCGGAGUAAUAUUACUUUAGGGAAAGUGCCGCAGAAAAUAAACCGCCAUAAUAUAUUUUAUAUUACGGUAAGGGUGAAAAGGUGUGGUAAGAGCACACCGGUAAGUUGGUAACAAGUUACGCAUGGUAAACCCCACCAAGAGCAAAAUCAAAUAGGCGUUACAGAGCUUUUAUAAGCUCCAGGGUAUCUCUAACCGGUUUGUAAUGCGGGUAGAUUGCUUGAGGUAAACGAUAACGUUUAUCCUAGAUAAAUAACUACAACGAGCUAUUUAUAGUUCGUACAGAAUCCGGCUUAUAGACCUUAUUUUGUC,127,107,94,66,394
5295,0,CP001097.1/1676001-1676408,AAACCGCAAGUGUGCAGCCGCUGUAUAACUUCUGGUUAUGCAGAGGAAAGUCCGAACUUCACAGGGCAGGAUGCCGGUCGAGAGCCGAAAGGCUCAAGCCCGGGGACAGCAGGGAAAACCAGCUGUCACAGAUAGUGCAACAGAAAAUAUACCGCUCCGGGAAACCGGUGUAAGGGUGAAAAGGCGGUGUAAGAGACCACCGGAUAUUCCGGUAACGGAAUGUGCCUGGCAAACCUCUCCGAAGCAAGGCUAAAUAGGAAAACUUUUUUCCUUCGGGAAAAAAAGAGCGGCCCGUUCAAUUCCUUUUACAAGGAGAGUUUUCGGGUAAGCCGCAUCAGAUAAAUGGCUGCAGCUUCAUAUCCCAGGGGAUAUGAUCCACAGAAUUCGGCUUACAGCUUCGGUUUCAGC,121,81,112,94,408
5296,0,CP000820.1/6067977-6068392,CGAGUUGGCCGGACGGUCGCGUCGGUACCGGGGCGCGAGCCCGGGUGCCGCCGAGGAACGUCCGGGCUCCACAGGGCGGGGUGGUGGGUAACGCCCACCCGGGGUGACCCGCGGGACAGUGCCACAGAGAACAGACCGCCGGUGCCGUCAUGGCGCCGGUAAGGGUGAAACGGUGCGGUAAGAGCGCACCAGCGCCCGGGGUGACCCGGGCGGCUAGGUAAACCCCACCCGGAGCAAGGCCAAGAGGCCCCGGCCGGUCACGGUCGCGGGCUGCGCAGGCGUCCGAGGGCUGCUCGCCCGAGCCUGCGGGUAGGCCGCUGGAGGCCGUCGGCAACGGCGGUCCUAGAUAGAUGACCGUCACCGGCAAGCCGCGAGGCGACCCGGAACAGAACCCGGCGUACAGGCCAACUCGUCCG,72,41,165,138,416
5297,0,CP001110.1/1741219-1741621,AACCGCAAGUGUGCAGUCGCCGUGCAGCCCAUCCGGGCUGUGCAGAGGAAAGUCCGAACUUCACAGGGCAGGGUGCCGGUCGAGAGUUGCAAAACUCAAGCCCGGGGAUAACGGCGCAAGCCGCUUGUCACAGAAAGCGCAACAGAAAACAGACCGCUUCGGGCAACCGGAGUAAGGGUGAAACGGGGGUGUAAGAGACCACCAGACAUGACAGUAAUGGCAUGUGCUUGGCAAACCUCCCCGAAGCAAGGCUAAAUAAGAGGACUUUUCCCCCAGGGGAAAAAGAGCGGCCCGUUCAAUUCCGCAAGGAGAGUUCUCGGGUAAGCCGCAUCAGAUAAAUGGCUGCAGUCUUACCCGGUCUCCGGGUAAUUCACAGAAUUCGGCUUAUAGCUUACGGUUUCAG,112,69,119,103,403
5298,0,CP001124.1/580627-581051,CGAAGCAGACCAGAUGGCCGCCGUCCACCGUAGCCUUUGGCGAAGGUGGAGGGAGGAAAGUCCGGGCUCCACAGGGCAUGGUGCUGGAUAACGUCCAGCGAGGGUAACCUCAGGGAAAGUGCCACAGAGAGAAGUCCGCCCCCCACACCCUGGCGACAGGGUCCGCCGAAGCCUCGGCGAAGGCGGAAGGGGGGUAAGGGUGAAAGGGUGAGGUAAGAGCUCACCGGGUUCGGCGGCGACGCCGGAUGCCAGGUAAACCCCACCAGGAGCAAGACCAAAUAGGGAAGCGUUAAGGACGGCCCGUCCGUGCUUCCGGGUUGGUUGCUUGAGGGCGUCGGUAACGGCGCUCCUAGAUGAAUGACCAUCGCCCGUCUCCGGGUAACCGGCUGCGGGAACAGAACCCGGCUUACGGGCUGCUUCGGCCA,94,59,153,119,425
5299,0,CP000675.2/2025610-2025238,AGAGUCGGUCAGGCAAUCGCUCUUUGCCUAACAGCAAGGGGAGGAAAGUCCGGGCUCCAUAGGGCAGAGUGCCAGGUAACUCCUGGGAGGUGUGAGCCUACGGAAAGUGCCACAGAAAAUAUACCGCCCACUUUUCCUUUGGGAAUCGUAGGUAAGGGUGAAAUGGUGCGGUAAGAGCGCACCGCGCGAUUGGUAACAGUCGUGGCAGGGAAAACCCCACUCGGAGCAAGACCAAAUAGGAAUCCAUUUGACUGCAAGGUCCUAACGUAUGGCCCAUACGGGAUUCGGGUAGGUCGCUUGAGGCAUGUGGUGACGCAUGUCCCAGAUGAAUGGUUGCCCACGACAGAACCCGGCUUAUCGACCGACUCUAAUC,97,73,113,90,373
5300,0,CP000859.1/2608080-2607688,GAAGUUGCGCAGACGAUCGCUGAAGCGGUCAAGGCAUUGGCCUGCCGCUUUGGAGGAAAGUCCGAACACCACAGGGCAGGGUGCUUCAUAACGUGAAGUCAUGGCGACAUGAAGGAAAGUGCCACAGAAAAGAUACCGCCAAAGGAGCGCUGCUCUUUUGGUAAGGGUGAAAAGGUGCGGUAAGAGCGCACCAGUUCCCCGGGUGACCGGGGAAGCUAGGUAAACCCCACCCGGUGCAAGACCAAAUAGGGGGACGUUUGAGGGCGGCCCGUCCAAGUCCCCGGGUAGGUCGCAUGAGGCGUCGGGCAACCGGCGUCCCGAGAGGAAUGAUCGUCGGCCGGCAAGGGGUAACCCGCGCCGGACACAGAAUUCGGCUUACGCGCAGCUUCAACC,98,59,133,103,393
5301,0,BA000016.3/2292224-2291878,CGAGUAAGCCAGACAAUCGCUGCUAGUCUUAGAACUAGGAGAGGAAAGUCCGAGCUCCAUAGGGCAGGAUGCUGGAUAACGUCCAGUGGAGGUGACUCUAAGGAUAGUGCAACAGAAAUAAACCGCCUAGAUUUAUCUAGGUAAGGGUGGAAAGGUGAGGUAAGAGCUCACCAGGGUAUAGGUGACUAUACUGCUAUGUAAACCCCAUCUGGAGCAAGACCAAAUAGGAGGACAUAUAGGGGCUGCCCGUCCCGUCCUCGGGUGUGUCGCUUGAGCCUAUCGGCAACGGUAGGCCUAGAUAGAUGAUUGUCAAAUACAGAACUCGGCUUAUAGACUUAUCUCGUAUU,101,77,98,71,347
5302,0,CP001348.1/631191-631544,UGAGUAAGCCAGAUGAUCGCAGAUACUGCCUGAAAAGGCGUAGAUGAGGAAAGUCCGGGCUCCAUAGGGCAAUGGUGCCGGGUAACUCCCGGUGAAGGUGACUUUAAGGAAAGUGCAACAGAGAUAUACCGCCAUAUUAGGUUUGCCUUAUAUGGUAAGGGUGGAAAGGCGAGGUAAGAGCUCACCAGCGACUUGGCGACUUGUCGGCUAUGUAAACCCCAUCUGGAGCAACACCGUGGAGGGACGCAAUGACUGCCCGUCAGUCCCGGGGAGGUGGCUUGAGCCAGACAGAAAUGUAUGGCCUAGAUAGAUGAUCAUCAAAUACAGAACCCGGCUUAUAGACUUACUCAUACC,101,72,104,77,354
5303,0,CP000943.1/324335-323926,UCAGCCGGCCGGGCGGCCGCUCUGCCCUCGGGCAGGGAGGAAAGUCCGGGCUCCAUGGAGAGACGGUGCCGGAUAACAUCCGGCGGGGGCGACCCCAGGGACAGUGCCACAGAGAGGAGACCGCCGGGCGGGCCGCGAGGCCCGCGCCGGUCAGGGUGAAAGGGUGCGGUAAGAGCGCACCGCGGACGCGGCAACGCGGACGGCACGGCAAACCCCACCGGGAGCAAGACCGAAUAGGGGCGACACGGGCGGGCCGACGGCCCGCCCAGGCCUCUCCCCAGGCCCGUCGCCCGGGUUGGUUGCUCGAGGCGGCCGGCAACGGCCGUCCCAGAGGAAUGGCCGCCACGUCCGGGGGACCCGCGAGGGUCCGCCGGGCCCUACAGAACCCGGCUUACAGGCCGGCUGAUCCC,71,33,162,144,410
5304,0,AAUJ02000001.1/472894-473254,GAAGUGCGCCAGACCGCCGCUGGUACUAGCCGAAAGGCCAACGCUUGCGUUGGGUCGAAAGACCGUACUGGAGGAACGUCCGGACUGCAUAGGGCGGCGUAGCAGCUAACAGCUGUCCACCGUGAGGUGAGGAUCAGAGCAACAGAGACGAGUCUGGCAGGAGUGCCGCAAGGCAGACCAACCAGGGUGAAACGGGCAAUCUCUACGCGCAGCAAUACCAAGUAGGCACACGUUGACGGGGCCCCCGGAGUGUGCGGGUAGGUAGCACCGAGCCAUCAGGCGACUGAUGGCCAAGAUUAAUGGCGGUCACAUGGCGGGCAACCGUUGUGCACAGAAUCCGGCUUAUCGGCGCACUUCACAC,90,53,120,98,361
5305,0,CP000853.1/1386146-1386539,UGAGUAGAUCAGAUGAUCGCGGACAUGGUUUUCCAUGGACGAGGAAAGUCCGAGCUCCAUAGGGUAGGGCGCUGGGUAACACCCAGUGGGGGCGACCCCAAGGAAAGUGCAACAGAGAGAUACCGCCAGAUCCCUUGUUCAGUAGCAAUGCUGUUACUUGGGUGAGAAUAGCUUUUGACAGCUAUCUGGUAAGGAUGGAAAGGUGAGGUAAGGGCUCACCAGGGGCUAGGUGACUAGUCUGCUAUGUAAACCCCGUCUGGAGCAAGACCAAGUAGGGACUGAAAAAGCGGCGACCCGUCGUGUCCCGUGGUAGGUUGCUUGAGCCGUCUGGUAACAGCCGGCCUAGAUAGAUGAUCGUCGAAUACAGAACUCGGCUUAUAGAUUUGCUCACUUA,102,86,122,84,394
5306,0,CP000830.1/2943463-2943080,GCGGGGGGCUGGAUGGCCGCUUGGGCCGAUGUUUCGGUUCGAGAGGAAAGUCCGGACUCCACGAAGAGACGGUGCCGGGUAACGCCCGGGCGGAGUGAUCCGACGGAAAGCGCCACAGAGAAAAGACCGCCUGCCACAGGGCGGGUCAGGGUGAAACGGUGGGGUAAGAGCCCACCGCGGGGCUGGUAACAGCCCCGGCACGGCAAGCCCCACCGGGAGCAAUGCCAAAUAGGGACCUCGUCGCGUCGCAAGGCGCGGGGCCGCUUCAGCCCAGAGGUCCGGGUUGGCAGCUAGAGCGGCCGGGCAAUCGGUCGCCCAGAGGAAUGGUCAUCCACGGGGGUCCGCCCCCUGGACAGAAUCCGGCUUACAGGCCCCUCCGCGCAU,77,46,144,117,384
5307,0,AAQJ02000001.1/918442-918085,AGAGUUAGCUAGACAGUCGCUGUAAUAAUUAUCAUUACAGAGGAAAGUCCGGGCUCCAUUGGGCAAAGUGCCAGGUAAUGCCUGGGAAGCGCGAGCUUACGGAAAGUGCCACAGAAAAUAGACCGCCUAAGAUUUAUAAUGAUGGGUCUCAGGUAAGGGUGAAAAGGUGUGGUAAAAGCACACCGCAUCACUGGUAACAGUGGUGGCAAGGUAAACCCCACUUGGAGCAAGACCAAAUAGGAACCUUUUAGACGCGGUCCACGUUAGGUUCGGGUAGGUCGCUUGAGAUAUACGGUGACGUAUGUCCUAGAUGAAUGACUGUCCACGACAGAACCCGGCUUAUCGGCUAACUCUUCUU,105,80,99,74,358
5308,0,ABCC02000021.1/71166-70809,UGAGUAGGACAGGUGGCCGCUGCCGCGAUACCGCAAGGCCGCGGGAGAGGAAAGUCCGGGCUUCACAGGGCAGGGUGCCAGAUAACGUCUGGCGGAGGCGACUCCAGGGACAGUGCAACAGAAAUGUACCGCCUUUUUGGCUGCGGCCUUAAAGGUAAGGGUGGAAGGGCAGUGUAAGAGACUACCGCCCGUCUGGUAACAGGCGGGGCACAUGUAAACCCCACUCGAAGCAAGACCGAACAGGAAGCAUAUGGCUGCCCGUCAGCUUCCGGGUAGGUUGCUUGAGGCUGCCGGCGACGGCAGUCCUAGAUAGAUGGCCAUUCAACGACAUAACCCGGCUUAUCGUCCUGCUCACAUA,86,61,117,94,358
5309,0,CP001089.1/691698-691329,GGAGUAGGCCAGAUGAUCGCUGUCUGACCCAGGUCAGAGGGAGGAAAGUCCGGGCUCCAUAGGGCAGGGCGCUGGGUAAUCACCAGCGGGGGCGACCCCAGGGAAAGUGCCACAGAGAGAAGUCCGCCCGUUUCGACGGGUAAGGGUGAAAGGGUGAGGUAAGAGCUCACCGGGUCCGGUGGUGACACCGGAUGCCAGGUAAACCCCGCCAGGAGCAAGGCCGAAUAGGGAGGCGUCAAGGGCGGCCCGCCCGUGCCUCCGGGUUGGCUGCUUGAGGUCACCGGUAACGGUGAUCCUAGAGGAAUGAUCAUCAUCUGCCGUCGGGUAACCACCGGCAGAAACAGAACCCGGCUUACGGCCUGCUCCAACC,84,53,132,101,370
5310,0,CP001390.1/835755-836131,CGAAGCAGACCAGGUGGUCGCCGCCCGCAAGGGGGGAGGAAAGUCCGGGCUCCACAGGGCAUGACGCUGGAUAACGUCCAGCGGGGGCAACCCCAGGGAAAGUGCCACAGAGAGAAGUCCGCCUGUCGGAAGCGUGCGAAGACAGGUAAGGGUGAAAGGGUGAGGUAAGAGCUCACCGGAUCCGGCGGUGACGUCGGAUGCCAGGUAAACCCCGUCAGGAGCAAGACCAAAUAGGGAAGCGUCAAGGACGGCCCGUCCGUGCUUCCGGGUUGGUUGCUUGAGGCCGUCGGUAACGACGGUCCUAGAUGAAUGGCCGCCGCCUGCUUCAGGGAAACCUGUUGCAGGAACAGAACCCGGCUUAUGGGCUGCUUCGGCCA,88,54,136,99,377
5311,0,CP001037.1/1484900-1485316,AGAGUAGACGCAGGCGGUUGCAGAUCAGUCAUAGUCACUGAUUUGAGGAAAGUCCGGGCUCCCGAAAGACCAAACUUGCUGGAUAACGUCCAGUGCGAGCGAUCGUGAGGAUAGUGCCACAGAAAGAUACCGCCAGAUCAAUUAAAAAUUAAAAAUUAAAAAUCUAAAAUGAGUAAUUUUUAAUUUUACAUUUUUAAUUGAUCUGGUAAGGGUGCAAAGGUGCGGUAAGAGCGCACCAGCAGUAUCGAGAGGUGCUGGCUCGGUAAACCCCGGUUGGGAGCAAGGCGAUAGGAACUACGGUUGGUCUUUUACCAGUUCCGCUCAAUGAGAGCCGCUAGAGGCGUUUGGUAACAAGCGUCCCAGAUAGAUAACUGCCCUCGCAAGAGAACAGAACCCGGCUUAUGUACUGCUCUUUCC,125,97,109,86,417
5312,0,CP000750.2/3654587-3654962,CGAGUCGGCCGGGCGACCGCGUCGGCCGGGGCGACCCGGCCGCCGAGGAAAGUCCGGACUCCACAGGGCAGGGUGGUGGCUAACAGCCACCCGGGGUGACCCGCGGGACAGUGCCACAGAGAACAGACCGCCACCCCGAGCGAUCGGGGCGGUAAGGGUGAAACGGUGGUGCAAGAGACCACCAGCGUGCCGGGUGACCGGUGCGGCUAGGUAAACCCCACCCGGAGCAAGACCAGACAGGCAGCGUUCGAGGGCGGCCCGCCCGAGCUGCCGGGUAGGUCGCUUGAGGCGUGCGGCAACGCACGUCCUAGAGGGAUGGUCGCCGCCCGCUCCCCGGAGCGGGGCACAGGAUCCGGCUUACAGGCCGGCUCGUCCA,70,37,145,124,376
5313,0,AE016828.2/103047-103388,AGAGCCAGCCAAACAGUCGCUCAACGGUAGUUGGGAGGAAAGUCCGGGCUCCAUCGGGCAGAGUGCCAGGUAACCCCUGGGAGGCGCGAGCCUACGGAAAGUGCAACAGAAAGAAUACCGCUGCCGUCAGGCAGUAAGGGUGAAAUGGUGUGGUAAGAGCACACCGCGUUGGUGGUAACAUUAACGGCGAUGGUAAACCCCACUCGGAGCAAGGCCAAAUAGGAAUCCUGAUUGUGUGGCCCACACAGUGGAUUCGGGUAGGCUGCUUGAGGUACAUGGUGACAUGUAUCCCAGAUAGAUGACUGUUCAUGACAGAACCCGGCUUAUCGGCUGGCUCUCCAA,91,63,107,81,342
5314,0,ABAX03000012.1/707980-707643,UUAGUUAACCGAAUGAUCGCGCCAAAGUCUUUUGGUGAGGAAAGUCCGGGCUUCGCAGGGCAGGAUGCCGGAUAACGUCCGGUAGGGGUGACCCUCAGGCUAGUGCAACAGAAAUAAACCGCCGGUAUUAGCCGGUAAGGGUGGAAAGGCGGGGUAAGAGCCCACCGCUUGGCUGGUAACAGGCAAGGCACAUGUAAACCCCAUCCGAAGCAAGGCAGGAGAAAAGCUAUGGGCUUGCCCGGUCCGCUUUUCGGUGUGCCGCUGGAGCUUGCUGGCAACAGCAAGUCGAGAUAGAUGAUCAUUUAAGACAGAACCCGGCUUAUAGAUUAGCUAAAUUC,90,67,104,77,338
5315,0,CP000878.1/1554059-1554452,GAAAGCAGGAGAGGUGAUCACAAUCAAGAUUUAUCGCGUUUCGCAAUAAAUGCUUGAUUGAGGAAAGUCCGGGCUCCCUGAUGGUCAAGCUUGCUGGGUAACUCCCAGUGCGGGUGACCGUGAGGAUAGUGCCACAGAAACACACCGCCGAUGGCUUAGUCCCACUCAGCACAGGCAAGGGUGCAAAGGUGCGGUAAGAGCGCACCAGCAGCAUCGAGAGGUGCUGGCUUGGUAAACCCCGGCUAGGAGCAAGGCAAAGGAGCAUUAAUGGCCAUCUAUGAUGCUCCUGAAAAAAGCCGCUUGAGGUUGUCGGUAACGGCAGUCCCAGAUAGAUGAUUACCCACUAACCUUUUUAGGUAGUGAACAGAACCCGGCUUAUGACCUGCUUUCACCC,107,81,111,95,394
5316,0,CP000409.1/594394-594001,CUAAAUGGUCAUGCAGUUGCGUGAUGAUAUAGCAAAGCUAUAGAUCACGAGGAAAGUCCGGACUCUAUAGAGGUAUGGUGCCGGCUAAUCUCCGGCAGAGUAUUAUUACUUUAGGGAAAGUACCACAGAAAAUAUACCGCCGCAAUAUUUCGGUAAGGGUGAAAAGGUACGGUAAGAGCGUACCGGUAAGUUGGUAACAAAUUACGCAUGGUAAACCCCACCAAGAGCAAGAUCAAAUAGGCAUUACAGAACUUGUGUUUCCAAGUUCCCGGGUUAUCUCUAACCGGCUUGUAAUGUGGGUAGAUCGCUUGAGGUAAACGGUAACGUUUAUCCUAGAUAAAUAACUGCAAUGAAUUUCUAUUCAUACAGAAUCCGGCUUAUAGACCUUAAAAAU,128,102,91,73,394
5317,0,CP001251.1/1276985-1276628,GAAGUAGAUCAGGCAACCGCGGAAUUGAGAGAUUCCGAGGAAAGUCCGAACACCAAAGGGCAGGGUGCUGGGUAAUACCCAGUCAGGGUGACCUGAAGGAAAGUGCCACAGAAAAUAAACCGCCCAAGGUUUUUGCCUUGGGUAAGGGUGAAAAGGUGAGGUAAGAGCUCACCAGCAGGAAGGGUGACCUUCCUGGCUUGGCAAACCCCACCUGGUGCAAGGCCAAAUAGGAGGGGUUGAGGUGGCCCGCCGACCCUCGGGUUGGCCGCUUGAGGCAAGAAGUAAUUCUUGCCCUAGAUAGAUGGUUGCCGCCCCAUAUAUAUGGGGAACAGAAUUCGGCUUAUGAUCUGCUUCUUCC,96,70,111,81,358
5318,0,CP001146.1/1110111-1109756,GAAGUAGAUCAGGCAACCGCGGAAUCGAAAGAUUCCGAGGAAAGUCCGAACACCACAGGGCAGGGUGCUGGGUAACACCCAGUCAGGGCGACCUGAAGGAAAGUGCCACAGAAAACAGACCGCCUAGGGUUCUUUACCCUGGGUAAGGGUGAAAAGGUGAGGUAAGAGCUCACCAGCAGGAAGGGUGACCUUCCUGGCUUGGCAAACCCCACCCGGUGCAAGGCCAAAUAGGAGGGGUUGAGGUGGCCCGCCGACCCUCGGGUUGGCCGCUUGAGGCAAGAAGUAAUUCUUGCCCUAGAUAGAUGGUUGCCGCCCCUAUAUGGGGAACAGAAUUCGGCUUAUGAUCUGCUUCUUCC,93,64,111,88,356
5319,0,CP000304.1/1180839-1181198,AGAGUUGAUCGGACAGUCGCUGUCUCUUUUUGUUCCGGCAAGAAGGGAGGGAGGAAAGUCCGGGCUCCAUAGGGCAAAGUGCCAGGUAACGCCUGGGAGGCGUGAGCCUACGGAAAGUGCCACAGAAAAUAACCGCCUAAGCGCUUCGGCGCCGGUAAGGGUGAAAAGGUGCGGUAAGAGCGCACCGCACGGCUGGCAACAGUCCGUGGCUAGGUAAACCCCACUUGGAGCAAGACCAAAUAGGGAUCCAUUGGCGUGGCCCGCGCUGGAUCCGGGUAGGUUGCUAGAGGCAGUCAGUGAUGGCUGUCGUAGAGGAAUGGCUGUCCUCGACAGAACCCGGCUUACAGAUCGACUCUCCGA,87,64,121,88,360
5320,0,CP001157.1/1278404-1278762,AGAGUCGGUUGGACAGUCGCUGUCCCAUAUUGUUCCUCAAUAUGGGAGGGAGGAAAGUCCGGGCUCCAUAGGGCAGAGUGCCAGGUAACGCCUGGGAGGCGCGAGCCUACGGAAAGUGCCACAGAAAACAACCGCCUAAGCGCGCAAGCGCCGGUAAGGGUGAAAAGGUGCGGUAAGAGCGCACCGCACGGCUGGCAACAGUUCGUGGCUAGGUAAACCCCACUCGGAGCAAGACCAAAUAGGGAUCCAUUGGCGUGGCCCGCGCUGGAUCCGGGUAGGUUGCUAAAGGCGGCCAGCGAUGGUCGUCGUAGAGGAAUGACUGUCCUCGACAGAACCCGGCUUACAGACCGGCUCUCCCC,87,57,119,96,359
5321,0,CP000712.1/4919241-4918866,AGAGUCGAUCGGACAGUCGCUGCCUGUUUUUGUUCCGCAACUUUUUGUUGUGUGAGCAGCAGGGGGAGGAAAGUCCGGGCUCCAUAGGGCAGAGUGCCAGGUAACGCCUGGGAGGCGUGAGCCUACGGAAAGUGCCACAGAAAAUAACCGCCUAAGCACUUCGGUGCCGGUAAGGGUGAAAAGGUGCGGUAAGAGCGCACCGCACGGCUGGCAACAGUUCGUGGCUAGGUAAACCCCACUCGGAGCAAGACCAAAUAGGGUUCCAUCAGGCGUGGCCCGCGUCGGAACCGGGUAGGUUGCUAGAGGCGUCCAGUGAUGGCCGUCGUAGAGGAAUGACUGUCCUCGACAAAACCCGGCUUACAGAUCGACUCUCCAC,89,70,122,95,376
5322,0,BX897699.1/1251235-1250846,UCAGUCGGCUGGGCAGCCGCGCUUGUCAAUGCCUAAAGGUGGCAGGUGAGGAAAGUCCGGGCUCCAUGGAAAAACGGUGCCGGGUAACACCCGGCGGGGGCGACCCUAGGGAAAGUGCCACAGAAAGUAAACCGCCUAUUUUUAUAGGUAAGGGUGAAAGGGUGGGGUAAGAGCCCACCGCACAUUCAGUAAUGAAUGUGGCAAGGUAAACCCCACCGGGAGCAAGACCAAAUAGAAAUGACGCGCAAGGCUUAACUUGCAGCCGGUUUCCGGGCGAGUCAUUCGGGUAGGUUGCAAGAGGCGGAUGGUAACAUCCGUCCCAGAUGAAUGGUUGCCAUGUAAAGUGUACACUUUACCAUACAGAACCCGGCUUACAGGCCGACUGAUUUU,106,74,120,90,390
5323,0,CT573326.1/4810543-4810184,AGAGUCGAUCGGACAGUCGCUGCCGUCUUUUGUUCCGCAAGAGGCGGGGGAGGAAAGUCCGGGCUCCAUAGGGCAGAGUGCCAGGUAACGCCUGGGAGGCGCGAGCCUACGGAAAGUGCCACAGAAAACAACCGCCUAAGCGCUUCGGCGCCGGUAAGGGUGAAAAGGUGCGGUAAGAGCGCACCGCGCGACUGGCAACAGUUCGUGGCUAGGUAAACCCCACUCGGAGCAAGACCAAAUAGGGUUCCAUACGGCGCGGCCCGCGUCGGAACCGGGUAGGUUGCUAGAGGCGUCCAGUGAUGGCCGUCGUAGAGGAAUGACUGUCCUCGACAAAACCCGGCUUACAGAUCGACUCUCCAC,86,56,120,98,360
5324,0,CP000934.1/1090630-1090999,GGAGUUGGCCAGGCAAUCGCUCCGCGCAUACCUUCCAUUGCUGGAUAAGGUGCGCCGGGGAGGAAAGUCCGGGCUCCAUAGGGCAGAGUGCCAGGUAACACCUGGGAGGCGUGAGCCUACGGAAAGUGCAACAGAGAGUAGACCGCCCAAGCACGCAAGUGCCGGUAAGGGUGAAAGGGUGCGGUAAGAGCGCACCGCGCAACUGGUAACAGGCUGCGGCUAGGUAAACCCCACUCGGAGCAAGACCAAAUAGGGGUCCAUUGGUGUGGCCCGCACUGGACCCGGGUAGGUUGCUUGAGGCCUGUGGUGACACAGGUCCCAGAUGAAUGAUUGCCCACGACAGAACCCGGCUUAUCGGCCGACUCCUUUA,88,60,124,98,370
5325,0,CP001277.1/1731802-1732181,UAAGUUAACCAGACAGUCGCCGCUUCUUUUGAUGUUUAUUAAAAAAACAAAAAAUAGAAGAGGAGGAAAGUCCGGGCUCCAUAGAGCAGAGUGCCAGGUAAUGCCUGGGAGGCGUGAGCCUACGACAAGUGCAACAGAGAGCAAACCGCCGAUGGCCUGAAAUAUGAGGAUCAGGUAAGGGUGAAAUGGUGUGGUAAGAGCACACCGCGCGUUUGGUAACAAGCGUGGCAAGGUAAACUCCACUCGGAGCAAGACCAAAUAGGGGUUCACAUAGUGCGGCUCGUACUGAACUCGGGUAGGUUGCUUGAGCCAUCAAGCGAUUGCUGGCCUAGAUGAAUGACUGUCCACGACAAAACCCGGCUUAUCGGUUAACUUACUUU,115,79,107,79,380
5326,0,CP000680.1/1031226-1031573,AGAGUCGAUCGGACAGUCGCUGCCUUCGCAAGAAGGGGGAGGAAAGUCCGGGCUCCAUAGGGCGGAGUGCCAGGUAAUGCCUGGGAGGCGUGAGCCUACGGAAAGUGCCACAGAAAAUAACCGCCUAAGCGUUUCGGCGCCGGUAAGGGUGAAAAGGUGCGGUAAGAGCGCACCGCACGGCUGGCAACAGUCCGUGGCUAGGUAAACCCCACUCGGAGCAAGACCAAAUAGGGUUCCAUCGGCGUGGCCCGCGCUGGAACCGGGUAGGUUGCUAAAGGCGUGCAGUGAUGUACGUCGUAGAGGAAUGGCUGUCCUCGACAGAACCCGGCUUACAGAUCGACUCUCCUC,84,57,118,89,348
5327,0,CP000075.1/4902542-4902185,AGAGUCGAUUGGACAGUCGCUGCCUCUUGUUGUUCCGCAACAAGGGGGGGAGGAAAGUCCGGGCUCCAUAGGGCGGAGUGCCAGGUAACGCCUGGGAGGCGUGAGCCUACGGAAAGUGCCACAGAAAAUAACCGCCUAAGCACUUCGGUGCCGGUAAGGGUGAAAAGGUGCGGUAAGAGCGCACCGCACGUCUGGUAACAGUUCGUGGCAAGGUAAACCCCACUCGGAGCAAGACCAAAUAGGGUUCCUAGGCGUGGCCCGCGCUGGAACCGGGUAGGUUGCUAAAGACGUCCAGUGAUGGCCGUCGUAGAGGAAUGACUGUUCUCGACAGAACCCGGCUUACAGAUCGACUCUCCAC,88,63,117,90,358
5328,0,CP000681.1/4300860-4300509,CGAGUUGGCCAGACAGUCGCCGCGUUCGUAAGAACGGGGAGGAAAGUCCGGGCUUCAAAGAGCGGGGUGCCAGGUAACGCCUGGGCGGUGUGAACCGACGACAAGUGCAACAGAGAGUAGACCGCCUGCCUGAUUUAUCAGGUCGGUAAGGGUGAAAGGGUGCGGUAAGAGCGCACCGUGCGGCUAGCAAUAGUCCGUAGCAAGGUAAACUCCACCCGAAGCAAGACCAAAUAGGGUUCCGUAUGGCGUGGCUCGCGUUGGAACCGGGUAGGUCGCUUGAGCCUGUGAGCGAUUGCAGGCCUAGAUGAAUGACUGUCCAAGACAGGACCCGGCUUAUCGGCCAACUCACCUC,86,61,118,87,352
5329,0,CP001339.1/815892-816249,GGAGUCGGCCGGACAGUCGCUGCGACCUUGUGUCGUGGAGGAAAGUCCGGGCUCCAUAGGGCAGGGUGCCAGGUAACGCCUGGGCGGCGCGAGCCGACGGAAAGUGCCACAGAAAACAUACCGCCGAUGGCUCGGACCCGUUCCGGGAUCAGGUAAGGGUGAAAAGGUGCGGUAAGAGCGCACCGCGCGGGUGGCAACACUUCGCGGCACGGUAAACCCCACCCGGAGCAAGGCCAAAUAGGGGUGCAUUGGUGUGGCCCGCACUGCACCCGGGUAGGCUGCUCGAGGCGCGCGGUGACGCGCGUCCCAGAUGAAUGACUGUCCCAGACAGAACCCGGCUUACAGGCCGACUCCCCAU,76,49,127,106,358
5330,0,CR954246.1/2675114-2674750,GAGUUAGCCAAGAUAAUCGCUGCCUGUGACGAAAAUGAUCAGGGGGAGGAAAGUCCGGGCUCCAUAGGGCAGAGUGCCAGUUAACGGCUGGGGGGCGCGAGCCCACGACAAGUGCAGCAGAGAGAAGACCGCCAAUCUUCGGAUUGGUAAGGGUGAAAGGGUGCGGUAAGAGCGCACCGGGCCGCUAGUAAUAGUCGGUUGCAAGGUAAACUCCACUCGGAGCAAGACCAAAUAGGGUUCCUUAUGGCGUGGCCCACGUUGGAACCGGGUAGGUUGCUUGAGCCAUAGAGCGAUUUAUGGCCUAGACGAAUGAUUAUCACUUUCUUCGGAAAGGACAGAACCCGGCUUAUACGGCUAACUCACUC,97,70,116,82,365
5331,0,CP000851.1/283404-283755,CGAGUUGGCUAGACAGUUGCCGCGUUCGCAAGAACGGGGAGGAAAGUCCGGGCUUCAAAGAGCAGGGUACCAGGUAACGCCUGGGCGGUGUGAACCGACGACAAGUGCAGCAGAGAGGAGACCGCCUUCUUGAUUUAUCAAGGAGGUAAGGGUGAAAGGGUGCGGUAAGAGCGCACCGUGCGGCUAGUAAUAGUUCGUAGCAAGGUAAACUCUACCCGAAGCAAGACCAAAUAGGGUCCCGUAUGGCGCUGCUCGCGUUGGGACCGGGUAGGUCGCUUGAGCCUGUGAGCGAUUGCAGGCCUAGAUGAAUAACUGUCCACGACAGGACCCGGCUUAUCGGCCAACUCACCUA,89,64,116,83,352
5332,0,CP001034.1/1292874-1293232,CAAGUAAGUCGGGUAGUCGCGAGGACAGUAAACUGUCUUCGAGGAAAGUCCGAGCUCCGUAGGGCAGGGUGCUGGGUAACACCCAGUGGGGGCGACCCCCAGGAAAGUGCCACAGAAACAAACCGCCAGGCUUCAAUCUGGUAAGGGUGAAAAGGUGCGGUAAGAGCGCACCAGCGGCCAGGUGACUGGUCGGCUAGGUAAACCCCACCCGGAGCAAGACCAAAUAGGGAAGGGAUGAAGUGGCCCGCUGACCUUCCGGGUUUGGUCGCUUGAGGUGUCAGGCGACUGGCACCCUAGAUAGAUGACUGCCACUCCCUCUAGGGGGAGGACAGAACUCGGCUUACAGACUUGCUUGUAAA,92,60,118,89,359
5333,0,CP000961.1/447682-448026,CGAGUUGGCUAGACAGUUGCUGCGUUCGCAAGAACGGGGAGGAAAGUCCGGGCUUCAUAGAGCAGGGUACCAGGUAACGCCUGGGCGGUGUGAACCGACGACAAGUGCAGCAGAGAGGAGACCGCCAAUCUUAGGAUUGGUAAGGGUGAAAGGGUGCGGUAAGAGCGCACCGGGCGGCUAGUAAUAGUCGUUGCAAGGUAAACUCUACCCGAAGCAAGACCAAAUAGGGUUCCAGACGGCGCGGCUCGCGUUGGAACCGGGUAGGUCGCUUGAGCCUGCGAGCGAUUGCAGGCCUAGAUGAAUAACUGUCCACGACAAGACCCGGCUUAUCGGCCAACUCACCUA,89,59,115,82,345
5334,0,CP000891.1/4952519-4952167,CGAGUUGGCCAGACAGUCGCCGCGUUCGCAAGAACGGGGAGGAAAGUCCGGGCUCCAAAGAGCGGGGUGCCAGGUAACGCCUGGGCGGUGCGAACCGACGACAAGUGCAACAGAGAGUAGACCGCCUGCCUGAUUUUAUCAGGUCGGUAAGGGUGAAAGGGUGCGGUAAGAGCGCACCGUGCGGCUAGCAAUAGUUCGUAGCAAGGUAAACUCCACCCGGAGCAAGACCAAAUAGGGUUCCGUAUGGCGUGGCUCGCGUUGGAACCGGGUAGGUCGCUUGAGCCUGUGAGCGAUUGCAGGCCUAGAUGAAUGACUGUCCAAGACAGGACCCGGCUUAUCGGCCAACUCACCUC,85,60,119,89,353
5335,0,CP000941.1/425084-425433,GAAGUCGGCUGGACAGUCGCGUCAUCCGAGAGGAUGCCGAGGAAAGUCCGGGCUCCAUAGGGCAAGGUGCCAGGUAACACCUGGGCGGCGUGAGUCGACGGAAAGUGCAACAGAAAGAUACCGCCAAUAUUCCUUUCUAGGAUUCGGUAAGGGUGAAAUGGUGCGGUAAGAGCGCACCGCGAGUUCGGUAACGGACCGGCACGGCAAACCCCACCUGGAGCAAGACCAAAUAGGGAUCCUAUGGUGUGGCUCGCGCUGGAUCCGGGUAGGUUGCUUGAGCACCGUGGUGACGCGGUGCCUAGAUGAAUGGCUGUUCAUGACAGAACCCGGCUUAUAGGCCGACUUCACCG,84,63,117,86,350
5336,0,CP000749.1/2967653-2967305,CAAGUUGGCUAGGCAGUCGCCGCUCAAUUUAUUGGGGGGAGGAAAGUCCGGGCUUCGCAGGGUAAAGUGCCAGGUAACGCCUGGGGGGCGUGAGCCUACGGAAAGUGCAGCAGAAAAUACACCGCCUAAGCAGUUUACUGCCGGUAAGGUUGAAAUGGUGCGGUAAGAGCGCACCGCGCGACUGGCAACAGUUCGUGGCUAGGUAAACCCCACUUGAAGCAAGACCAAAUAGGAACUCUUUGGCGUGACCCGCGCUGAGUUCGGGUAGGUUGCUAAAGACGUGCAGUGAUGUACGUAUUAGAUGAAUGACUGUCCACGACAGAACCCGGCUUAUCGGCCAACUUGCAAU,90,70,109,80,349
5337,0,AE008691.1/1699443-1699089,UGAGUAAGUCGGAUGGCCGCGGGCGAGGCAUUUGCCUCGCACGAGGAAAGUCCGAGCUCCACAGGGCAGGGUGCCGGGUAACACCCGGUGGAGGCGACUCCAAGGAAAGUGCCACAGAAAUGUAGACCGCCUGACGCUUUCAAAGGCGUCGGGUAAGGGUGCAACGGUGCGGUAAGAGCGCACCAGCAGCCGGGCGACCGGCUGGCUAGGUAAACCCCACCCGGAGCAAGGCAAAUAGGAGGGAGUAGGUGGCCCGCCAUUUCCCUCGGGUUAAGCCGCUAGAGGUAUCAGGCAACUGAUACCCUAGAUAGAUGGCCAUCUAAAACAGAACUCGGCUUACGGACUUGCUCACAUG,89,55,117,94,355
5338,0,CP000472.1/2154687-2155030,CGAGUUGGCUAGACAGUUGCCGCGUUCGUAAGAACGGGGAGGAAAGUCCGGGCUUCAAAGAGCAGGGUACCAGGUAACGCCUGGGCGGUGUGAACCGACGACAAGUGCAGCAGAGAGGAGACCGCCAACUUCGGUUGGUAAGGGUGAAAGGGUGCGGUAAGAGCGCACCGGGCGGCUAGUAAUAGUCCGUUGCAAGGUAAACUCUACCCGAAGCAAGACCAAAUAGGGUCCCGUAUGGCGCUGCUCGCGUUGGGACCGGGUAGGUCGCUUGAGCCUGUGAGCAAUUGCAGGCCUAGAUGAAUAACUGUCCACGACAGGACCCGGCUUAUCGGCCAACUCACCUA,86,60,115,83,344
5339,0,CP001336.1/4457100-4456711,AAAGUUAAUCAGAUGGUCGCGGAAGUAAGAACCGAAAGGUUGCUUCUGAGGAAAGUCCGGGCUCCAUAGGGCAAGGUGCUGGGUAACGCCCAGUGGGAGAAAUCCUAAGGACAGUGCAACAGAGAUAUACCGCCAAACAGCGGCCGGUCCGAUGACUGACUGAGCGUUUGGUAAGGGUGGAAAGGCGAGGUAAGAGCUCACCGGCAGCCUGGUGACAGGCUGGCCCUGCAAACCCCACUUGGAGCAAGACCGAAUAGGGAGACUAUAAAACGGCCCGUUUUUGUCUCCGGGUAAGGUCGCUUGAGGCCGUUGGUAACAACGGUCCCAGAUAGAUGAUCAUCACCUUCUGAAAGGAAGGAACAGAACCCGGCUUAUAGAUUGGCUUUGCAU,109,74,120,87,390
5340,0,CP000821.1/5221598-5221247,CGAGUUGGCCAGACAGUUGCCGCGUUCGCAAGAACGGGGAGGAAAGUCCGGGCUUCAUAGAGCAGGGUACCAGGUAACGCCUGGGCGGUGUGAACCGACGACAAGUGCAGCAGAGAGGAGACCGCCUGCUUGAUUUAUCAAGUAGGUAAGGGUGAAAGGGUGCGGUAAGAGCGCACCGUGCGGCUAGUAAUAGUCCGUAGCAAGGUAAACUCUACCCGAAGCAAGACCAAAUAGGGUUCCAUACGGCGCGGCUCGCGUUGGAACCGGGUAGGUCGCUUGAGCCUGUGAGCGAUUGCAGGCCUAGAUGAAUAACUGUCCACGACAAGACCCGGCUUAUCGGCUUACUCUUUGG,88,66,116,82,352
5341,0,AE004439.1/600938-601317,UGAGUUGGUCAGACAAUCGCUGGUUUAUUGAAGCCCUUAACCGUCUUUAUGACGACCUAGUGGGACAAAUAGACGAGAGGAAAGUCCGAGCUACACAGGGCAGAGUGCCAGGUAACGCCUGGGAGGCGCGAGCCUACGACAAGUGCAACAGAGAGCAGACCGCCAGUUUCGGCUGGUAAGGGUGAAAGGGUGCGGUAAGAGCGCACCGCAUGGCUGGCAACAGUACAUGGCAGGGUAAACUCCACUCGUAGCAAGACCAAAUAGGAAUCCAAUGAGUGGCCCGCUCAGGAUUCGGGUAGGUUGCUUGAGCGUAUGUGCGAAUGUACGCCUAGAGGAAUGAUUGUCCGCGACAGAACUCGGCUUAUCGACCAACUCAGUAC,104,72,117,87,380
5342,0,CP000447.1/420344-420697,CGAGUUGGCCAGACAGUUGCCGCGUACGCAAGUACGGGGAGGAAAGUCCGGGCUUCAAAGAGCGGGGUACCAGGUAACGCCUGGGCGGUGUGAACCGACGACAAGUGCAACAGAGAGGAAACCGCCAUUUUGGCCUAGGCUAAGAUGGUAAGGGUGAAAGGGUGCGGUAAGAGCGCACCGUGCGGCUAGUAAUAGUCCGUAGCAAGGUAAACUCUACCCGAAGCAAGACCAAAUAGGGUUCCGCAUGGCGCUGCUCGCGUUGGAACCGGGUAGGUUGCUUGAGCCUGUGAGCGAUUGCAGGCCUAGAUGAAUAACUGUCCACGACAGGACCCGGCUUAUCGGCCAACUCACCUC,90,62,116,86,354
5343,0,CP001393.1/1102031-1102382,CGAGCAGGUCGAACGGCUGCGCAAGGGAAUAACCCUUGUGAGGAAAGUCCGAGCUCCACAGGGCAGGGUGCUGGGUAACACCCAGUGGAGGCGACUCCAAGGAAAGUGCAACAGAAAAGAACCGCCGUCCAUUUUUGCAUGGAUGGUAAGGGUGAAAAGGUGAGGUAAGAGCUCACCAGCAGUCAGGCGACUGACUGGCUGUGCAAACCCCACCCGGAGCAAGACCAAAUAGGGGAACAAUGCAGUGGCCCGCUGCGUUCCCGGGUUGGUCGCAAGAGGUCUGAUGGCAACGUCAGACCCAAAGAGAAAUAGCCGUUCUCGACAGAACUCGGCUUACAGACCUGGUCGCACA,99,54,110,89,352
5344,0,CU468230.2/2376950-2376596,GAAGUGAGCCGGAUGGUCGCUGCUGUGGAGGUCUCCGUGACUGAAGCAGGAGAGGAAAGUCCGGGCUUCAUAGGGCAGGGUGCCAGGUAACGCCUGGGCGGUGAAAGCCGACGGAAAGUGCAGCAGAGAGUAGACCGCCUCAUUCGUGAGGUAAGGGUGAAAGGGUGCGGUAAGAGCGCACCGCGUGUCUGGGAACAGUUCACGGCAUGGCAAACCCCACCAGAAGCAAGACCAAAUAGGAAUCCUAGGUGCGGCCCGUACUGGAUUCGGGUAGGUCGCUUGAGCGUAUGAGUGAUUGUACGCCUAGAGGAAUGACCAUCCUCGACAGAACCCGGCUUAUAGGCUCACUUCACCU,88,63,121,83,355
5345,0,BX571872.1/169334-168958,GGAGUUGACUAGACAGUCGCUGCUUUAUCAUUAAUCCUUUGGAUGAUAGAUGGAGGAGAGGAAAGUCCGGGCUCCACAGGGCAGGGUGCCAGAUAACGUCUGGGGGGUGAAAGCCCACGACCAGUGCAACAGAGAGCAAACCGCCGAUGGCUUACUUAAUGUAGGAUCAGGUAAGGGUGAAAGGGUGCGGUAAGAGCGCACCGCACGGCUGGUAACAGUUCGUGGCACGGUAAACUCCACUCGGAGCAAGGCCAAAUAGGGGUUCAUUAGGUACGGCCCGUAUCGAACCCGGGUAGGCUGCUUGAGCCAGUGCGUAAGUGCUGGCCUAGAUGAAUGAUUGUCCACGACAGAACCCGGCUUAUCGGUCAACUUCACAA,99,74,119,85,377
5346,0,BX950851.1/373518-373896,GGAGUUGACCAGACAGUCGCCGCUUCACUGCCGUCCCUUUCGGGGGAGACAGGUGGAGGGGAGGAAAGUCCGGGCUCCAUAGGGCAGGGUGCCAGGUAACGCCUGGGAGGCGCAAGCCUACGACUAGUGCAACAGAGAGCAAACCGCCGAUGGCCCACGCAAGUGGGAUCAGGUAAGGGUGAAAGGGUGCGGUAAGAGCGCACCGCGCGACUGGCAACAGUUCGUGGCACGGUAAACUCCACCCGGAGCAAGGCCAAAUAGGGGUUCACAUGGUACGGCCCGUACUGAACCCGGGUAGGCUGCUUGAGCCAGUGAGUGAUUGCUGGCCUAGAUGAAUGACUGUCCACGACAGAACCCGGCUUAACGGUCAACUCCCUUC,90,60,128,101,379
5347,0,AM260525.1/1710521-1710131,UCAGUCGGCUGGGCAGCCGCGCUUGUCCAAUGCUGAAAAGCGGCAGGUGAGGAAAGUCCGGGCUCCAUGGAAAGACGGUGCCGGGUAACACCCGGCGGGGGUGACCCUAGGGAAAGUGCCACAGAAAGCAAACCGCCUAUUUUUAUAGGUAAGGGUGAAAGGGUGGAGUAAGAGCCCACCGCACAUUCAGUAAUGAAUGUGGCAAGGUAAACCCCACCGGGAGCAAGACCAAAUAGAAAUGACGUGCAAGAUUUAAUUUGCAGCCAAUUUCCGGGCGAGUCAUUCGGGUAGGUUGCACGAGGCGGGUGGUAACAUCCGUCCCAGAUGAAUGGUUGCCAUGUAAAGUACAAGCUUUACACUACAGAACCCGGCUUAUAGGCCGACUGAUAUU,110,75,118,88,391
5348,0,CP001616.1/482441-482821,GGGGUUGGCCGGGCAGUCGCCGUCUUGUUGUUGUGCCUUCGGGUAGACAAACAGGAGGGAGGAAAGUCCGGGCUCCACAGGGCAGGGUGCCAGGUAACGCCUGGGAGGCGUAAGCCUACGACCAGUGCAACAGAGAGCAAACCGCCGAUGGCCCGCAAGGGAUCAGGUAAGGGUGAAAGGGUGCGGUAAGAGCGCACCGCGCGACUGGCAACAGUUCGUGGCACGGUAAACUCCACCCGGAGCAAGACCAAAUAGGCUUCCAUGUCGCGGCCCGCGUCGGAAGCGGGUAGGUUGCUUGAGCCUGCGAGCGAUUUCAGGCCUAGAGGAAUGGCUGCCACCGCGCAAGCGGAACAGAACCCGGCUUACAGGCCAACCCCACUA,89,55,133,104,381
5349,0,CU468135.1/3254372-3253993,GAAGCUGACCAGACAGUCGCCGCUUUGUUGCCGUCCUCCUUCGGGGGAGACAGACAGAGGGGAGGAAAGUCCGGGCUCCAUAGGGCAGGGUGCCAGGUAACGCCUGGGGGGCGCAAGCCCACGACCAGUGCAACAGAGAGCAAACCGCCGAUGGCCUACGCAAGUAGGAUCAGGUAAGGGUGAAAGGGUGCGGUAAGAGCGCACCGCGCGGCUGGCAACAGUUCGUGGCACGGUAAACUCCACCCGGAGCAAGGCCAAAUAGGGGUUCACCAGGUACGGCCCGUACUGAACCCGGGUAGGCUGCUUGAGCCAGUGAGCGAUUGCUGGCCUAGAUGAAUGACUGUCCACGACAGAACCCGGCUUACCGGUCAGCUUCACAC,91,56,128,105,380
5350,0,AP008232.1/411371-411749,GGAGUUGACCAGACAGUCGCCGCUUCACCAUCGUCCCCGCAAGGGGAAACAGGUGGGGGGGAGGAAAGUCCGGGCUCCAUAGGGCAGGGUGCCAGGUAACGCCUGGGGGGUGCAAACCCACGACAAGUGCAACAGAGAGCAAACCGCCGAUGGCCCGCGCACGCGGGAUCAGGUAAGGGUGAAAGGGUGCGGUAAGAGCGCACCGCGCGGCUGGUAACAGUUCGCGGCACGGUAAACUCCACCCGGAGCAAGGCCAAAUAGGGGUUCACAUGGUACGGCCCGUACUGAACCCGGGUAGGCUGCUUGAGCCAGCGCGUGAGCGCUGGCCUAGAUGAAUGACUGUCCACGACAGAACCCGGCUUAACGGUCAACUCCACUC,91,51,130,107,379
5351,0,CP000783.1/3478414-3478038,GAAGCUGACCAGACAGUCGCCGCUUCGUCGUCGUCCUUUCGGGGAGACGGACGGAGGGGAGGAAAGUCCGGGCUCCAUAGGGCAGGGUGCCAGGUAACGCCUGGGGGGCGCAAGCCUACGACCAGUGCAACAGAGAGCAAACCGCCGAUGGCCCACGCAAGUGGGAUCAGGUAAGGGUGAAAGGGUGCGGUAAGAGCGCACCGCGCGUCUGGCAACAGUUCGCGGCACGGUAAACUCCACCCGGAGCAAGGCCAAAUAGGGGUUCACAAGGUACGGCCCGUACUGAACCCGGGUAGGCUGCUUGAGCCAGUGAGCGAUUGCUGGCCUAGAUGAAUGACUGUCCACGACAGAACCCGGCUUACCGGUCAGCUUCACAC,89,55,129,104,377
5352,0,CR378673.1/179764-179382,GGAGUUGGUCAGGCGAUCGCUGCUUCGUUGAUGUCCUUAGGGAGACUGACGGAGGGGAGGAAAGUCCGGGCUCCAAAGGGCAGGGUGCCAGAUAACGUCUGGGGGGCGCGAGCCCACGACAAGUGCAGCAGAGAGUAUACCGCCGAUGACUCGCUUGCGAGAACAGGUAAGGGUGAAAGGGUGCGGUAAGAGCGCACCGCGCGGCUAGUAAUAGUUCGUGGCAUGGUAAACUCCACCCGGAGCAAGACCAAAUAGGUCCCUAAUGGCGCGGCCCGCGUUGGGGACGGGUAGGUUGCUUGAGCCUGUGAGCGAUUGCAGGCCUAGAGGAAUGGUUGCCACUGCGAAAGCAGCUACAAAACCCGGCUUAUAGACCAACUCCACCU,92,66,133,92,383
5353,0,AE016827.1/976620-977008,CGAGUUGGUCAGACAAUCGCUGGUUUAUUGAAGCCCUUAACCGUAGUAAUACGACCUAGCGGGACAAGUAAACGAGAGGAAAGUCCGAGCUACAUAGGGCAGAGUGCCAGAUAACGUCUGGGAGGCGUGAGCCUACGACAAGUGCAGCAGAGAGCAAACCGCCGAUGGCUCGCAAGAGAUCAGGUAAGGGUGAAAGGGUGCGGUAAGAGCGCACCGCAUGGCUGGUAACAGUACAUGGCAGGGUAAACUCCACUCGUAGCAAGACCAAAUAGGAACUCAAUGGGUGUGCCCGCCCAGAGUUCGGGUAGGUUGCUUGAGCGUAUGUGCGAAUAUACGCCUAGAGGAAUGAUUGUCCGCGACAGAACUCGGCUUAUCGACCAACUCAAUCU,112,72,118,87,389
5354,0,CP001145.1/493991-493612,AAGAGUAGACGAGGCAGCCGCAACCAAAAGGUUGAGGAAAGUCCGAGCUCCACAGAGCAGGAUGCUGGGUAACACCCAGUGAGGGCGACCUCAAGGAGAGUGCCACAGAAAACAAACCGCCUACCCAAAUGUUUGGGUAGGUAAGGGUGAAAAGGCGGGGUAAGAGCCCACCGCAGCACUGGCGACAGUGCUGGCACGGUAAACCCCAUCCGGAGCAAGGCCAAGCAGCCAGCUGUGACCCUGCUCGGCGAGCUGGCGGGUAGGCCGCUGGAGCUUGCUGGCAACAGCAAGCCAAGAUAAAUGGUUGCCACCCACCAAAACUUUUGAAGGCAACGCGGUUUUGGUGGGAACAGAACUCGGCUUACCGUCUACUCGUAGUU,106,57,118,99,380
5355,0,AM236080.1/3479602-3479205,CCAGUUGGCUGGGCAGCCGCGCUUUACCAAUGCCGAAAGGCGGUAGGGUGAGGAAAGUCCGGGCUCCACGGAAACACGGUGCCGGAUAACGUCCGGCGAGGGCGACCUCAGGGAAAGUGCCACAGAAAGCAAACCGCCUGUCAUGACAGGUAAGGGUGAAAGGGUGGGGUAAGAGCCCACCGCAUCUCCGGCAACGGAAAUGGCACGGUAAACCCCACCGGGAGCAAGACCGAAUAGGGAUGACGCGGUAGGCCGAAAGGCCUUCCGGCUGGUUUCCAGGCCAGUCAUCCGGGUGGGUUGCGUGAGGCAGCGUGCGAACGCUGUCCCAGAGGAAUGGCUGCCACGUUCCGGUUCACGCCGGAGCCAUACAGAACCCGGCUUACAGGCCAACUGGCGAU,95,56,137,110,398
5356,0,CP000698.1/4631397-4631021,CGAAGUAGACCAGAUGGCCGCCGCCCGCAAGGGGGGAGGAAAGUCCGGGCUCCAUAGGGCAUGGCGCUGGAUAACAUCCAGCGGGGGUGACCCCAGGGAAAGUGCCACAGAGAGAAGUCCGCCUGCCGGAGCUUUGCGAAGGCAGGUAAGGGUGAAAGGGUGAGGUAAGAGCUCACCGGGUCCGGCGGUGACGUCGGAUGCCAGGUAAACCCCGCCAGGAGCAAGACCAAAUAGGGAAGCGUUAAGGACGGCCCGUCCGUGCUUCCGGGUUGGUUGCUUGAGGCCGUCGGUAACGACGGUCCUAGAUGAAUGGCCAUCGCCCGCGGUCGGGAAACUUGCAGCGGGAACAGGACCCGGCUUAUGGGCUGCUUCGGCCA,84,55,140,98,377
5357,0,CP000910.1/2951051-2950681,UGGGGCAACUGGGCGAUCGCGUGUUGUGCAAACAACCCGAGGAACGUCCGGGCUCCGAAGAGCACAGUGGUGGGUAACACCCACUCGGGGUAACCCGCAGGCCAGUGCCACAGAAAAUAGACCGCCUCUGCAUGCAGAGGUAAGGGUGAAACGGCGGUGUAAGAGACCACCGCUUUCCGGGUGACCGGAAAGGCUAAGGUAAACCCCACUGGGAGCAAGGCCAGACAGGGCACGUUUGAGGGCUGCUCGCCCGAGUGUCCGGGUAGGCUGCUAGAGGGCGUCGGCAACGGCGUCCGUAGAUGGAUGAUCGUCGCUUCUAUGCUGGUAACGGCGUAGUAAGACAGAACCCGGCGUACAGGUUGCCCCAUCCG,86,59,127,99,371
5358,0,CP000082.1/408052-408419,UUGGUAGACUAGGCAAUCGCCGCUGCACACUGGCAACAGAUUGAGCAGGGGAGGAAAGUCCGGGCUACAUAGGGCAGCGUGCCAGCUAACGGCUGGGCAGGGUAACUUGACGACCAGUGCAGCAGAGAGUAGACCGCCUUUGUUAUCGCAAGAUAUCAUCGGUAAGGGUGAAAGGGUGCGGUAAGAGCGCACCGCGUGGCUGGCAACAGUUCACGGCAUGGUAAACUCCACGCGUAGCAAGACCAAAUAGGCAUCGGCAUGGCGCGGCCCGCGUUCGAUGCGGGUAGGUUGCUUGAGCGUACGAGCGAUUGUGCGCCUAGAGGAAUGAUUGUCCACGACAGAACCCGGCUUAUCGGUUUACCAACCUU,90,69,120,89,368
5359,0,CP001197.1/295568-295205,GGAGCCGGACGGGCUGUCGUCGCGGGCCGCAAGGCCCGGGGAGGAAAGUCCGGGCUCCGCAGGGCAGGACGCUGGGUAACCCCCAGGACGAGCGAUCGUCGGACAGGGCCACAGAAAACAGACCGCCCGGCAGGUUCGCCUGCCGGGUAAGGGUGAAACGGUGGGGUAAGAGCCCACCAGCUGGCGCGGUGACGCACCAGGCUCGGUAACCCCCGUCCGGAGCAAGACCAAAUAGGGAAGCGUACGAGGCCUGCCCGGCCCAUGCUUCCGGGUCGGUUGCUUGAGGGCGUCGGUAACGGCGCUCCUAGAGGAAUGACAGCCACCCGCAAGGGUACAGAACCCGGCUUACAGUCCGACUCCCGAA,77,42,132,113,364
5360,0,CP000633.1/2425356-2424957,CCAGUCGGCCGGGCAGCCGCGCUUUACCAAUGCCGAAAGGCGGUAGGGUGAGGAAAGUCCGGGCUCCACGGAAACACGGUGCCGGAUAACGUCCGGCGAGGGCGACCUCAGGGAAAGUGCCACAGAAAGCAGACCGCCCCGUUUAUCGGGGUAAGGGUGAAAGGGUGGGGUAAGAGCCCACCGCGUCGCUGGUGACAGGGACGGCAUGGUAAACCCCACCGGGAGCAAGACCGAAUAGGGAUGACGCGGGUGCAACGCAAGUUGCGCUACAGCCGGUUUUCGGGCCAGUCAUCCGGGUGGGUUGCGAGAGGCGGUGCGCAAGUAUCGUCCCAGAUGAAUGGCUGCCACGUUCCGGGAAACCGGGGCCAUACAGAACCCGGCUUACAGGCCGACUGGUAUU,91,58,144,107,400
5361,0,CP000628.1/2390520-2390121,CCAGUUGGCCGGGCAGCCGCGCUUUACCAAUGCCGAAAGGCGGUAGGGGGAGGAAAGUCCGGGCUCCACGGAAACACGGUGCCGGAUAACGUCCGGCGAGGGCGACCUCAGGGAAAGUGCCACAGAAAGCAAACCGCCUGAUCCUUGGAUCGGGUAAGGGUGAAAGGGUGGGGUAAGAGCCCACCGCGUCUCUGGCGACAGCGACGGCACGGUAAACCCCACCGGGAGCAAAACCGAAUAGGGAUGACGCGGAGCGCGAAAGCGCUCCAGCCCGUUUCCGGGCCGGUCAUCCGGGUGGGUUGCAUGAGGCGGCGCGCAAGCGUCGUCCCAGAUGAAUGGCUGCCACGUUCCGGCCUCGGCCGGAGCCAUACAGAACCCGGCUUACAGGCCAACUGGCAAA,92,51,140,117,400
5362,0,AB047586.1/419-800,GGAGCUGACUGGGUAGUCGCUGCUUUGUUGAUGUCCUUCGGGAGACUGACAAAGGGGAGGAAAGUCCGGGCUUCAUAGAGCAAGGUGCCAGGUAACGCCUGGGGGGCGCAAGCCUACGACAAGUGCAGCAGAGAGAAGACCGCCGAUGGCCCGUAAGGGUACAGGUAAGGGUGAAAGGGUGCGGUAAGAGCGCACCGGACGACUAGCAAUAGUUCGUAGCAGGGUAAACUCCACCUGAAGCAAGACCAAAUAGGCCUCCACAUUGCGUUGCUCGCGUAAGGAGGCGGGUAGGUUGCUCGAGCCAGUGAGUGAUUGCUGGCCUAGACGAAUGGCUACCGCCGCGCAAGCGGAACAGAACCCGGCUUAUGUGUCGGCUCCACCU,94,66,131,91,382
5363,0,CP000148.1/443714-444093,CGAAGCAGAACAGAUGACCGCUCUCCGUUCGCGGAGGGAGGAAAGUCCGGGCUCCACAGGGCAUGGUGCUGGAUAACGUCCAGCGGGGGCGACCCCAGGGAUAGUGCCACAGAGAGAAGUCCGCCUGCCGGAGCGUUAGCGAAGGCGGGUAAGGGUGAAAGGGUGAGGUAAGAGCUCACCGGGUCCGGCGGUGACGUCGGAUGCCAGGUAAACCCCACCAGGAGCAAGGCCGAAUAGGGAAGCGUUAAGGACGGCCCGUCCGAGCUUCCGGGUUGGCUGCUUGAGGCCGUCGGUAACGGCGGUCCCAGAGGAAUGGUCAUCGCCCGCCAAGGGGUAACCCGCGGCGGGAACAGAACCCGGCUUAUGGGCUGCUUCGGCCA,83,52,143,102,380
5364,0,CP001056.1/940440-940784,CGAGCAAAACGUGCAAUCGCUGCUGGGCUUGACCCAGGAGAGGAAAGUCGGGGCUCCAUAGGGCAGGGUGCUGGAUAACGUCCAGUCAAGGCGACUUGAAGGAUAGUGCAACAGAGAUAUACCGCCUAAGUUUACUUAGGUAAGGGUGGAAAGGCGAGGUAAGAGCUCACCAGCGUGAUGGUGACAUCACGGCUAUGUAAACCCCACUUGGAGCAAGACCGAAUAGAGAGGCAUUAAGGGAUUGCCCGUCCCGCCUCCGGGUGCGUCGCUUGAGCUCAUUGGCAACAAUGAGCCUAGAUAGAUGAUUGCUUAAUACAGAACCCCGCUUACGGCUUGUCUCGCAUA,93,69,103,80,345
5365,0,CP001341.1/2464077-2463692,UGGGACAGCCAGGCGGCCGCGCGUCACGAAAGUGGCUCGAGGAACGUCCGGGCUCCACAGGGCAGGGUGGUGGGUAACGCCCACUCGGGGUAACCCGCAGGCAAGUGCCACAGAGAAUAGACCGCCUGCGUUUUCCGUUUUCGGAAAGCGGCAGGUAAGGGUGAAACGGUGGUGUAAGAGACCACCAGCUUCCCGGGUGACCGGGAAGGCUAGGUAAACCCCACCCGGAGCAAGGCCAGACAGGGCACGUUUGAGGGCUGCCCGCCCGAGUGUCCGGGUAGGCCGCUAGAGGGUGCCGGCAACGGUACCCGUAGAUGGAUGGCCGUCGCCCCCGUGACGGCAACGGCACGGGGGAACAGAACCCGGCGUAUCGGUUGUCCCAUCCG,80,53,141,112,386
5366,0,CP000488.1/840996-840654,GAAGUUGGUCGGAUGGUCGCUGGAGCUUGAUUCUUCAGAGGAAAGUCCGGGCUCCAUAGAGUAAAGUGCUAGCUAACAGCUAGGUAUGGUGACAUAACGGAAAGUGCUACAGAGAUUUAGACCGCCUAUUUUUAAUAGGUAAGGGUGAGAAGGCGCGGUAAGAGCGCACCGCGCGAUUGGUGACAACCGUGGCAAGGUAAACCCCACUUGGAGCAAGCUCAAAUAGGCUGAUGAUGACGUUGCUCGCUGAGUUGGUGGGUAGAGUGCUAAAGCGUUUUGGCAACAAAACACGUAGAUGAAUGACCAUCUAUUACAGAACCCGGCUUAUAGACCGACUUCUUUU,96,81,100,66,343
5367,0,AM494475.1/1549288-1548904,GUUGAUAGCUGUAUGGCUACACAAAAUUUAUAGAUUUGUGAGGAAAGUCCGAGCUCCAUAAAAGCAUAGUGCUGGGUAACGCCCAGCAGAAGUAAUUCUAGGGAAAGUACCACAGAGAAUAUACCGCCAAAUAAAUUAAUUUGGUAAGGGUGAAAAGGUGAGGUAAGAGCUUACCGGUAGUUUAGUAAUAAAUUACGCAUGGUAAACCCCACUAGGAGCAAGACCAAAUAGAAGCAACAUAACUAAUAAGUUAGAAGGCGUUUUUAUCUAGUUGCUUGGGUAGGUCGCUUGAGGUAAAUAGUAAUAUUUACCCCAGAUAAAUAGCCGUAAUUAAUAUAUUAAUUAAUAUAUUUUACAGAACUCGGCUUAUAGGCUAUCAAUACAA,141,104,82,58,385
5368,0,CP000113.1/7099786-7100181,GGAGCGGCCCGGGUGAACGCCGGUCACCGCAGUCAUGGGUGGCGGGAGGAAAGUCCGAGCUCCAGAGGGCAGGGUGCUGGCUAACGGCCAGUCGAGGCGACUCGCAGGAAAGUGCCACAGAAAACAGACCGCCCGUUCCGAAAGGGGCGGGUAAGGGUGAAACGGUGCGGUAAGAGCGCACCGCGUCCGGGGUGACUCGGACGGCUCGGUAAACCCCACCUGGAGCAAGAGCCAAUAGGAGCGCGUCCUCGCCGUACGGAGGACAGGGAUGGCCCGUCCCAUGCGUUCGGGUUGCUCGCUGAUGAGGCCCCUGGGCAACCAGGGCCCUAGAUGAAUGUUCACCGCCCAUCCCGAAAGGGGUGGGAACAGAACUCGGCUUACACGGCCGCUCCGGCG,84,51,146,115,396
5369,0,CP001016.1/2691085-2690677,CCAGUCGGCCGGAUGGCCACCGCUCAGGCGGAGGAAAGUCCGGGCUCCAUGGAAACACGGUGCCGGAUAAUGUCCGGCGAGGGUGACCUCAGGGAAAGCGCCACAGAAAGGAAACCGCCUCGCAACCGAGCCGAAAGGCGAGGACCGCGGAGGUAAGGGUGAAAGGGUGCGGCAAGAGCGCACCGCGCUUAUGGUGACAUGAGCGGCACGGCAAGCCCCACCGGGAGCAAGACCGAAUAGGGGCGACAGGCAGCGAACCCAUUCGAUGGGACGCUCAAAUCCGUUUCCAGAUUGUCGCCCGGGUUGGUUGCUCGAGGCGGCUGGCAACAGCCGUCCUAGAGGAAUGGUCAUCACGCAAGCGGUUUCGCCGCUUGCCUUACAGAACCCGGCUUACAGGCCGACUGGUAUU,96,57,140,116,409
5370,0,AP009384.1/5180043-5180420,CCAGCCGGCCGGGCGGCCGCGGUGCCUUGUGCAUCGAGGAAAGUCCGGGCUCCACGGAGACACGGUGCCGGAUAACGUCCGGCGGGGGCGACCCUAGGGAAAGUGCCACAGAAAUCAGACCGCCCGCGCGUGCGCGGGUAAGGGUGAAACGGUGGGGUAAGAGCCCACCGCGCGACCGGCAACGGAAGCGGCACGGCAAACCCCACCGGGAGCAAGGUCGAAUAGGGACGGCACGGGCGCGCAAGCGCCCAAUCCGGUCUUCGGAUCGUCGUCCGGGUUGACUGCCAGAGGCGCCGGGUAACCGGCGUCCCAGAGGAAUGGCCGCCACGUGGGAGAAAUCCCGCCAUACAGAACCCGGCUUACAGGCCGGCUGGUGCU,78,41,140,119,378
5371,0,CP001189.1/3484775-3484361,CCAGAUGGUCGGGCGGCCGCUGUCGCGUGGAUUUCCCACGCGGUGGAGGAAAGUCCGGGCUCCACGGAGGAACGGUGCCGGCUAACGGCCGGCGGGGGUGACCCCAGGGAAAGUGCCACAGAAAACAGACCGCCCCCACGGCAUUCCGGUUCGCCGGAGAUGGUGCGGGUAAGGGUGAAACGGUGCGGUAAGAGCGCACCGCGCGUGCGGUAACGCAGGCGGCAGGGCAAACCCCACCGGGAGCAAGACCGAAUAGGAACGGCAGACGGACCGCCUCGCGCGGGGUCGUCGGGGGUCCCUCCGCCCCGUCGUUCGGGUUGGUCGCGUGAGGCGCGCCGCAAGGCGCGUCCCAGAGGAAUGGUCGCCCCCCUUCAUCGAAGGUGGACAGAACCCGGCUUACAGACCAUCUGGCCGU,78,52,156,129,415
5372,0,CP000482.1/3637855-3637487,UGAAGCAGGACAGACGGCCGCCGCCGAGGUAUCGGGGGAGGAAAGUCCGGGCUCCACAGGGCGCGAUGCUGGAUAACGUCCAGCGGGGGUGACCCCAGGGAAAGUGCCACAGAGAGAAGUCCGCCUGCCACGCGCAGGUAAGGGUGAAAGGGUGAGGUAAGAGCUCACCGGGUCCAUCGGUGACGGUGGAUGCCAGGUAAACCCCAUCGGGAGCAAGACCUAAUAGGGGGGCGUCAAGGGUGGCCCGCCCGUGCCUCCGGGUUGGUUGCUUGAGGCUGCCGGUAACGGCAGACCCAGAUGAAUGGCCGUCGCCCGGGAAGGGGUAACCCGACCCGGGAACAGAACCCGGCUUACGGACUGCUUCAGCCA,82,48,138,101,369
5373,0,AB047591.1/293-732,GGAGUUGACUGGGUAGUCGCUGCUUUGUUGAUGUCCUUCGGGAGACUGACGCUGAAGUCCUUUGGGAGACUGGCGUUGACGUCCUUCGGGAGACUGACAAAGGGGAGGAAAGUCCGGGCUCCAUAGAGCAGGGUGCCAGGUAACGCCUGGGGGGCGCAAGCCCACGACAAGUGCAGCAGAGAGAAGACCGCCGAUGGCCUCAUUUCUUCGGAAGGGGCACAGGUAAGGGUGAAAGGGUGCGGUAAGAGCGCACCGGACGGCUAGCAAUAGUCCGUUGCAGGGUAAACUCCACCCGGAGCAAGACCAAAUAGGCCUCCACAUUGCGUUGCUCGCGUAAGGAGGCGGGUAGGUUGCUUGAGCCAGUGAGCGAUUGCUGGCCUAGACGAAUGGCUACUACCGCGCAAGCGGAACAGAACCCGGCUUAUAUGUCGACUCCACCU,102,81,150,107,440
5374,0,CP001196.1/1207538-1207114,UCAGUCGGCCGGACGGCCGCUCUUGCAGGAUCGAAAGGUCGCAAGGGAGGAAAGUCCGGGCUCCAUCGACAUACGGUGCCGGAUAACAUCCGGCGAAGGCGACUUCAGGGAAAGUGCCACAGAGAACGAACCGCCACGCCCCCGCAAGGGUGGCUCGGUAAGGGUGAAAAGGUGCGGUAAGAGCGCACCGCGUCUCCGGCAACGGAGGCGGCAUGGCAAACCCCACCGGGAGCAAAACCGAAUAGGGACGGCACAGCGGAAAGUUCGUCUUCGGACGAUAACCCCGCGGGGUCAUGUCGGACCCGCCGUCCGGGUAGGUUGCUUGAGGCGCGCAGCAAUCCGCGUCCCAGAGGAAUGGCCGUCACGUCUGCAUGGUGCGAACCGUGCAGGCCCUCCAGAACCCGGCUUACAGGCUGGCUGACAUC,97,57,144,127,425
5375,0,CP001280.1/3899599-3899981,CCAGUCGGCCGGAUGGCCGCCGCCUCAGGGCGGAGGAAAGUCCGGGCUCCACAGAGAAACGGUGCCGGAUAACGUCCGGCGGGGGCGACCCUAGGGAAAGCGCCACAGAAAACAGACCGCCAUCCGGCUUGCGCCGGAGGUAAGGGUGAAACGGUGCGGUAAGAGCGCACCGCGCGCAUGGCGACAUGAGCGGCACGGCAAGCCCCACCGGGAGCAAAACCGAAUAGGGGCGACGCGGGGCGCAGGCCCCAGAUCCUUCUCUGGAUCGUCGCCCGGGUUGGUUGCUCGAGGCGGCCGGUAACGGCCGUCCCAGAGGAAUGGCCAUCGCGCGCCGCGGACUCCGCGGCGCCUUACAGAACCCGGCUUAAAGGCCGGCUGGCGCC,77,41,141,124,383
5376,0,CP001087.1/3336133-3335754,CGGACCAGACUAGGCGAUCGCGGGAUCGAAAGAUUUCGAGGAAAGUCCGAACACCGCAGGGCAGGACGCUCCAUAACGUGGAGUCGCAGCAAUGUGAAGGAAAGUGCAGCAGAGAAUAGACCGCCGGGCACCCCUUGGGGUGCCCGGUAAGGGUGAAACGGUGCGGUAAGAGCGCACCAGUUUUCCAGGUGACUGGAAAAGCUUGGUAAACCCCGUCCGGUGCAAGACCAAAUAGAGAAGCGUUUGAGGGUUGCCCGCCUGAGCUUCCGGGUAGGUUGCUUGAGGUGCACGGCAACGUGCAUCCUAGAUGAAUGAUCGCUGCCCCGGCAUCGGGUAACCGUGCAGGGGUACAGGAUUCGGCUUACUGGCUGAUCUGGCCG,91,67,129,93,380
5377,0,CP000250.1/2253459-2253028,UCAGUCGGCCGGACGGCCGCUCCCGCACCGGCCGAAAGGCUGCGGGGGAGGAAAGUCCGGGCUCCAUCGACAUACGGUGCCGGAUAACGUCCGGCGGGGGCGACCCCAGGGAAAGUGCCACAGAGACCGAACCGCCCCGCGAAGCCGCAAGGCGAAGCGGGGUAAGGGUGAAAAGGUGCGGUAAGAGCGCACCGCGUCUCCGGCAACGGAGACGGCAUGGUAAACCCCACCGGGAGCAAAACCGAAUAGGGACGGCAUCGCGGACAGUUCGCUCUCGGGCGAUAACUCCGCAGGGUGAUGUCAAACCCGCCGUCCGGGUAGGUUGCUCGAGGCGCUGUGCAAACAGCGUCCCAGAGGAAUGGCCGUCGCGUAUCGCUCCGCCUCACGGCGAGCGGUGCCCUCCAGAACCCGGCUUACAGGCCGACUGAUACU,94,52,150,136,432
5378,0,CP000860.1/536580-536991,CGAGUAAACCAGGUGAUCGCGGGUACCGUUUGGUAUUCGAGGAAAGUCCGAGCUCCGCAGGGCAGGGUGCUGGGUAACUCCCAGUGGGGGCGACCCCAAGGAAAGUGCCACAGAAAUGUGUACCGCCGUGCGUCGGAGCCGGUCGCCGGAGGUCUGGAAUCGGCAAGCCUUCCGAGACGGACUUCCUGAGACCGGCGGCCGGUACGGUAAGGGUGGAACGGUGCGGUAAGAGCGCACCAGCGGUCAGGUGACUGGCCGGCUAGGUAAACCCCACCCGGAGCAAGACCAAAUAGGGGAACAAUGGAGCGGCCCGCUCCGUUCCCGGGUUAGGUCGCUAGAGGCGUCCGGGCAACCGGCGUCCCAGAUAGAUGAUCAUCCACGACAGAACUCGGCUUACAGGUUUACUCGCCCG,90,64,143,115,412
5379,0,CP000463.1/2310384-2309954,UCAGUCGGCCGGACGGCCGCUCCCGCUAUGGUCGAAAGGCUGCGGGGGAGGAAAGUCCGGGCUCCAUCGACAUACGGUGCCGGAUAACGUCCGGCGGGGGCGACCCUAGGGAAAGUGCCACAGAGAACGAACCGCCCCGCAAAGCCGCAAGGCGAAGCGAGGUAAGGGUGAAAAGGUGCGGUAAGAGCGCACCGCGUCGCCGGCAACGGCGAUGGCAUGGUAAACCCCACCGGGAGCAAAACCGAAUAGGGACGGCAUCGCGGACAGUUCGCUUUCGGGCGAUAACUCCGCAGGGUGAUGUCAAACCCGCCGUCCGGGUAGGUUGCUCGAGGCCAUGUGCAAACAUGGUCCCAGAGGAAUGGCCGUCGCGUAUCGGCUCGCGCAAGCGAGACGGUGCCCUCCAGAACCCGGCUUACAGGCCGGCUGACGUU,97,57,151,126,431
5380,0,CP001389.1/2181601-2181204,CCAGUUGGCCGGGCAGCCGCGCCCCGCAGGUGCCGAAAGGCCGCGGGGUGAGGAAAGUCCGGGCUCCACGGAAACACGGUGCCGGAUAACGUCCGGCGGGGGCGACCCCAGGGAAAGUGCCACAGAAAGCAAACCGCUCCGCUCGCGGAGUAAGGGUGAAAGGGUGGGGUAAGAGCCCACCGCGGACAUGGCGACAUGGACGGCACGGUAAACCCCACCGGGAGCAAAACCGAAUAGGGAUGACACGGGCGCGCAAGCGCCCAGCCGGUUUCCAGGCCGGUCAUCCGGGUGGGUUGCACGAGGCUGUGCGCAAGCGCAGUCCCAGAUGAAUGGCUGCCACGUUCCGCUUCCUCGGAGGCGGAGCCAUACAGAACCCGGCUUACAGGCCAACUGGCGAU,89,45,143,121,398
5381,0,CU458896.1/1909668-1910072,CGAGUUGGCCGGGCGGCCGCGGAUCACGAGAGAAAUCUCGCGGUUCGAGGAAAGUCCGGACUUCACAGAGCAGGGUGAUUGCUAACGGCAAUCCGAGGUGACUCGCGGGACAGUGCCACAGAAAACAGACCGCCACCACUCGUGGUGGUAAGGGUGAAACGGUGCGGUAAGAGCGCACCAGCGGACCGGGUGACCGGUUCGGCUCGGUAAACCCCACCCGAAGCAAGGCCAAAAGGCUGUGCGUGCACAGCUGCGGAAGUGUUCGAGGGCUGCUCGCCCGAGCUUCCGGGUAGGCCGCUCGAGGUACCCGGCGACGGUGUACCCAGAUGGAUGGUCGCCGCCGCGUGGCCGCGGCUAGCCCGUGGCUGUGCGGAACAGGAUCCGGCUUACAGGCCAACUCGUUCG,83,60,145,117,405
5382,0,CP001185.1/1619726-1619403,UGAGUGGAGCGAGGAGGCGCAGCUUUAAAGCUGAGGAAAGUCCGGACUCCGUGGGCAGGGUGCCGGAUAACAUCCGGAGGGAGUGAUCCCUGGACAGGGCCAUAGAGAAGAAAACCACCACUAUGGUAAGGGUGGAACGGUGAGGUAAGAGCUCACCAGGUAUGGAGUAAUCCAUACGCUUGGCAACCCCCACCUGGAGCAAGGUCAAGCAGGGUUUGGGUGGCCCGCCCUAUAACCCGGGUAGACCGCUUGAGGAAUUUGGUAACAAAUUCCCAAGAUAGAUGCCUCCAAAAACAGAAUCCGGCUUACCGCUCCACUCAUUUU,89,59,98,78,324
5383,0,AB047588.1/607-1060,GGAGCUGACUGGGUAGUCGCUGCUUUGUUGAUGUCCUUCGGGAGACUGACGUCGAAGUCCCUUCGGGAGACUGACGUCGAAGUCCCUUUGGGAGACUGACGUUGACGUCCUUCGGGAGACUGACAAAGGGGAGGAAAGUCCGGGCUUCAUAGAGCAAGGUGCCAGGUAACGCCUGGGGGGCGCAAGCCUACGACAAGUGCAGCAGAGAGAAGACCGCCGAUGGCCUUAGGGCACAGGUAAGGGUGAAAGGGUGCGGUAAGAGCGCACCGGACGACUAGUAAUAGUUCGUAGCAGGGUAAACUCCACCUGAAGCAAGACCAAAUAGGCCUCCACAUUGCGUUGCUCGCGUAAGGAGGCGGGUAGGUUGCUCGAGCCAGUGAGUGAUUGCUGGCCUAGACGAAUGGCUACCGCCGCGCAAGCGGAACAGAACCCGGCUUAUGUGUCGGCUCCACCU,107,84,154,109,454
5384,0,CP000454.1/2736332-2735941,UGGGUUGACCAGGCGGCCGCGCGUCACGCAAGUGGCUCGAGGAACGUCCGGGCUCCGCAGAGCAGGGUGGUGGGUAACGCCCACUCGGGGUAACCCGCAGGCCAGUGCCACAGAGAACAGACCGCCUGCCGCGGUCCGUGUCCGCACGGGCUGUGAACAGGUAAGGGUGAAACGGUGGUGUAAGAGACCACCAGCUUCCCGGGUGACCGGGAAGGCUAGGUAAACCCCACCCGGAGCAAGGCCAGACAGGGCACGUUCGAGGGCUGCUCGCCCGAGUGUCCGGGUAGGCCGCUGGAGGGCGUCGGCAACGGCGUUCGUAGAUGGAUGGCCGCUAUUCCCGCACCGGCAACGGCGCGGGAACACAGAACCCGGCGUAUCGGUCAACCCAUCCA,79,51,142,120,392
5385,0,AM747720.1/3667865-3667454,AAAGCAGGCCAGGCAGUCGCGGCCUCGCCGUCUUCGGGCGCGCGGGGGCGAGGAAAGUCCGGACUCCACAGGGCAGGGUGAUGGCUAACGGCCAUCCGUGGCGACACGCGGAACAGGGCAACAGAAAGCAAACCGCCGAUGGCCCGGCGCAAGCCGGGAUCAGGUAAGGGUGAAACGGUGCGGUAAGAGCGCACCGCGGCGACGGCGACGUUCGCCGGCACGGUAACCUCCACCCGGAGCAAUUCCAAGUAGGCAGGCGCGCAUUUUCGGAUGCAGGACGGGGCCCCCGUCUCGUCUGCGGGUAGGAAGCUUGAGCGCGUCAGCAAUGGCGCGCCUAGAGGAAUGACUGCCACGCGUUGCGUGCUUCGGUGCGCGGCGUGCACAGAAUCCGGCUUAUCGGCCUGCUUUGCCG,81,57,151,123,412
5386,0,AP009493.1/6142372-6142780,CGAGCCGGGCGGACGGCCGCGUGAGGAUCCCUCGGGACCUCCCGAGGAACGUCCGGGCUCCACAGGGCAGGGUGGUGGCUAACGGCCACCCGGGGUGACCCGCGGGACAGUGCCACAGAAAACAGACCGCCCGGGACUCCGGUCCCGGGUAAGGGUGAAACGGUGGUGUAAGAGACCACCAGCGCCUGAGGUGACUCAGGCGGCUAGGUAAACCCCACCCGGAGCAAGGUCAAAAGGAGGCGCCCCGGAAACGGGACGGCUCUGCGUGAACGUUCGAGGGCUGCUCGCCCGAGUUCACGGGUGGACCGCACGAGGCCGGCAGCAAUGCCGGCCCUAGAUGGAUGGCCGUCUCCCCGGCCGCCGCGAGGCGACCGGGAGACAGAACCCGGCGUACAGCCCGACUCGUCUG,81,44,151,133,409
5387,0,AE017196.1/707035-706686,CUAGGUGGAAUAAGUAGCUGCUGUUGUGUGAUAAACAUAGCAGAGGAAAGUCCGGGCUCCAAGGAAAAAUAGUGACGGGUAAUGCCCGCCGGAGGUAACUCCAGUUAUAGGGCUACAGAAAAUUACCGCCUAAAAUAUUUUUAGGUAAGGGUGAAAAGGUGUGGUAAGAGCACACCAUGGCAAUGGCAACAUUGGUAGUCGAGUAACCAACACUAGGAGCAAGAUUAAAUAGAAGUAGAUUUUAUGUUUUCCUCAUAUCUACUCGGGUAAAUCGCAUGCGGUAAAUGGUAACAUUUACUCCAGAUAAAUAGCUACAUAAACAGAACUCGGCUUAUAUUUCACCUAGGCGU,117,87,85,61,350
5388,0,CP000885.1/4346921-4346525,UGAGUAGUACAGAUGAUCGCGCCGAUUUAAUCGGUGAGGAAAGUCCGGGCUUCAUAGGGCAGGGUGCCGGAUAACGUCCGGUGGAGGCGACUCUAAGGCCAGUGCAACAGAAAAUAAACCGCCUAACCGCAGGUUAGAUAAUAACCGUUAGGUUAGGUAAGGGUGGAAUGGCGGUGUAAGAGACCACCGCUUCUCUGGUAACAGAGAAGGCUGUGUAAACCCCACUUGAAGCAAGACCAAACAAAUACCUUUAUGGUAUGAGAGCGAUACGGCGGCCCGUCGUGCUCUUAGGUAGGUCGCGUUUUGUCUGGUAACGGGCAAAUGAGCUGUAUGGUAACGUACAGUCAAGAUAGAUGAUCAUCAAAUACAGAACCCGGCUUAUAGUACUACUCAACUU,115,88,112,82,397
5389,0,AP009152.1/1651041-1650663,CAGGUGGGCCGGGCGACCGCGCGGCGUCGUCGUUCGCGACGGCGUCUCGAGGAAAGUCCGGGCUCCGCAGAGCAGGACGGUGGGUAACACCCACUCGGGGAAACCCGCAGGACAGUGCCACAGAAAACAGACCGCCCGCCGCGAGCGGGUCAGGGUGAAAAGGUGGUGUAAGAGACCACCAGCGCGCCGGGUGACCGGCGCGGCUCGGUAAACCCCGUCCGGAGCAAGGCCAUGCAGGGCGCGUUCGAGGGCUGCUCGCCCGAGCGUCCGGGUAGGCUGCUCGAGCCGUGCGGCAACGCACGGCCUAGAUGGAUGGUCGUCACCGCGGUGCGGGCAACCGGCCGCGGCACAGAACCCGGCUCACAGGCCCACCUGUCCA,71,41,142,125,379
5390,0,CP001043.1/2886567-2886154,AAAGUAGGCCAGGCAGUCGCGGCUUCGCUGGUUUCGGCUGGCGAGGGCGAGGAAAGUCCGGACUCCACAGGGCAGGGUGAUGGCUAACGGCCAUCCGUGGCGACACGCGGAACAGGGCAACAGAAAGCAAACCGCCGAUGGCCCGUCGCAAGACGGGAUCAGGUAAGGGUGAAACGGUGCGGUAAGAGCGCACCGCGGCUGCGGCGACGCAGACCGGCACGGUAACCUCCACCCGGAGCAAUUCCAAGUAGGCAGGCGCGCAUCUUCGAGAUGCAGGAUGGGGCCCCCGUCUCGUCUGCGGGUAGGAAGCUUGAGCGCGUCAGCAAUGGCGCGCCUAGAGGAAUGGCUGCCACGCGUGGGGCGCUUUCGGGCGCGUCGCGUGCACAGAAUCCGGCUUAUCGGCCUGCUUUGCCG,84,60,152,118,414
5391,0,CP001096.1/4356479-4356935,UCAGUCGGCCGGACGGCCGCUCCGGCAAGUGCCGAAAGGCCGCCGGGGAGGAAAGUCCGGGCUCCAUCGACAUACGGUGCCGGAUAACGUCCGGCGGGGGCGACCCCAGGGAAAGUGCCACAGAGAACGAACCGCUUCCUCUUUCUUCUCCCUCCCCCGCUUGCGGGGGAGGGUCGGGGUGGGGGCAGUAAGGGUGAAAAGGUGCGGUAAGAGCGCACCGCGUCGCCGGCAACGGGGACGGCAUGGUAAACCCCACCGGGAGCAAAACCGAAUAGGGACGGCAUCGCGGAUAGUUCGCUGCUCGCAGCGAUAACUCCGCAGGGCGAUGUCAGGCUCGCCGUCCGGGUAGGUUGCUCGAGGCGCUGUGCAAACAGUGUCCCAGAGGAAUGGCCGUCGCGCAUCGCCUCCGCAAGGAAGCGGUGCCCUCCAGAACCCGGCUUACAGGCCGGCUGAUACU,91,65,162,139,457
5392,0,AP009153.1/4390-3973,GUCACCGGCCGGAUGGUCGCGAAACAGGGGAACGAGCCUUCAUGGCCACGCCCGUGUUCCGAGGAAAGUCCGGGCUCCAUAGGGCAGAUCGCCAGGUAACGCCUGGGCGCAUACGGCGUGAGCUGCAUGCGACGGACAGUGCAACAGAAAGCAAACCGCCGUCUUCGCGAGAAGGCGGUAAGGGUGAAAGGGUGGGGUAAGAGCCCACCGCGCGUCCGGCAACGGGCGUGGCUCGGUAAACCCCGGUCGGAGCAAGGCCAAAUAGGCGGUGAGAGACGGCCCGUCUCGACAGGAUGCUUUCGGGCAUCGAGCCGCGGGUAGGCUGCUGGAGCGUGUUGGUGACGACACGCCGAGAGGAAUGACCAUCCGGUGCACCUCGGUGUACCGACAGAACCCGGCUUACAGGCCGGUGACAUCC,91,58,151,118,418
5393,0,CP000812.1/706597-706925,GGAGAGAGGCGGGUGGUCGCAGGCGCUGCCUGAGGAAAGUCCGGACUCCACAGGGCAGGACGCUGGGUAAUACCCAGGAGGAGCGAUCCUCGGACAGGGCCAUAGAGACUUCAAACCGCCUUGAAAGGCAAGGGUGGAAAGGUGAGGUAAGAGCUCACCAGCAUCGGGGUGACCCGAUGGCUCGGUAACCCCCGUUCGGAGCAAGGCCAAGCAGGGGUUGGGUGGUCCCGCCCGAUAACCCCGGGUAGGCCGCUUGAGGAGGGUGGUAACACCCUUCCAAGAUAGAUGACCACCUGAGACAGAAUCCGGCUUACGGCCUCUCUCCGAUU,77,50,114,88,329
5394,0,CP000084.1/39405-39051,CUAGAUGAACGACUUAUCGCUUUAAUUUAUUAAAGAGGAAAGUCCGGGCUCCGCAAAGACACAGUGCCAGAUAAUACCUGGCGGGGGAAACCCUAGGGAUAGUGCCACAGAAAAUAUACCGCCAUAACAUGGCAAGGGUGAAAAGGUGUGGUAAGAGCGCACCGGUUCUAUUGGUAACAAUGAACGCUGGAAAACCCCACUGGGAGCAAGACUAAGUAGAGAUGACAUUGUUGCAAAACUAAAAGCCGUCUUUGGCUAGUCAUCAGGGUUAGUUGCAUGAGCUUAAGAGUGAUCUUAAGCCUAGAGAAAUGAUAGGUUUAAAUGACAGAACCCGGCUUAUAGUUUGUCUAGCAAA,118,80,91,66,355
5395,0,AP008971.1/892181-891852,UGACUAAAUCAGAUAAUCGCAUGAAUUCAUGAGGAAAGUCCGUGCACUAUAGAGCGAGGAUGCUGGAUAACGUCCAGUGGGGGCGACCCUAAGGCUAGUGCAACAGAGAUAUACCGCCAUUUAAUGGUAAGGGUGGAAAGGUAGGGUAAGAGCCUACCAGCAUAAAGGUGACUUUAUGGCUAUGUAAACCCCAUUCAGUGCAAAAUCAAAUAGGAAUAAAGACGGCUGCUCGUCGUCUCCGGUAGGUAGAUUGCUUGAACUAAUUGGUAACAAUUAGUCUAGAUAGAUGAUUAUCAAAUACAGAACACGGCUUAUAGAUUUGGUCAUAAA,110,80,83,57,330
5396,0,CP000850.1/4149263-4148852,CGAGUCGACCGGGCGGUCGCGUCGGUGGGUUUGGCCCGCCGUCGAGGAACGUCCGGACUCCACAGGGCAGGGUGGUUGCUAACGGCAACCCGGGGUGACCCGCGGGACAGUGCCACAGAAAACAGACCGCCGUUCCCAUCGGGGACGGUAAGGGUGAAACGGUGGGGUAAGAGCCCACCAGCACCCCGGGUGACCGGGGUGGCUCGGUAAACCCCACCCGGAGCAAGGCCAAGAAGGGCGUCAUCUGCGGAGACGACGACCCGCGCAGGCGAUCGAGGGCGGCCCGUCCGAUGUCUGCGGGUAGGCCGCUGGAGCCUGUCGGUGACGGCAGGCCGAGAUGGAUGACCGCCGCCGGCGCGAACCCUCGGGUGCGCGCCGCGCACAGAAUCCGGCGUACAGGUCGACUCGUCCG,75,49,158,130,412
5397,0,CR767821.1/1094194-1094531,UCAGGUAAGAAAGUAGUUGCUGUAUUUCAUAAUGCAGAGGAAAGUCCGGACUCCAAGGGAAAAUGGUGACAGGUAACUCCUGUCGGAGGUAACUCUAGGUAUAGGACUACAGAAAAUAACCGCCUUACUAAUAAGGUAAGGGUGAAAAGGUGUGGUAAGAGCACACCGUACUUAUGGCAACAUAUAGUAGCUAAGCAACCACCACCAGGAGCAAGACUAAAAGAGAUAUAUGUGUUUUCCCUCACAAUUAUCUAGGUAAGUCGCGUGAGGUAGAUAGCAAUAUUUAUCCCAGAUGAAUAACUACACAAACAGAAUCCGGCUUACUCUUACCUGACCAU,118,79,76,65,338
5398,0,CP001322.1/3925535-3925148,AGAGGAGACCAGGCGGCCGCCGGGUUUCACCUCCCGGAGGAAAGUCCGAACACCGCAGGGCAGGGUGCUCCGUAACGCGGAGUCGCGGCAACGCGAAGGCAAGUGCAACAGAAAGUAUACCGCCUGGCAGUCUCGCUUUUGAGCGGGCCUGCCCGGUAAGGGUGAAACGGUGCGGUAAGAGCGCACCAGUUCCCCGGGCGAUCGGGGAAGCUGGGUAAACCCCACCCGGUGCAAGACCAAAUAGGGGAGCUCAUGCAGCGGCCCGCUGUAGGCUCCCGGGUAGGUUGCAAGAGGCGUCGGGCAACCGGCGCCCUUAGAUGAAUGGCCGCCGCCCUGGCCGGGGCGACCCGACCAGGGAACAGAAUUCGGCUUACGGUUUCCUUUGACC,82,55,136,115,388
5399,0,AE016958.1/2182909-2182516,CGAGUUGGCCGGGCGGCCGCGGCUCGUAUCCCGAGUCGAGGAAAGUCCGGACUUCACAGAGCAGGGUGAUUGCUAACGGCAAUCCGAGGUGACUCGCGGGAAAGUGCCACAGAAAACAGACCGCCACCCUCGCGGUGGUAAGGGUGAAACGGUGCGGUAAGAGCGCACCAGCACCCCGGGUGACCGGGGUGGCUCGGCAAACCCCACCCGAAGCAAGGCCAAGAAGGCCGUGCCGCCGGCACGGCCGCGCAGGCGUCCGAGGGUUGCUCGCCCGAGCCUGCGGGUAGGCCGCUCGAGGCACCCGGUGACGGUGUGUCCAGAUGGAUGGUCGCCGCCGCGGCGCCGGUUUUCCGGCGGCGCGGAACAGAAUCCGGCUUACAGGCCAACUCGUCCG,75,50,144,125,394
5400,0,CP000236.1/343907-343570,UCAGGUAAAAAAGUAGUUGCUGUAUUGUAAAGUACAGAGGAAAGUCCGGACUCCAAGGGAAAAUGGUGACAGGUAAUCCCUGUCGGAGGUGACUCUAGGUAAAGGGCUACAGAAAAUAACCGCCUUGUUACAAGGUAAGGGUGAAAAGGCGUGGUAAGAGCACACCGUACUUAUGGCAACAUAUAGUAGCUAAGUAACCACCACCAGGAGCAAGACUAAGAAGAGGUAUUUGUGUUUUCCCUCACAAUUACCCAGGUGAGUCGCGUGAGGUAGGUAGCGAUAUCUAUCCCAGAUGAAUAACUACAUAAACAGAAUCCGGCUUAUUUUUACCUGGCAAG,112,77,86,63,338
5401,0,AP009179.1/609781-610130,CAGGUGCAACAGGUAGUUGCUGGUGACAUUUGUGUCACGAGAGGAAAGUCCGGGCUGCAAGUGAGACAGGACUCCAUCUAACGGAUGGCCAGAGUAAUCUGAGGGCAAGUGCAACAGAAAGUAAACCGCCAGACUUUGUUUGGUAAGGGUGAAAGGGUGGGGCAAGAGCCCACCGGUGAGUGUGGUAACACGCUCAGCCAGGUAAACCCUGUCCGCAGCAAGAAGUAUAUGGUAUAAGUCUCACAAGCCGUUCAGUCGGCACUCAUACUUCGCUCGAGCCUGCUGGCAACAACAGGCCUAGAUAAAUAACUACCCAAUGACAGAACCCGGCUUAUCGUUGCACCUAUUAU,100,71,97,82,350
5402,0,CP001001.1/2506640-2506242,UCAGCCGGCCGGGCAGCCGCUCCGGACGCGCGAGCGUUCGGGGAGGAAAGUCCGGGCUCCAUGGAGAGACGGUGCCGGAUAACCUCCGGCGGGGGCGACCCCAGGGACAGUGCCACAGAGAGCAGACCGCCCCGGAUCCGUCCGGGGUCAGGGUGAAAGGGUGCGGUAAGAGCGCACCGCGGACGCGGCAACGCGGACGGCACGGCAAACCCCACCGGGAGCAAGACCGAAUAGGGGCGGCGCGCCCUUCGCGAGAAGGGCAGGCCGGCUCUCCAGGCCAGUCGCCCGGGUUGGUUGCUCGAGGCGGUCGGCAACGAUCGUCCCAGAGGAAUGGCUGCCACGUCGGCGCGCGCGAGCGCUCCGGCCCUACAGAACCCGGCUUACAGGCCGGCUGAUCCA,74,40,153,132,399
5403,0,CABC01000030.1/25678-26056,ACGGAUCGGCGGACGGCCGCGUGCCCCUGCGGGGGUGCGAGGAAAGUCCGGGCACCGCAGAGCAGGAUGGUGGACAACAUCCACCCGGGGCGACCCGCGGGCCAGUGCCACAGAGAGAAGACCGCCUCCGCGCCGUGUGCGCGGCGGUAAGGGUGAAAGGGUGGUGUAAGAGACCACCAGCGGCCCCGGUGACGGGGCCGGCUCGGUAAACCCCAUCCGGUGCAAGGCCGAACAGGACGCGUCACGAGGGCUGCUCGCCCCAGCGUCCGGGUUGGCCGCUCGAGCCCGUCAGCGAUGGCGGGCCCAGAUGGAUGGCCGUCACCUCGCGCGGGGCAACGCGCGCGAGGCACAGAACCCGGCUUACAGCCGGUCCGUCCCA,68,39,145,127,379
5404,0,CP001079.1/890021-890352,CCAGGUGGAGAAGUAGCCGCUGUGCCGCGUUGUACAGAGGAAAGUCCGGACUCCAAGGGAAGAUGGUGGCAGGUAACUCCUGCCGGGGGUAACCCUAGGUUAGGGCCACAGAAAAUUACCGCCUCUACGAGGUAAGGGUGAAAAGGUGCGGUAAGAGCGCACCGUGCUCGUGGUGACACGUAGCAGCCAGGCAACCACCACCAGGAGCAAGGCUAAGAAGGGUAUUGUGUCUUCUCUCAUGUUACCCGGGUAAGUCGCUUGAGGUAAGUAGCGAUGCUUGCCCCAGAUGAAUGGCUACAUAAACAGAAUCCGGCUUAUCUCCACCUGGUCCG,84,64,103,81,332
5405,0,AP010918.1/2472230-2471802,UGAGUUGGCUGGGCGGCCGCGGCUCGCGUAGGGCUUGUGUGGAUUCACGAGGUUCAGCGUCGAGUCGAGGAAAGUCCGGACUUCACAGAGCAGGGUGAUUGCUAACGGCAAUCCGAGGUGACUCGCGGGAAAGUGCCACAGAAAACAGACCGCCAUCCUCGUGGUGGCAAGGGUGAAACGGUGCGGUAAGAGCGCACCAGCAUUCCGGGUGACCGGGGUGGCUAGGCAAACCCCACCCGAAGCAAGGCCAAGAAGGCCGCACCGAAAGUGCGGCCGCGCAGGCGCUUGAGGGUUGCUCGCCCGAGCCUGCGGGUAGGCCGCUCGAGGCACCCGGUAACGGUGUGUCCAGAUGGAUGGUCGCCGCCGUGCCGCCGUUAGCUUGGCUGUGGCGGCGCGGAACAGAAUCCGGCUUACAGGCCAACUCGUCCG,85,67,157,120,429
5406,0,CP000235.1/215238-214901,UCAGGUGGAGUUGUAGUCGCUGUGCUUUUUUUGCACAGAGGAAAGUCCGGACUCCAAGAGAAGAUGGUGGCAGGUAACUCCUGCCGGGGGUAACUCUAGGUUAGGGCCACAGAAAACUACCGCCCCGUAAAGGGGUAAGGGUGAAAAGGUGCGGUAAGAGCGCACCGUACUCGUGGUAACACGCAGUAGCAAGGUAACCACUACCAGGAGCAAGGCUAAGAAGGGCAUUAUGGCUUCUCUCAUUUGUUGCCCGGGUAAGCCGCAUGAGGCAUGCAGCGAUGCAUAUCCCAGAUGAAUGACUACAUAACACAGAAUCCGGCUUAUCUCCACCUGACAUC,92,70,97,79,338
5407,0,CP001029.1/5550002-5549599,UCAGCCGGCCGGGCGGCCGCUCCGUCGUCAGACGGGGAGGAAAGUCCGGGCUCCAUGGAGAGGCGGUGCCGGAUAACCUCCGGCGGGGGCGACCCCAGGGACAGUGCCACAGAAAGCAGACCGCCCCGCCAAGGCCCGUCCUUCGCGGGGUCAGGGUGAAAGGGUGCGGUAAGAGCGCACCGCGGACGCGGCAACGCGGACGGCACGGCAAACCCCACCGGGAGCAAAACCGAAUAGGGGCGACACGCCUUCUCCGCGAGGGGAAGGCAGGCCCGCUCUCCAGGCUCGUCGCCCGGGUUGGUUGCUCGAGGCGGCCGGCAACGGCCGUCCCAGAGGAAUGGCUGCCACGUCCGUGGGCUUGCCCACGGGCCCUACAGAACCCGGCUUACAGGCCGGCUGAUCCA,75,43,149,137,404
5408,0,AE006914.1/739871-739357,CUAAAUGGUCGUGCAGUUGCGUGAUAAUAUAGCAAAGCUAUAGAUCACGAGGAAAGUCCGGACUCUAUAGAGGUAUGGUGCCGGUUAACCUCCGGCAGAGUAUUAUUACUUUAGGGACAGUACCACAGAAAAUACACCGCCAAGUAUGAAUACGAAGAUCCUUCAAAAAGAGCUAGGAGUUCACAAGACGAGGAACGGAGCGUAUACUUAAUACGUGAGUACCGUAGUACUUGUGAAAUGACGCAGCCAAUUUUUGCAGUUGAUCGAGUAUUUUUGGUAAGGGUGAAAAGGUACGGUAAGAGCGUACCGGUAAGUUGGUAACAAAUUACGCAUGGUAAACCCCACCAAGAGCAAGAUCAAAUAGGCGUUACAGAACUUAUCAAGUUCCCGGGUUAUCUCUAGCCGGCUUGUAAUGCGGGUAGAUCGCUUGAGGUAAACGGUAACGUUUAUCCUAGAUAAAUAACUGCAAUGAAUUGAUAUUCAUACAGAAUCCGGCUUAUAGACCUUAUUGUCAU,166,131,124,94,515
5409,0,CP000511.1/3845801-3845381,UGAGCUGGCUGGGCGGCCGCGGCACCCCACAGUGUCGAGGAAAGUCCGGACUUCACAGAGCAGGGUGAUUGCUAACGGCAAUCCGAGGUGACUCGCGGGAAAGUGCCACAGAAAACAGACCGCCUCCACUGCGCCCCAAGCCUUCGGGCCCAAGGACGCUCCGGAGGUAAGGGUGAAAAGGUGCGGUAAGAGCGCACCAGCAUCCCGGGUGACCGGGGUGGCUUGGUAAACCCCACCCGAAGCAAGGCCAAGAAGGCCGCAACCUGGUUGCGGCCGCGCAGGCGUUCGAGGGUUGCUCGCCCGAGCCUGCGGGUAGGCCGCUCGAGGCACCCGGCGACGGUGUGUCCAGAUGGAUGGUCGCCGCCUCGCUGCCAGAGAUGGCCGUGAGGAACAGAAUCCGGCUUACAGGCCGGCUCAUCCG,87,57,148,129,421
5410,0,CP001357.1/28262-27922,UAUGCGGAGUGGGUAAACGCGGUAUUUAAGUAACUAAUACUGAGGAAAGUCCGUACCUCUAAAGGGCUUCAUGCAAGCUAACGGCUUGAAGGCGAAAGCCUAUGGAAAGUGCAGCAGAAAAUAUACCGCCAAUUUGGUAAGGGUGAAAAGGCAUGGUAAGAGCAUACCGCAUUUAUGGCGACAUGAAUGGCAGUGUAAACCCCAUGAGAGGCAAGAGCAAACAGAAACGGAUUGCCCUUUUCCUAUGUUUCAGGUGGCUCGCUAAAGCAUUGUAGUGAUAUAAUGCGUAGAUAAAUGUUUACCUUAAAUGACAGAAUACGGCUUAUAGCUCCGCUUUUUAU,109,85,86,61,341
5411,0,CP000848.1/666733-667249,CUAAAUGGUCGUGCAGUUGCGUGAUAAUAUAGCAAAGCUAUAGAUCACGAGGAAAGUCCGGACUCUAUAGAGGUAUGGUGCCGGUUAACCUCCGGCAGAGUAUUAUUACUUUAGGGACAGUACCACAGAAAAUACACCGCCAAGUAUGAAUACGAAGAUCAACUUCAAAAAGAGCUAGGAGUUCACAAGACGAGGAACGGAGCGUAUACUUAAUACGUGAGUACCGUAGUACUUGUGAAAUGACGCAGCCAAUUUUUGCAGUUGAUCGAGUAUUUUUGGUAAGGGUGAAAAGGUACGGUAAGAGCGUACCGGUAAGUUGGUAACAAGUUACGCAUGGUAAACCCCACCAAGAGCAAGAUCAAAUAGGCGUUACAGAACUUAUCAAGUUCCCGGGUUAUCUCUAGCCGGCUUGUAAUGCGGGUAGAUCGCUUGAGGUAAACGGUAACGUUUAUCCUAGAUAAAUAACUGCAAUGAAUUAAUAUUCAUACAGAAUCCGGCUUAUAGACCUUAUUGUCAU,168,131,124,94,517
5412,0,CP001620.1/804140-804595,UGAGCCGGCCGGGUAAUCGCGGGGGCGGAAUCGACAGCACAGCGAGUCUCUGCUUGCAGAGACGGUGCCUGAUGCUGCGCAGACCGUCGUCGAGGAAAGUCCGGACUCCACAGAGCACGGAUGUUGCUAACAGCAACCCAGGGCGACCUGAGGGCACGUGCAACAGAAAGUAGACCGCCUGCAGACGCAAUAUCUGCAGGUAAGGGUGAAAGGGUGCGGUAAGAGCGCACCAGCACUGCAGGUGACUGUGGUGGCUAGGUAAACCCUUCCGGGAGCAAGGCAUGAUGGCGCACCAGUAUGGUGCGCCGGCGCGGGCGUUUGAGGGCUGCUCGUCCAAGUCCGCGGGUAAGCCGCGUGAGGCUGCCAGCGAUGGCAGCCCAAGAUAGAUGAUUACCUCCCAUGCCAGGGGAGACCCCGCAUGGCAGACAAAAUCCGGCUUAUAGGCCGGCUCAUUCG,104,71,157,124,456
5413,0,CP000683.1/680077-680596,CUAAAUGGUCGUGCAGUUGCGUGAUGAUAUAUAGCAAAGCUAUAGAUCACGAGGAAAGUCCGGACUCUAUAGAGGUAUGGUGCCGGUUAACCUCCGGCAGAGUAUUAUUACUUUAGGGACAGUACCACAGAAAAUACACCGCCAAGUAUGAAUACGAAGAUCAACUUCAAAAAGAACUAGGAGUUCACAAGACGAGGAACGGAGCGUAUACUUAAUACGUGAGUACCGUAGGUACUUGUGGAAUGACGCAGCCAAUUUCUGAAGUUGAUCGAGUAUUUUUGGUAAGGGUGAAAAGGUACGGUAAGAGCGUACCGGUAAGUUGGUAACAAAUUACGCAUGGUAAACCCCACCAAGAGCAAGAUCAAAUAGGCGUUACAGAACUUAUCAAGUUCCCGGGUUAUCUCUAGCCGGCUUGUAAUGCGGGUAGAUCGCUUGAGGUAAACGGUAACGUUUAUCCUAGAUAAAUAACUGCAAUGAAUUUCUAUUCAUACAGAAUCCGGCUUAUAGACCUUAUUGUCAU,168,132,125,95,520
5414,0,CP000107.1/922327-922662,UCAGGUAAAAGAGUAGUUGCUGUACUAACAUACAGAGGAAAGUCCGGACUCCAAGGGAAAAUGGUGACAGGUAAUCCCUGUCGGGGGUAACUUCAGGUAAAGGGCUACAGAAAAUAACCGCCUUGUUAACAAGGUAAGGGUGAAAAGGCGUGGUAAGAGCACACCGUACUUAUGGCAACAUAUAGUAGCUAGGCAACCACCACCAGGAGCAAGACUAAAAUGAGGUAAUGUAUUUUCCCUUACAAUUACCAAGGUGAGUCGCGCGAGUUAGGUAGUGAUACCUAUCCCAGAUGAAUAACUACAUAAACAGAAUCCGGCUUAUUUUUACCUGGCACA,114,74,82,66,336
5415,0,AP009178.1/851649-851994,GUGGCGCAACGGAUAGCUGCUUGGGAAACCAAGAGGAAAGUCCGAGCUGCAGUGAGGCAGGGUUCCACCUAACCGGUGGCCAGCGAAGCCCUUUGGGAUAAGCUGAGGGAAAGUGCAACAGAAAGCAGACCGCCGAUGGCCUUUUGGCACAGGCAAGGGUGAAAGGGUGAGGUAAGAGCUCACCGCUUCUGUGGCAACACAGAAGGCAGUGUAAACCCAACCCGCAGCAAGUCGCACCUGGUUAAAGCCUCACAUUUUUGAGUGCGACGCUAGAGCUUAGUGGUGACACUAAGCGUAGAUAAAUAGCUAUCCACGACAGAACUCGGCUUACAGUUGCGCCACCUCU,96,62,103,85,346
5416,0,AM260522.1/1224605-1224290,CGCAUUAGAAGAUGGUCGCUAUUUUAGAAUAGAGGAAAGUCCGGGCUACAUUAGACAAAAUUCCAUCUAACGGAUGGCUAGCGCAAGCUAAGGGAAAGUGCCACAGAAAGCAAACCGCCUUUUAAGGUAAGGGUGAAAGGGUGGGGUAAGAGCCCACCAAAGCUAAAGCAAUUUAGUUUGUUUGGCAAACCCAAUUUGUAGCAAGAAGUGCAUGGUAAGUCUAAAUUGAUACGCACUUCGCUUGAGGAAUAUUGCAAAAUAUUCCCUAGAUAAAUGACCAUCCAUUGACAGAACCCGGCUUAUUCUAAUGCUUUAU,106,78,73,59,316
5417,0,CT573073.1/410381-410766,AAAGUAGACGAGGUGAUCGCCGGUUAUAAUGAAUCUUCGGAUUUAUUAUUGGACGGGAGGAAAGUCCGAGCUCCAUAGGGCGCAGUGCUCCGUAACGCGGAGUCCCGGCGACGGGAAGGAAAGUGCAACAGAAAAUAUACCGUCUCAUCUUUUUUUCGAUGGGAUAAGGGUGAAAUGGCGGGGCCGAAAGGCUUAAUGUAAGAGCCCACCGCUCCGGCGGCGACGUUGGAGGCAUGGCAAACCCCACUGGGAGAAAGGCCAAAUAGGGAGGGAUGAAGCUGCCCGCUUCGCUAUACCUUCGGGUAGGCCGUUAGAUCUCGCUGGCAACAACGAGGCUAGAUGAAUGAUCACCCACGACAAGACUCGGCUUAUUGUCUACUUUUACC,102,80,116,88,386
5418,0,CP000661.1/2259552-2259157,GCGGGUGGCCGGAUGACCGCGUGCCUUCGGGCGCGAGGAAAGUCCGGACUCCAUGAGACAAGGGUGCCGGGUAACGCCCGGCCGGGGCAACCCGAGGGAAAGCGCCACAGAGAAGAGACCGCCCCACCGGCCGAAAGGCCCGGGGCAAGGGUGAAACGGUGGGGCAAGAGCCCACCGCGGGACUGGCAACAGGACCGGCACGGCAAGCCCCACCCGGAGCAAUGCCGAAUAGGGGUCUCGCGCGGGGCUGAUCCGUCAGGAUAUCGCCGCAGGGAAGUCUCAGCCCGAGAGACCCGGGUUGGCAGCUCGAUCCCGUCGGCAACGGCGGGGCCAGAGGAAUGGUCAUCGAAGGGGGCAACCCCGGAACAGAAUCCGGCUUACAGGCUGCCCGCACAU,88,37,148,123,396
5419,0,CP001349.1/5573628-5573218,UCAGCCGGCCGGGCGGCCGCUCCGCCUUCGGGUGGGGAGGAAAGUCCGGGCUCCAUGGAGAGACGGUGCCGGAUAACCUCCGGCGGGGGUGACCCCAGGGACAGUGCCACAGAGAGGAGACCGCCGCGCGCACCUCCGGGUGCCUUAGCGGUAAGGGUGAAAGGGUGCGGUAAGAGCGCACCGCGGACGCGGCAACGCGGACGGCACGGCAAACCCCACCGGGAGCAAAACCGAAUAGGGGCGACAGGCGCCGGCCUUCGGGCCGGCGCGAGGCGUUCUCCAGCCCCGUCGCCCGGGUUGGUUGCUUGAGGCGGCCGGCGACGGCCGUCCCAGAGGAAUGGCCGCCACGUCCGGGGAGCCUUCGGGUUCCGCCGGGCCCUACAGAACCCGGCUUACAGGCCGGCUGAUACU,70,47,159,135,411
5420,0,BX294154.1/194145-193741,CGAGUGGGCGGGGUGACCGCUGGCACGGUUCGCGGUUCCCGCGUUUCCGGCUGGAGGAAAGUCCGGGCUCCGAAGGGCAGGAUGGUCGAUAACGUCGACCGGUCGUGAGGCCAGGGAAAGUGCAGCAGAGAGCAGACCGCCGAACGGUGACGCCGCUUGCGGUGUCAUGCGUGGUGAGGGUGAAACGGUGCGGUAAGAGCGCACCAGCGAUCAGGGUGACUUGAUCGGCUCGGUAAACCCCAUCCGGAGCUAGACCAAACAGGGUGCAUCAUCGAGGCGGCCCGCCUCGUUAUCGACAUCCGGGUAGGUCGCAGUGGAGGCGACGAGCAAUCGUCGUGCACAGAUAAAUGGUCACCGUCGAUGCUCGCAUCGGCACAGAACCCGGCUUACAAGCCCACUCGUUUU,84,68,143,110,405
5421,0,AE001439.1/590504-590821,CGCAUUAGAAGAUGGUCGCUAUUUUAGAAUAGAGGAAAGUCCGGGCUACAUUAGACAAAAUUCCAUCUAACGGAUGGCUAGCGCAAGCUAAGGGAAAGUGCCACAGAAAGCAAACCGCCUUUUUAAGGUAAGGGUGAAAGGGUGGGGUAAGAGCCCACCAAAGCUAAAGCGAUUUAGCUUGUUUGGGCAAACCCAAUUUGUAGCAAGAAGCGCAUGGUAAGUCUAAAUUAAUACGCGCUUCGCUUGAGGAAUAUUGCAAAAUAUUUCCCAGAUAAAUGGCCAUCCAUUGACAGAACCCGGCUUAUUCUAAUGCUUAAC,105,75,76,62,318
5422,0,CP000360.1/1550317-1549892,CCGCUGGGCCGGACGGCCGCUGCUGCAUCGGUUUACGCCCGGUUCGCCGGGGCCGUACUGAUGUGGGGGAGGAAAGUCCGAACUCCGCAGAGUGGUGUGCCGGAUAACGUCCGGGAGGGCGCCGUUAAGGGCGUUCGACGGAAAGUGCCACAGAGAACAUACCGCCCGCCGCAAGGCAGGUAAGGGUGAAAAGGUGCGGUAAGAGCGCACCGGGCGCGCAGUGAUGCGCGUUGCAUGGCAAACCCCACACGGAGCAAGACCAAAUAGGGGAGAAGUUCGCGGGGCAACUCGCGAUGCGUGCUGACUCGGUGCGCCAAACUUCCGGGUAGGUCGCUUGAGCCAGUCAGUAAUGAUUGGCCCAGAGGAAUGGUCGUCCCGCCGGCGCAAGCCGGUGGACAGAAUUCGGCUUAUAGGCCCGGCGGCUAA,90,65,156,115,426
5423,0,CT573213.2/2444154-2443740,CGAGGUGGCCGGGCGGCCGCGUCGGCACCGGUUCACGCCGGUGCCGCCGAGGAAAGUCCGGGCUCCACAGGGCAGGGCGGUGGGUAACACCCACCCGGGGCGACCCGCGGGACAGUGCCACAGAAAACAGACCGCCGGUGCCGGUGACGGCGCCGGUAAGGGUGAAACGGUGCGGUAAGAGCGCACCAGCGCCCAGGGUGACCUGGGCGGCUCGGUAAACCCCGCCCGGAGCAAGGUCAGAAGGCCCGCGGCCGUAACCGGUCGCGAGCCGCGCAGGCGUUCGAGGGCUGCCCGCCCGAGUCUGCGGGUGGACCGCUGGAGGCUGUCGGCAACGGCAGCCCGAGAGAGAUGGCCGCCACCGGCGAGCCGCAAGGCGACCCGGCCACAGGACCCGGCUUACAGGCCACCUCGUCCG,73,37,162,143,415
5424,0,CP001072.2/761860-761543,CGCAUUAGAAGAUGGUCGCUAUUUUAGAAUAGAGGAAAGUCCGGGCUACAUUAGACAAAAUUCCAUCUAACGGAUGGCUAGCGUAAGCUAAGGGAAAGUGCCACAGAAAGCAAACCGCCUUUUUAAGGUAAGGGUGAAAGGGUGGGGUAAGAGCCCACCAGAGCUAAAGCAAUUUAGCUUGUUUGGGCAAACCCAAUUUGUAGCAAGAAGCGCAUGGUAAGUCUAAAUUGAUACACGCUUCGCUUGAGGAAUAUUGCAAAAUAUUUCCCAGAUAAAUGGCCAUCCAUUGACAGAACCCGGCUUAUUCUAAUGCUUAAC,105,76,76,61,318
5425,0,AE000511.1/629821-630135,GCAUUAGAAGAUGGUCGCUAUUUUAGAAUAGAGGAAAGUCCGGGCUACAUUAGACAAAAUUCCAUCUAACGGAUGGCUAGCGCAAGCUAAGGGAAAGUGCCACAGAAAGCAAACCGCCUUUUAAGGUAAGGGUGAAAGGGUGGGGUAAGAGCCCACCARAGCUAAAGCAAUUUAGCUUGUUUGGGCAAACCCAAUUUGUAGCAAGAAGCGCAUGGUAAGUCUAAAUUGAUACACGCUUCGCUUGAGGAAUAUUGCAAAAUAUUUCCCAGAUAAAUGGCCAUCCAUUGACAGAACCCGGCUUAUUCUAAUGCUCAA,105,73,75,61,315
5426,0,CP000747.1/2646768-2646353,UCAGACGGCCGGGCGGUCGCGGCCCUCCUUCGGGCGGGUCGAGGAAAGUCCGGGCUCCACGACGGCAUGGCGGCGGGUAACGCCCGCCGGGGGCGACCCCAGGGAUAGCGCCACAGAAAGCAAACCGCCCGGCGAAGCCUCGUGCGGAGCAGGGUAAGGGUGAAAGGGUGGGGUAAGAGCCCACCGGGUCGCUGGUGACAGAGGCCGCAUGGCAAGCCCCGCCAGGAGCAAGACCGAAUAGGGAUUCCGCGCCGGCGCCUCUCCUUCGGGAAAGGGGCCGGUAGGGCCGCCGCCGGCCCGAGGGAUCCGGGUAGGUCGCGAGAACCGGUCCGCGAGGGCCGGUCCAGAGGAAUGAUCGCCGCGCUCCGCCCUCGGGCGGGGCGGCACAGAACCCGGCUUACAGGCCGUCUGAUCCC,74,43,164,135,416
5427,0,CR555306.1/867494-867067,GAAGUUCGCCAGGCAGUCGCUGCGUGCACUUGUGUGCGUGGAGGAAAGUCCGGGCCCCGCAGAGCAGGAUGCCGGCUAACGGCCGGGCGUCGUGAGGCGACGGAAAGUGCAACAGAAAGCAAACCGCCGAUGGCUCCGCGAGGAGAUCAGGCAAGGGUGAAAUGGUGCGCAGCGCGCGUCGAGCGUCGUUGCGGACGGGGUGCAAGCCUCGUCGGGUAAGAGCCCACCGCAGGACUGGCGACAGGACUGGCACGGCAAACCCCAUCCGGGGCAAGGCCAAAUAGGGGAGCAAUGGCGUGGCUCGCGCUGUUCCCGGGUAGGCUGCUUGAGCGCCGCGGCAACGCGGCGCCCAGAGGAAUGACUGCCCGGUGCCUGUGAUGCGAGUCGCAGGCGCUCGACAGAACCCGGCUUAUCGGCGAACUUCCCAU,87,58,160,123,428
5428,0,CP000552.1/1578074-1578455,GAAAGCAGGAGAGGCAAUCGCAAAAAAGUUUUAUUUCGUUUUGAAAAUAAAACUUUUUUGAGGAAAGUCCGGGCUCCCAUAUGGUCAGGCUUGCUGGGUAAUUCCCAGUGCGGGCAACCGUGAGGAUAGUGCCACAGAAACAUACCGCCUAAUACUUUCUUAGUAUGGCAAGGGUGCAAGGGUGCGGUAAGAGCGCACCAGCAACAUUGAGAAGUGUUGGCUAGGUAAACCCCGGCUGGGAGCAAGGCUUAGUGGAUUUAUGACCAUUAGAAAAUCUACUUAUGAGCGCCGCUUGAGGCUGUGAAGUAAUUCCAGUCCUAGAUAGAUGAUUGCCCAUCUUAAUUACGAUGAACAGAACCCGGCUUAUGACCUGCUUUCUAAU,110,97,99,76,382
5429,0,CP000976.1/763015-763362,GUUGAUAUCCAGUCAUCGCUUAACAUACUGUAUUUCAGUAUCUUGAGAGGAAAGUCCGAGCUCCAAUAAGAGCAUAAUGCUAGGUAAUGCCUAGGAGUUGAAAGACUUAAGAUAGUGUCACAGAAAAUUACCGCCUUAGGGUAAGGGUGAAAAGGUGAGGUAAGAGCUCACCGCUUAUUUAGUGAUAAAUAAGGUCAAGACAAACCUCAUUAGGAGCAAAAUCAAGUAAACAAGCUUCCUUAGCUCUUGAGGGUAUGCUUGUGGGUAGAUUGCAUGAUUUUUUCAGUGAUGGAAAAACAAGAUAGAUGAUGACAUAAUACAGAACUCGGCUUAUGGAUAUCAACUUAA,120,94,80,54,348
5430,0,CP000576.1/1518319-1518700,GAAAGCAGGAGAGGCAAUCGCAAGAAAGUUUUAUUUUGGAAACAAAAUAAAACUUUCUUGAGGAAAGUCCGGGCUCCCAAAUGGUCAGGCUUGCUGGGUAAUUCCCAGUGCGGGCAACCGUGAGGAUAGUGCCACAGAAACAUACCGCCUAAUACUUUAUAUGUAUGGCAAGGGUGCAAGGGUGUGGUAAGAGCGCACCAGCAACAUUGAGAAGUGUUGGCUAGGUAAACCCCGGCUGGGAGCAAGGCUUAGUAGAUUUAUGACCAUUACACAAUCUACUUUGAAGCGCCGCUUGAGACUGUGAAGUAAUUCCAGUCCUAGAUAGAUGAUCGCCCAUCUUAAUUAAGAUGAACAGAACCCGGCUUACGACCUGCUUUCUAAU,116,91,97,78,382
5431,0,BX548174.1/1533930-1534307,GAAAGCAGGAGAGGCAAUCGCAAAAAUGUUUUAUUUUGUUUUGAAAAUAAAUCUUUUUGAGGAAAGUCCGGGCUCCCAUAUGGUCAGGCUUGCUGGGUAAUUCCCAGUGCGGGUAACCGUGAGGAUAGUGCCACAGAAACAUACCGCCUAAUACUUUAUGUAUGGCAAGGGUGCAAGGGUGCGGUAAGAGCGCACCAGCAACAUUGAGAAGUGUUGGCUAGGUAAACCCCGGCUGGGUGCAAGGCUAAGUAGAUUUAUGACCAUUAAAAAAUCUACUUUUAAGCGCCGCUUGAGGCUGUGAAGUAAUUCCAGUCCUAGAUAGAUGAUUGCCCAUCUUAUUAAGAUGAACAGAACCCGGCUUAUGACCUGCUUUCUACU,109,100,96,73,378
5432,0,CP000814.1/518663-518343,AAAGCAUAGUAAAUGCUCGCUUCUUUUUAGAAGAGGAAAGUCCGGGCUGCUAAAGACAAACAUUCCAUCUAACAGAUGGCUAGGGUAACCUAAGGGAUAGUGCAACAGAAAGAAAACUACCACGCAAGUGGAAAAGGUGAAACGGCGGGGUAAAAGCCCACCAGCGAUUUUGGUAACAAUUUCGGCUAUGUAAACCCAAUGUGCAGCAAGAAGGGAUGGUUAGCGUCUUUGUUUUAACCCUUCGCUUGAUUUUGUUUGCAAAAACAAAACUAGAUAAAUGAGCAUUCAAGACAGAACUCGGCUUAUCGCUAUGCUUUUUUA,108,80,73,60,321
5433,0,CP001154.1/3111469-3111873,GAAGUCAGCCGGACAGCCGCCGCCCGCUUGCGGGGGGAGGAAAGUCCGGGCUCCGCAGAGCAGGAUGCCGGCUAACGGCCGGGCGUCGCGAGGCGACGGAAAGUGGAACAGAGAGCAGAACCGCCGAUGGCCGGGGCAACCCGGCACAGGCAAGGGUGAAAAGGUGGACUCCUUCACGGAGCCGCCGGGUGCAAACCCGGCGCGGUAAGAGCGCACCGCGGACGUGGCAACACGGACGGCAGGCUAAACCCCAUCCGGAGCAAGACCAAACAGGGGGCAUUGACGUGGCUCGCGUCGUCCCCGGGUAGGUUGCUGGAGCGCACGGGUAACCGUGCGCCUAGAGGAAUGGCUGUCUGAGGUGGCAACACCCGAACACAGAACCCGGCUUACAGGCUGACUUCACCC,92,43,148,122,405
5434,0,CP000792.1/844958-845284,CUGGCACGGUAAGCGGUCGCUUUUGCAUCUUGCAAAAGAGGAAAGUCCGAGCUGCGAUAAGACAAAGUUCCAUCUAACGGAUGGCUAGGGAAACCUAAGGGAUAGUGUAACAGAAAGCAAACUUCCGCCUUGGCGGUAAAGGUGAAAUGGCGGGGUAAGAGCCCACCGGCACGCUUGGUAACUUGCGUGGCCAUAUAAACCCAACUUGCAGUAAGAAGGGAUGGUUUUGGUCUUAUAUUAAAACCCUUCGCUAGAGCUUGUUUGUAAAAGCAAGCGUAGAUAAAUGAUCGCUCAAGACAGAACUCGGCUUAACGCCGUGCCUCCCUU,95,74,87,71,327
5435,0,CP000111.1/1585720-1586099,GAAAGCAGGAGAGGCAAUCGCAAAAAAGUUUUAUUUUGUUUCCAAAAUAAAACUUUUUUGAGGAAAGUCCGGGCUCCCACAUGGUCAGGCUUGCUGGGUAAUACCCAGUGCGGGUAACCGUGAGGAUAGUGCCACAGAAACAUACCGCCUAAUACUUUAUGUAUGGCAAGGGUGCAAGGGUGCGGUAAGAGCGCACCAGCAACAUUGAGAAGUGUUGGCUAGGUAAACCCCGGCAGGGAGCAAGGCUUAGUAGAUUUAUGACCAUUACACAAUCUACUUUUAAGCGCCGCUUGAGACUGUGAAGUAAUUCCAGCCCUAGAUAGAUGAUUGUCCAUCUGAAUUAAGAUGAACAGAACCCGGCUUAUGACCUGCUUUCUAAU,114,94,95,77,380
5436,0,CP001344.1/3702833-3702450,AGAGUAGGCGAGGUGGUUGCGGAUUUGUCUAAGCGAUAAAUCUGAGGAAAGUCCGGGCUUCCGAAAGACCAGACUUGCUGGAUAACGCCCAGUGCGAGCGAUCGUGAGGAUAGUGCCACAGAAAAAUACCGCCGAUGGGGCCUUUCUCACAGAUAAGGGCUCACAGGUAAGGGUGCAAAGGUGUGGUAAGAGCGCACCAGCAGUAUCGUGAGGUACUGGCUCGGUAAACCCCGGUCGGAAGCAAGGUUGAAGGGACAAGGGUUGGUCUUUUUCCUGUCCCGCGUUUGAAACCGCUAGAGGCAUCUGGUAACAGUUGUCCCAGAUAGAUAACCGCCCUGCUGGUCCGCCAGUGGAACAGAACCCGGCUUAUGUCCUGCUCUUUCC,94,82,118,90,384
5437,0,CP000048.1/758113-758459,GUUGAUAUCCAGUCAUCGCUUAAUAUGCUGCAUUGAAGUAUUUUAAGAGGAAAGUCCGAGCUCCAAUAAGAGUAUAAUGCUAGGUAAUGCCUAGGAGUUUAAAACUUAAGAGAGUGUCACAGAAAAUUACCGCCUUAGGGUAAGGGUGAAAAGGUGAGGUAAGAGCUCACCGCUUAUUUAGUGAUAAAUAAGGUCAAGAUAAACCUCAUUAGGAGCAAAAUCAAAUAAGCAAGCUUCCUUAGCUCUUGAGGGUAUGCUUGCGGGUGGAUUGCAUGAUUUUUUCAGUGAUGAAAAAACAAGAUAGAUGAUGACAUAAUACAGAACUCGGCUUAUGGAUAUCAACUUAA,121,95,80,51,347
5438,0,BA000019.2/4950808-4950360,GAGAGUAGGCGUUGGCGGUUGCAGACCAGUUAGCUUAACUGAUUUGAGGAAAGUCCGGACUCCCGAAAGACCAGACUUGCUGGAUAACGUCCAGUGCGAGCGAUCGUGAGGAUAGUGCCACAGAAAAAUACCGCCAAGAUUGGGGACUGGGGACUAGGGGUUGGGGACUGGGGAAGAAACUUCCCAAUCCCUAAUCCCCCAUACCCAAUACCCAACUCUUGGUAAGGGUGCAAAGGUGCGGUAAGAGCGCACCAGCAGUAUCGAGAGGUACUGGCUCGGUAAACCCCGGUUGGGAGCAAGGCCGAAGGAACUAUGGUUGGUCUUUUACCAGUUCCGCUAUCAGAGAGCCGCUAGAGGCGUUUGGUAACAAACGUCCCAGAUAGAUAAUCGCCCUCGUGUAAAGCAAUUUACACAGAGAACAGAACCCGGCUUACCACCAACUCUCUCCU,124,89,126,110,449
5439,0,CP001291.1/2949667-2949299,AGAGUUGGCGAGGGGGUUGCGGAUUCGUUUUAAGCGACGAAUCUGAGGAAAGUCCGGGCUCCCGAAAGACCAAACUUGCUGGAUAACGCCCAGUGUACGCGAGUGCGAGGAGAGUGCCACAGAAACAUACCGCCUUUUUUAGGUAAGGGUGCAAAGGUGCGGUAAGAGCGCACCAGCAGUAUCGUGAGGUACUGGCUCGGUAAACCCCGGUUGGGAGCAAGGUCGGAGGGACUAAGGUUGGUCUUUUCCCCGUCCCGUUUUAGGUGAACCGCAAGAGGUGUUUGGUAACAAACAUCCCAGAUAGAUAACUCCCCUCAUCGAUGGCAACAUCUAUGAAGAACAGAACCCGGCUUAUGUCCAACUCUCUCC,95,79,108,87,369
5440,0,CP000951.1/518444-518058,AGAGUUAGCGCGGCAGUUGCAGGGUUGACAUUGAGAUCAGCUCUGAGGAAAGUCCGGGCUCCCCAAAGACCAAACUUGCUGGGUAACGCCCAGUGCGCGUGAGCGUGAGGAUAGUGCCACAGAAACAUACCGCCGAAGCUUAGCAUUAGGUUCGCCUAAUCUAUCUGGUAAGGGUGCAAAGGUGCGGUAAGAGCGCACCAGCAGUAUCGUGAGGUGCUGGCUCGGUAAACCCCGGUUGGGAGCAAGGACGGUGGGAUGAUGGUUGGUCUUUUUCCGAUCCCAUAAUUUGGAGUGCCGCUGGAGGUGGCUGGUAACAGUCAUCCUAGAUAGAUAACUGCCCUUUUGCGCUGCAAGAGAACAGAACCCGGCUUAUGUCUAACUCUCCUG,92,87,119,89,387
5441,0,CP000393.1/3464219-3463800,AAAAGUAGAAGAGGCAGUUGCGGACUCAAUACUUAUUUAGGGUCUGAGGAAAGUCCGGGCUCCCAAAAGACCAAGCCUGCUGGAUAACGCCCAGUGCGAGUGAUCGUGAGGAUAGUGCCACAGAAAAAUACCGCCAAAGUAGAUUAAUUAUUAUUGUUUAGUCACUUCAGGUAAGGGUGCAAAGGUGCGGUAAGAGCGCACCAGCAGUGUCGUGAGAUACUGGCUCGGUAAACCCCGGCGGGGAGCAAGGUCGAAGGAACAAUGGUUGGUCUUUUUCCGGUUCCAUUGCAUUAUAGAUUUAUUUGUAAUGUUUGGUGUACCGCAAGAGGUGUCUGGUAACAGGCAUCCCAGAUAGAUAACUGCCCUCAAAGCUUGUUUGAGUUGAGAGAACAGAACCCGGCUUACUUCCUACUUUUUCCU,116,107,113,84,420
5442,0,AM406670.1/935235-935677,GAAGUUCGCCAGGCAGUCGCUGCGUGCCAUGUGUGCGUGGAGGAAAGUCCGGGCCCCGCAGAGCAGGAUGCCGGCUAACGGCCGGGCGCCGUGAGGCGACGGAAAGUGCAACAGAGAGCAGACCGCCGAUGGCUCUUGUCGAGGAGUUCGCUCUUCGCGGAGCACAGGUAAGGGUGAAACGGUGCGGUGACGCGCGCAAGCGCGGCGCCGGUCGGAGCGCAAGCUUCGGCGGGUAAGAGCCCACCGCAGGACUGGCAACAGGACUGGCACGGUAAACCCCAUCCGGGGCAAGGCCAAAUAGGGGAGCAUUGGCGUGGCUCGCGUCGCUCCCGGGUAGGCUGCUAGAGCGCCGCGGUAACGCGGCCCCCAGAGGAAUGACUGCCCGGCGACUGCGGCUUGCCGCGGUCGUUCGACAGAACCCGGCUUAUCGGCGAACUUCCCAA,87,60,165,131,443
5443,0,CP000932.1/724342-724668,CAAACAUAGCAAAUGAUCGCUUCAUUUUUUGAAGAGGAAAGUCCGAGCUGCAAUAGGACAAAGAUUCCAUCUAAUGGAUGGCUAGGGUGACCUAAGGGAAAGUGCAACAGAAAGAAAACUACCAUAUUUUAUAUGGAAAAGGUGAAACGGUAGAGUAAGAGCCUACCAGUAGCUUUGGUAACAAAGCUAGCUAUGUAAACCCAAUCUGCAGCAAGAAGGGGUGGUUUUUGUCUUAUAAUAUAACCCUUCGCUUGAGUUUGUUUGCAAAAACAAAAUUAGAUAAAUGAUCAUUCAAGACAAAACUCGGCUUAUAGCUAUGUUUUACUU,117,88,69,53,327
5444,0,BX571658.1/53597-53272,AGGGCGUGGCGGACGGUUGCUUCUGCUCCAAGAAGAGGAAAGUCCGAGCUGCAUUGAGACAGGGUUCCAUCUAACGGAUGGCUAUCGUAAGAUAAGGGAAAGUGCAACAGAGAAGAGACCGCCGAGUCAUCGGUAAGGGUGAAACGGAGGUGUAAGAGACCCCCGGAGUCCUAGCAAUAGGAGUCGCAUGGUAAACCCAACCCGCAGCAAGAAGGAUCUGGUUAAAGUCUCAAAACUUCGAAUCCUUCGCUUUAUCGCUAUUGUGAAAUAGUCGAAUAGAUGAAUAGCCGUCAUAACAGAACUCGGCUUACGGCCACGCCCCUCUC,96,64,91,75,326
5445,0,CP000805.1/532010-532352,ACAGAGAACUGCAGAUAGUCGCUGCGGGUUUCUCGCAGAGGAAAGUCCGGACUCCUUCGGAAAUGAUGCUAGUUAAUUACUAGGCAGCGGCUCUCUGCAGUGCCGCUGACAGCAAGCGCCACAGAAAAUAUACCGCCUUUGGGUAAGGGUGAAAGGGCGAGGUAAGAGCUCACCGCGUUUUGGCGACAAAACGGCACGGCAAGCCUCAUCAGGAGCAAGAUCGAGCAGCAAAGGAUAUUCCGAUCCUGUUUUGCGGGUUGAUUGCAUAAAUUUAUAUAGCGAUAUAUAAAGUGAGACAGAUGAUUAUCCUUGACAGAAUCCGGCUUACCAGUUCUCUGUUUUU,95,82,92,74,343
5446,0,CP000435.1/208346-207956,AAAGUAGGCGAGGUGAUCGCAAUCGAUGGUUGUUGCCUUCGGGCUGCAGUCAUCGGUUGAGGAAAGUCCGGGCUCCCCGAUGGCCAGGCUUGCUGGGUAACGCCCAGUGCGGGUGACCGUGAGGAGAGUGCCACAGAAACACACCGCCGAUGGCCGGUUCCGCCGGCACAGGCAAGGGUGCAAAGGUGCGGUAAGAGCGCACCAGCAGCAUCGAGAGGUGCUGGCUCGGUAAACCCCGGCUGGGAGCAAGGCCUAGGAACGACGGGUGGCCAUCUUCCCCGUUCCGUCUUUGUGCGCCGCUCGAGGUCGUCGGUAACGGCGAUCCCAGAUAGAUGAUCACCCCCCUUCCUUGGAAGGGUGAACAGAACCCGGCUUAUGUCCUGCUUUCAAC,79,72,130,110,391
5447,0,CP000815.1/542171-541778,GAAAGCAGGCGAGGUGAUCGCGACCAGACUUUGUUCUGGUUGAGGAAAGUCCGGCCUCCUUAAUGACCAGGCUUGCUGGGUAAUACCCAGUGCGGGUAACCGUGAGGAAAGUGCCACAGAAACAUACCGCCAAUGACCUCGGGAAUUUUUCCAAGGUACAGGCAAGGGUGCAAAGGUGUGGUAAGAGCACACCAGCAAUAUCGAGAGAUAUUGACUUGGUAAACCCCAGCCAGGAGUAAGGCCUAGGGACAACGGUUGGUCCAUUUCCCUGUUCCGCUUUUGAGUGCCGCUUGAGAUUGUUGGUAACAGCAGUUCCAGAUAGAUGAUUACCCACUUCCUCUGAAUCUUCGUCAGUGGUAGUGAACAGAAUCCGGCUUACGUCCUGCUUUCAGAC,101,93,108,92,394
5448,0,CP000090.1/512222-512564,AAAGCAGGCCAGACAAUCGCUGCUUGCAUCGCAAGGUGCAAGGGGAGGAAAGUCCGGACUCCACAGGGCAGGGUGUUGGCUAACAGCCAUCCACGGUAACGUGCGGAAUAGGGCCACAGAGACGAGUCUUGCCGCCAGGUUCGCCUGGCGGGAAGGGUGAAACGCGGUAACCUCCACCUGGAGCAAUCCCAAAUAGGCAGGCAUCGAGGCGGCCCGCUGAGCCUGCGGGUAGGGAGCUGGAGCCGGCUGGUAACAGCCGGCCUAGAGGAAUGGUUGUCACGCGCCGCCGUGCCGCAAGGUGCGGUGACGUGCACAGAAUCCGGCUUAUCGGCCUGCUUUGCGC,75,52,121,95,343
5449,0,CP000361.1/1308271-1307950,UAGGUAAACCAGACAAUAGCUUGAAAUUUCAAGAGGAAAGUCCGGGCUGCAGUGAAGUGUGGUUCCAUUUAAAUAAUGGCUAGAGUAAUCUAAGGGAUAGUGCAACAGAGAGUAGACAGCCAAUUUUUUUGGUGAUGGUGAAACGGUAAGGUAAGAGCUUACCAGCAAAUUGAGUAAUCUUUUUGGCUUUGUAAACCCAACUUGCAGCAAGAAGACUAGGUAAUUACUUCACAUUUUUGGUCUUCGCAGGAGUACUAAAGUAAUUUAGUACCUAGAUAAAUUAUUGUCUUUGACAGAACGCGGCUUACGGUUUACCUAACUU,103,95,74,50,322
5450,0,CP000352.1/435682-436022,AAAGCAGGCCAGACAAUCGCUGCUUGCAUCGCAAGGUGCAAGGGGAGGAAAGUCCGGACUCCACAGGGCAGGGUGUUGGCUAACAGCCAUCCACGGUAACGUGCGGAAUAGGGCCACAGAGACGAGUCUUGCCGCUGGCUUCGGCUGGCGGGAAGGGUGAAACGCGGUAACCUCCACCUGGAGCAAUCCCAAAUAGGCAGACGAUGAAGCGGCCCGCCGAGUCUGCGGGUAGGGAGCUGGAGCCGGCCGGUAACGGUCGGCCUAGAGGAAUGGUUGUCACGUUCCGGGCGCCGCAAGGCGUGCGGGGCGCACAGAAUCCGGCUUAUCGGCCUGCUUUGCUU,74,54,122,91,341
5451,0,CP000767.1/1120671-1120353,UCGGCACGGUAAGUGAUCACUUGAAAAAGAGGAAAGUCCGAGCUGCGAUAAGACGAAGUUCCAUCUAACGGAUGGCUAGGGCAACCUAAGGGAAAGUGUAACAGAAAGCAAACAGCCGCUAAACGCGGUAAAGGUGAAACGGCGGGGUAAGAGCCCACCAGCGCGCUUGGCAACUCGCGCGGCUUUAUAAACCCAACUUGCAGCAAGAAGGGACGGUUUUAGUCUUAUAUUUAAACCCUUCGCUAGAGCUAAAUUGUAAAAUUUAGAGUAGAUAAAUGAUCACUCACGACAGAACUCGGCUUAUCGCCGUGCCUUAAUU,103,66,81,69,319
5452,0,AE015925.1/236348-235953,CGGAAGAGAAAGGCAACCGCUUUUUAUAUCUCUAGUUAGGUAUACUGAGAGGAAAGUCUGGACUUCAUAAGAAGAGAUACUGGAGAAACUCCAGGGGCCGUAAGGCUACGGAAAGUGCAACAGAAAACACUCCGCUAUAAAAGGGUCUUUUUAUAGACAGGCUGAAAAUUCCUACUUUAAGAGUAGGAGCUAUUAAGGUGACUUAAUAGACAUGCAAACCCUAUCUGAAGCAAGAGAAAAAGUUUUUGUUUCUGCAUAGUGAGGGAUAGUAUUCCUCAUAAACUUUUUCAUAAUCGCUUGAGGGGUAUAGUAAUAUGCCCCCUAGAUGAAUGGUUGCCCUCAAGAUGGUCUUUUCCAUCUUGUAGACAGAAUCCGGCUUACUCUCUCUUCCGAUAU,124,111,88,73,396
5453,0,CP000828.1/1701275-1701688,AAGAGUAGGAGUAGGUGGUUGCGGACUUGAGAUCGCAAGUCUGAGGAAAGUCCGGGCUCUCGAAAGGCCAGACUUGCUGGGUAACGCCCAGUGCGGGUGACCGUGAGGAGAGUGCCACAGAAACAUACCGCCGAUGGCUUGUUUCGCUACAGGAUAGCCAAACAUUCACAGGUAAGGGUGCAAGGGUGCGGUAAGAGCGCACCAGCAACGUCGAGAGGCGUUGGCUCGGUAAACCCCGGUGGAGAGCAAGGCAGAGGGCAACGGUUGGUCUUUUCCCCGCUCUCGUUUGUAGCGCCGCUUGAGGCGUCUGGUAACAGGCGUCCCAGAUAGAUAACUACCCUCUUUCGACCAAUCCUGGGCCAAUGUCCGGGUGGAGAAAGAGAACAGAACCCGGCUUACCGCCUGCUCUUCCCU,97,80,132,105,414
5454,0,CP000269.1/3436150-3435828,GAAGUAAGCCAAGACAACCGCUGGCUGUCAUUUCGGUGAUGGCGGGAGGAAGGUCCGGACUCCAUAGAGCAGGGUGACGGUUAACGGCCGUCCGCCGUGAGGCGAGGAAUAGGGCCACAGAGACGAGCGUAUUAAGUUACGGUGAAACGCGGUAACCUCCACUCGGAGCAAUUCCAAAUAGGCACGCGUUGACGUUGCUCGCGGAGCGUGCGGGUAGGAAGCUUGAGCCGUGGAGUAAUUCACGGCCUAGAGGAAUGGUUGUCAUAACGCGUGGGUUCGCCCAUGCGUCGUAACAGAAUCCGGCCUAUCGGCUUGCUUCAACU,76,63,107,77,323
5455,0,CR848038.1/237165-236768,CGGAAGAGAAAGGCAACCGCUUUUUGUACCUUAACUAAGGUAGAUUAAGAGGAAAGUCUGGACUUCAUAAGAAAAGAUACUGGAGAAACUCCAGGGGCCGUAAGGCUACGGAAAGUGCAACAGAAAACAUUCCGCUAUAAAAGGGUCUUUUUAUAGACAGGCUGAAAAUUCCUAUUUUAAGAAUAGGAGCUAUUAAGGUGACUUAGUAGACAUGCAAACCCUAUCUGAAGCAAGAGAAAAAGUUUUUGUUUCUGCAUAAUGAGAGGGAGGGUAUCCCUCAUGAACUUUUUCAUAAUCGCUUGAGGGAUAUAGUAAUAUAUCCCCUAGAUGAAUGGUUGCCCUCAAGAUGAGUUUUCUCAUCUUGUAGACAGAAUCCAGCUUACCCUCUCUUCCGAUAU,131,109,87,71,398
5456,0,CR931997.1/806240-806707,CGAGACGGCCGGGCGAUCGCGGCGCACGGAACCACCCUGUACACGGGGCAGGCCGGGCGCGGAGGAAAGUCCGGACUCCACAGGGCAACGGUGGUUGCUAACAGCAACCCGGGGCGACCCGCGGGAACAGUGCCACAGAAAACAAACCGCCCGCCACGCGCGGGUAAGGGUGAAAAGGUGCGGUAAGAGCGCACCAGCACCCCAGGCGACUGGGGUGGCUAGGUAAACCCCACCGGGAGCAAGGUCAAGGUGCCCGCACGCACGCCAUCCCAGAUGGUGCACCAGCGUGCGGCGUAGCUCUAGGGCUGCCCGCCCAACAAUGAGCAGGUAGGCCGCUUGAAGCCACCAGCAAUGGUGGGCUCAGAUGGAUGAUCGCCUCGUCCCACGCCUUCUUCGCGUGCCCCUCGCGGGCGCUGCGGAAAUGGACGGGGGAUAGGACAGAAUCCGGCUCAUAGGCCGUCUCGGCGC,101,54,163,150,468
5457,0,AM942444.1/1533990-1533532,CGAGGCGGCCGGGUGGCUGCGGCGCGGUGGAACCACCGGCCGGUGUUAUGCCGGCGGGUCAGGCCCCGUGUCGAGGAAAGUCCGGACUCCACAGAGCACAGUGGUUGCUAACGGCAACCCAGGGUGACCUGCGGGCAAGUGCAACAGAAAGUAGACCGCCCGCCCACCGUUUUUCGCGGUGUGCGGCGGGUGAGGGUGAAAGGGUGCGGUAAGAGCGCACCAGCGUGGCAGGCGACUGUCGCGGCUAGGUAAACCCCACUGGGAGCAAGGUCAAGGAGCCGCACGGCCCCGCCCGUCGCAGGGCGGGGCGGGCGGCGUUGUCUGAGGGCUGCUCGCCCGAUGAAGGACAGGUGGACUGCUUGAGGCGCCCAGCAAUGGUGCGUCCAGAUGGAUGGUCACCUCGUGCCACCCCUCGUGGGUGGCAUCAGACAGAAUCCGGCUUAGAGGCCGCCUCGACAC,83,66,175,135,459
5458,0,AJ012174.2/7-392,GAGUAAGGCAACCGCUGUUUAUAUUUCUCAAAAAAUAUAAAGAGAGGAAAGUCUGGACUUCAUAAGAGAAGAUACUGGAGAAAUUCCAGGGGCCGUAAGGCUACGGAAAGUGCAACAGAAAACACUCCGCUAUAAAAUUUAUUUUAUAGACAGGCUGAAAAUUCCUACUUUAGGAGUAGGAGCCAUUAAGGUGACUUAAUAGGCAUGCAAACCCUAUCUGAAGCAAGAGAAAAAAGCUUUUUGUGUCUGCAAAUGUGAGAGGAAUUCCUCCCAUAGGCUUUUUCGAAAUCGCUUGAGGGAUCUAGUAAUAGCUCCCCUAGAUGAAUGGUUGCCCUUAGGAUAGUUCGCAAGAGCUAUCUUAUAGACAGAAYCCGGCUUACUCGCUC,128,99,87,71,386
5459,0,CP000879.1/813666-813996,GAAGUAGGACGGUUGAUCGCGAGUAGGCAUACUUGGGCCUAUUUUGAGGAAAGUCCGGACUCUAAGGGCAAGAUACUGGUUAACAACCAGAGGGAGUGAUCCCUGAAUAGGGCCAUAGAAAAGAAAACCGCCGAAAGGCAAGGGUGGAACGGUGAGGUAAGAGCUCACCAGUGUCAGAGCGAUCUGGCAGCUUGGUAACCUCUAUCUUGAGCAAGGUCAAACAAGAAGGCCAGAGGUUGCCCGCCGAGAGACUUUAGUGUCCGCCUUCUGGGUAGACCGCGUAGAUUAAUGGUUAACUUUACAGAAUCCGGCUUAUAGUCCUACUGAUAUA,96,71,97,67,331
5460,0,CP001100.1/2524217-2524610,GGCUGUAUCUUGGCAAUCGCUGUAUUGCAUAGGCAAUGCAGAGGAAAGUCCGAACAUCAUAGGGCAGGGUGCCGGACAAGAUGUUUCAUCAAGUUCGGGCAAAAAGGCUGAAGAGCCUUUUUGACAGAAAGUGCAACAGAAAGCAAACCGCCAUUCCGUUGGAAUUGGUAAGGGUGAAACGGUGGUGUAAGAGACCACCAGGCAAUGUGGUAACACGUUGUGCUCGGUAAACCUCCCCGGUGCAAGGCUAAGUAAGAAAGCUUCCUUUUGGGAAAGAGCUGCCCGCUCAAUUUACUUCGGUAAAAGUUUUCGGGUGAGCCGCAUUAGAUAAAUGGUUGCCGACUGCUUCAUUAUUGAAGUAGUACAGAAUUCGGCUUAAAAGAUGCAGCUUUGC,113,95,109,77,394
5461,0,CP001108.1/1643311-1643713,AUACCACAGUGUGCAGUCGCUGUUUACCAUUGCUGGUAGACAGAGGAAAGUCCGAACAUCACAGGACAGGGUGCCGGCCGAGAGCUCUGCUCAAGUCCGGGAGUACAGGACUGAAAACCUGUACUACAGAUAGUGCAACAGAAAACAGACCGCUCCGGAAUUCCGGAGUAAGGGUGAAACGGUGGUGUAAGAGACCACCAGAUGCGUCAGUAAUGGCGCAUGCUUGGCAAACCUCCCCGAUGCAAGGCUAAAUAGGGCAGCUUUUCCAAAAAGGAAAAAGAGCGGUCCGUUCAAUUCUGAACAGAGAGUUGCCGGGUGAGCCGCAUCAGAUAAAUGACUGCAACUCUCCUCCGGUCACGACCGGAAGAGAGAACAGAAUUCGGCUUACAUCUGCGGUAUCGGC,119,74,113,97,403
5462,0,AJ012172.2/7-388,GAGUAAGGCAACCGCUUUUUAUAUCUCUAGUUAGGUAUACUGAGAGGAAAGUCUGGACUUCAUAAGAAGAGAUACUGGAGAAACUCCAGGGGCCGUAAGGCUACGGAAAGUGCAACAGAAAACACUCCGCUAUAAAAGGGUCUUUUUAUAGACAGGCUGAAAAUUCCUACUUUAAGAGUAGGAGCUAUUAAGGUGACUUAAUAGACAUGCAAACCCUAUCUGAAGCAAGAGAAAAAGUUUUUGUUUCUGCAUAGUGAGGGAUAGUAUUCCUCAUAAACUUUUUCAUAAUCGCUUGAGGGGUAUAGUAAUAUGCCCCCUAGAUGAAUGGUUGCCCUCAAGAUGGUCUUUUCCAUCUUGUAGACAGAAYCCGGCUUACUCGCUC,119,106,86,70,382
5463,0,AJ012171.2/7-376,GAGUAAGGCAACCGCUUCCUGUAUCUCUAGUAGAUAUGGUAAGAGGAAAGUCUGGACUUCAUAAGAAGAGAUACUGGAGAAACUCCAGGGGCCGUAAGGCUACGGAAAGUGCAACAGAAAACACUCCGCUAUAAUAUAGACAGGCUGAAAAUUCCUACUUUAAGAGUAGGAGCUAUUAAGGUGACUUAAUAGACGUGCAAACCCUAUCUGAAGCAAGAGAAAAAGUUUUUGUUUCUGCAUAAUGAGGAGCUCUGUUCCUCAUAAACUUUUUCACAAUCGCUUGAGGGAUAUAGUAAUAUAUCCCCUAGAUGAAUGGUUGCCCUCAAGAUGGUCUUUGCCAUCUUGUAGACAGAAYCCGGCUUACUCGCUC,117,97,83,72,370
5464,0,AJ012177.2/7-395,GAGUAAGGCAACCGCUGAGCCAGUUUUAGAAAAACUGCGUAUCAGAGGAAAGUCCGGACUUCGUAAGAAAAGAUGCUGGAGAAAUUCCAGGGGCCGUAAGGCUACGGAAAGUGCAACAGAAAACAUUCCGCUAUAAAUGAUAUCAUUUAUAGACAGGCUGAAAAAUCCUACUUUAGGAGUAGGAGCUGCUAGGGAGACCUGGUAGACUUGUAAACCCCAUCUGAAGCAAGAGAAAAAGUUAUUUGUCUCUGCAAAAUCCUUUCUAAUGAAAGGCAUAAACUUUUUCAUAAUCGCUUGAGGAGUACAGUAAUGUGCUCCCUAGAUGAAUGGUUGCCCACAAGUAAGAAUUUCUUAUUCGUACUUGUUGACAGAAYCCGGCUUACUCGCUC,127,98,89,74,389
5465,0,CP001013.1/621331-621659,GAAGCAAGCCAGACCGCCGCUGGUGCCGGAUCCGAAAGGUGGCACUGGAGGAAGGUCCGGACUGCACAGAGCAGCGUAGGAGGUAACACCUCUCCACCGCGAGGUGCGGAUCAGAGCAACAGAGACGAGCCGGUUCAGUCCGGGUGAAACGGGCAAUCUCUACGCGCAGCAACACCAAAUAGGCCAGCAUUGAAGCGGCUCGCUGAGCUGGCGGGUAGGUGGCAUCGAGCCGGGUGGGCGACCCCCGGCCCAGAGGAAUGGCGGUCACGGCGGGGGGUCUUUCGGGAUCGUCUGCUGCACAGAAUCCGGCCUAUCGGCUUGCUUCACAC,72,47,116,94,329
5466,0,CP000539.1/3943608-3943267,GAAGCACGCCAGACCGCCGCUGGUGCAAUCUGGGAAACCAGGCACUGGAGGAACGUCCGGACUGCACAGGACAGCGUAGCAGCUAACGGCUGCCCACCGUGAGGUGAGGAUCAGAGCAACAGAGACGAGUCCCGGGGGAGUGCCUGCGAAGGCAGACCACUGGGGGUGAAACGGGCAAUCUCUACGCGCAGCAAUACCAAGUAGGCCAGCGUUGACGUGGUUCCGCGGAGCUGGCGGGUAGGUAGCACCGAGCCGUGGUGGUGACACCCGGCCCAGAUUAAUGGCGGUCACGCUGCGGGCAACCGCAGUGCACAGAAUCCGGCUUAUCGGCGCGCUUCACAC,79,46,119,98,342
5467,0,CP000884.1/1619737-1620169,GAAGCACGCCAGACCGCCGCUGGUGCAAUCGUGGAAACACGGCACUGGAGGAACGUCCGGACUGCACAGGGCAGCGUAGCAGCUAACGGCUGUCCACCGUGAGGUGAGGAUCAGAGCAACAGAGACGAGUCGGGGACAUGUGCCGCCAACUUGGUGUUCUAUGGGGUGCCAGCGCAAGCUGGCGACGGAUGGCGCAAGCCAGACGCCCAGGCGAAAGCCUGGGCCCCAUAGCCACCCGGGGACGCGGAACGCGUCCCCGGGUGAAACGGGCAAUCUCUACGCGCAGCAAUACCAAGUAGGCACACGUUGACGGGGCCCCCGGAGUGUGCGGGUAGGUAGCACCGAGCCGGGCGGCGACGCCCGGCCCAGAUUAAUGGCGGUCACAUGCGGGCAACCGCGUGCACAGAAUCCGGCUUAUCGGCGCGCUUCACAC,96,54,151,132,433
5468,0,AM902716.1/765617-766031,AAGACAGGCCGGGCAAUCGCGGUGGAUGCAAAUCCGUCGAGGAAGGUCCGGACUCCACAGGGCAGGGUAGCGGCUAACGGCCGUCCGGCCGUGCCGGCAGGCUUGCCUGCAGGCACGACCGAGGAACAGGGCCACAGAGACGAGUCUGCGGGGCGGGCGCGCCAGUCGCGCACCGGCACGGCCAUCUCCGUGCCGCGCGGUCCGGCAACGGGCGGCGGCAUCGCAGGGUGAAACGCGGCAACCUCUAUCCGGAGCAACACCAAAUAGGCAUGUGUGGGCCCCUGGGCCCGAAGGGCGGCCCGCCCGAGCAUGCGGGUAGGUGGCUACAGCGGUCCAGCAAUGGCCCGCGCAGAGGAAUGAUUGCCCGCCGGGUUCGCCCGGCGUACAGAAUCCGGCCUACAGGCCUGUCUUGCAA,79,49,153,134,415
5469,0,CP002156.1/1932954-1933325,UCAGAUGGCCGGACGGCCGCAGGUCCUACCUGAGGAAAGUCCGGGCUCCCUGGCGGCAGGGUGCCGGGUAACCCCCGGCCGGAGCGAUCCGAGGGAAAGCGCCACAGAGAUCGAACCGCCUCGGUCCGCCGAGGUAAGGGUGAAAAGGUGCGGUAAGAGCGCACCGCCGCAUCGGCAACGCUGCGGGCAUGGCAAGCCCCACCUGGAGCAAAACCGAAUAGGGAUGGGAGGGGCCCUUGGGCCCGGGGGCGCCGCCACCCCUUACCCAUCCGGGUUGGUUGCUUGAGGCCGCCCGCAAGGGCGCGUCCCAGAUGAAUGGUCGUCCUCCGCCACGGCAGAGACAGAACCCGGCUUACGCGGCCGUCUGACACU,72,46,132,122,372
5470,0,CP001103.2/922253-922603,GGAGUUGGCCAGGCAAUCGCCGCUUUCGUAAGAAAGGGGAGGAAAGUCCGGGCUCCAAAGGGCAGGGUGCCAGAUAACGUCUGGGCGGCGUGAGCCGACGACAAGUGCAGCAGAGAGAAGACCGCCUAAGCAUGUUUACAUGCCGGUAAGGGUGAAAGGGUGCGGUAAGAGCGCACCGCACCUCUGGUAACAGAGUGUGGCAAGGUAAACUCCACCCGGAGCAAGACCAAAUAGGAUCCCUCAACGUGUGGCCCGCAUGGGGAUCGGGUAGGUUGCUUGAAUCAGUGAGCGAUUGCUGAUCUAGAGGAAUGGUUGCCCACGACAGAACCCGGCUUACGGCCAACUCCACUC,91,58,116,86,351
5471,0,CP000613.2/663266-662837,CCAGACGGCCGGAUGGCCGCCCUCCGGCAACGGGGAAACCCGCCGGGGGGAGGAAAGUCCGGGCUCCACGGAAGCACGGUGCCGGGUAACGCCCGGCGGGGGCGACCCCAGGGAAAGUGCCACAGAAAGCAAACCGCCCAUGAUCCCCGCCUCCGGGUGGGACGGCAUGGGCAAGGGUGAAAGGGUGCGGUAAGAGCGCACCGCGCCCCCGGCGACGGGGGUGGCAUGGUAAACCCCACCGGGAGCAAGACCGAAUAGGGGUGGCACGGCCGGGAAACCGGCCGAAGCGCGCUUCCGCGCAGCCGCCCGGGUGGGUCGCGUGAGGCGUCCGGCAACGGGCGUCCCAGAGGAAUGGCCAUCCCCCGGAUACCGUCCAGCCCGCUGGAUACGGUCCGGCGGACAGAACCCGGCUUACAGGCCGUCUGGCGUC,83,39,165,143,430
5472,0,AE008692.2/1079883-1079512,CCAGAAGGUCGGGCGGCCGCCGGUAUGUUUUUGACAUACGGGAGGAAAGUCCGGGCUCCAAGGAGUAACGGUGCCGGAUAACAUCCGGCGAGGGUGACCUCAGGGAAAGUGCCACAGAAAACAAACCGCUUUUUACUUCGGUAAUAAAGUAAGGAUGAAAAGGUGCGGUAAGAGCGCACCGCAUUUCCGGUAACGGCAAUGGCAAGGUAAACCCCACCGGGAGCAAAACCGAAUAGGGAUGGCAUAUGGGCUGGCUCCGCCCCGUCAUCCGGGUUGGUUGCUGAAGACCGGAAGCAAUUCCGGUUUUAGAUGAAUGGUCGCCUAUCCAGCUUUGCUGGUGGACAGAACCCGGCUUAUAGACCUUCUGGCGUA,96,73,115,88,372
5473,0,URS0000D6B57B_12908/1-35,UUGGGAGAUUCCGAAAACCCUUAAGAGAGUAGGAU,12,8,10,5,35
5474,0,URS0000D659A5_12908/1-35,UUGGGAAUUGCCGAAAACCCAUAAAAGAGUAGGCG,13,6,10,6,35
5475,0,URS0000D6C8C9_12908/1-38,AGGGAGGUAGCCCAAAAUCCCACACAACAGAGUAGGCA,15,3,10,10,38
5476,0,URS0000D664FA_313606/1-36,UCAGGGGACUCCGAAAACCUAGCAAUAGAGUAGGGA,13,5,11,7,36
5477,0,URS0000D676E9_12908/1-35,AACCAGGAUACCGAAAAUGGUGAAAAGAGUAGGUA,16,5,10,4,35
5478,0,URS0000D6B096_12908/1-35,AUGCAGGAAGCUGAAAAUGCAAAACAGAGUAAGCA,17,4,9,5,35
5479,0,URS0000D6C55D_12908/1-35,GAUGGGGUAUCCGAAAACCAUUGAAAGAGUAGGAA,14,6,11,4,35
5480,0,URS0000D68AAA_12908/1-36,ACGGCAGAUUCUGAAAAGCCGGUAACAGAGUAAGAG,14,5,11,6,36
5481,0,URS0000D664C6_12908/1-35,UUGGUGGUACCCGAAAAACCAUAAAAGAGUAGGGG,13,6,11,5,35
5482,0,URS0000D69372_12908/1-35,AAAGGGAAUGCCGAAAACCUUUAACAAAGUAGACA,17,5,7,6,35
5483,0,URS0000D6A71A_12908/1-35,UGAGCGGAAGCCGAAAAGCUCUGAUUGAGUAGGCG,10,6,13,6,35
5484,0,URS0000D69A04_12908/1-35,UGAGCGGAAGCCGAAAAGCUCUGAUCGAGUAGGCG,10,5,13,7,35
5485,0,URS0000D6622F_12908/1-35,AAAGAGGAUGUCGAAAAUCUUUAAAAGAGUAGACG,16,7,9,3,35
5486,0,URS0000D687F9_12908/1-35,UAAGGGGAUGCUGAAAACCUUGAAAAGAGUAAGCU,14,7,10,4,35
5487,0,URS0000D67C9E_12908/1-36,GAGGGGGUAUCUGAAAACCCGUAAAAAGAGUAGGAA,15,5,12,4,36
5488,0,URS0000D6B355_12908/1-36,GAGGGGUAAUCUGAAAACCCGUAAACAGAGUAGGAA,15,5,11,5,36
5489,0,URS0000D68550_743722/1-36,UAGGGCGUAACCGAAAACCCUUGAUCAGAGUAGGCA,12,6,10,8,36
5490,0,URS0000D66FEF_12908/1-36,UCGGCAUUAUCCGAAAAGCCGUAAAGAGAGUAGGAG,13,6,11,6,36
5491,0,URS0000D682EE_12908/1-37,AAGGUGGUUGUCCGAAAAACCUUGAAUAGAGUAGGGC,12,8,12,5,37
5492,0,URS0000D69E59_12908/1-37,GCAGGACAAUCCGAAAACCUGUAGAAAAGAGUAGGAA,17,4,10,6,37
5493,0,URS0000D67E00_12908/1-37,UAUGGGUAACCCGAAAACCAUAUUAAUAGAGUAGGGG,14,8,10,5,37
5494,0,URS0000D6B61B_12908/1-38,GUGGAGAAAACCGAAAAUCCAAAAUAACAGAGUAGGUA,19,5,9,5,38
5495,0,URS0000D67347_12908/1-33,UACGAGUAAUCCGAAAAUCGAUAAGAGUAGGAA,15,6,8,4,33
5496,0,URS0000D67788_12908/1-35,GAGGCGCAUACCGAAAAGCCUUAUUAGAGUAGGCA,12,6,10,7,35
5497,0,URS0000D6CACB_12908/1-32,AUCGAGGAUGCCGAAAAGCGAAAGAGUAGGCA,13,3,11,5,32
5498,0,URS0000D6A685_12908/1-36,AUCGAGAAUGCCGAAAAUCGAUUAAAAGAGUAGGCU,15,7,9,5,36
5499,0,URS0000D6C2B6_12908/1-36,AUCGAGAAUGCCGAAAAUCGAUUAAAAGAGUAGGCC,15,6,9,6,36
5500,0,URS0000D6A575_12908/1-33,AAACCGGAUGCCGAAAAGGUUAUAGAGUAGGCG,12,5,11,5,33
5501,0,URS0000D6B909_12908/1-35,UUGGGCGAAGCUGAAAACCCUUAACAGAGUAGGCA,12,6,10,7,35
5502,0,URS0000D6A645_12908/1-36,CGCGGGAAUGCCGAAAACCGUGGAAAAGAGUAGGCU,12,4,13,7,36
5503,0,URS0000D6A9A1_12908/1-35,CGCGGGAAAGCCGAAAACCGUGAAAAGAGUAGGCU,13,3,12,7,35
5504,0,URS0000D6905D_471854/1-35,GCAGGGGACGCUGAAAACCUGAAAAAGAGUAGGCU,13,4,12,6,35
5505,0,URS0000D66999_12908/1-33,GUAGGGGAUUCCGAAAACCUAUUAGAGUAGGAA,12,7,10,4,33
5506,0,URS0000D66543_12908/1-37,ACCGAGGAAAGCUGAAAAUCGGAUAAAAGAGUAGGCG,16,4,12,5,37
5507,0,URS0000D6C45A_694427/1-36,ACCGCAGCAGCCGAAAAGCGGAACAAAGAGUAGGCA,15,1,11,9,36
5508,0,URS0000D6967B_575590/1-37,UACGGGGAACCUGAAAACCGUAUUAAUAGAGUAGGGA,14,7,11,5,37
5509,0,URS0000D6A768_12908/1-36,UACGGGGAACCUGAAAACCGCAUAAUAGAGUAGGGA,14,5,11,6,36
5510,0,URS0000D6D2F9_12908/1-33,AGGGGGGUAGCCGAAAACCCUGUAGAGUAGGCA,10,4,13,6,33
5511,0,URS0000D66641_12908/1-36,AACCCGUAAGCCGAAAAGGGUAUUAUAGAGUAGGCA,14,6,10,6,36
5512,0,URS0000D67E11_12908/1-36,AUCGGGUAAGCCGAAAACCGAAUCUAAGAGUAGGCA,14,5,10,7,36
5513,0,URS0000D68CDD_12908/1-35,GAUGAGGAUGCCGAAAAUCAUAAAGAGAGUAGGCA,15,5,11,4,35
5514,0,URS0000D6BEF8_12908/1-33,AAUGAGGUUGCCGAAAAUCAUUAAGAGUAGGCA,13,7,9,4,33
5515,0,URS0000D66447_12908/1-33,UUUGGGGAUGCCGAAAACCAAAUAGAGUAGGUG,11,7,11,4,33
5516,0,URS0000D69F87_313606/1-37,AAAGCGAUUGCCGAAAAGCUGUAUAAAAGAGUAGGCA,16,6,10,5,37
5517,0,URS0000D67656_12908/1-33,AAUGGGGAUUCCGAAAACCACAGAGAGUAGGAA,14,4,10,5,33
5518,0,URS0000D68BC1_700598/1-36,AGUGGGAUUCGCCGAAAACCAUUAAAAGAGUAGGCA,14,6,10,6,36
5519,0,URS0000D6955E_12908/1-35,AAUGGAAUUUCCGAAAACCAUUAAAAGAGUAGGAA,17,7,7,4,35
5520,0,URS0000D6B5D0_12908/1-35,AAUGGAAUUUCCGAAAACCAUCAAAAGAGUAGGAA,17,6,7,5,35
5521,0,URS0000D6AA57_12908/1-35,AAUGGAGUUUCCGAAAACCAUCAAAAGAGUAGGAA,16,6,8,5,35
5522,0,URS0000D69E97_694427/1-35,ACAGCGUAACCUGAAAAGCUGCAAAAGAGUAAGGA,16,4,9,6,35
5523,0,URS0000D65EB1_12908/1-36,AAGGGGAUUGCCGAAAACCCUGCAAUAGAGUAGGCG,12,5,12,7,36
5524,0,URS0000D6CAAC_12908/1-39,CAGGGGAAUGCCGAAAACCCUUUUGCAACAGAGUAGGCG,12,6,12,9,39
5525,0,URS0000D6CB64_12908/1-36,UGCGGGUAAGCCGAAAACCGUAUCAGAGAGUAGGCA,12,5,12,7,36
5526,0,URS0000D6570F_12908/1-33,UUAGCGUAUUCCGAAAAGCUAAAAGAGUAGGGA,13,7,9,4,33
5527,0,URS0000D6722D_700598/1-37,GGCGGGGAAGCCGAAAACCGUUAAAAUAGAGUAGGCC,13,4,13,7,37
5528,0,URS0000D69EF1_12908/1-33,AAAGUGGAAGCCGAAAAACUUUACGAGUAGGCA,14,5,9,5,33
5529,0,URS0000D6BF14_12908/1-35,ACAGGGAUUGCCGAAAACCUGGGAAAGAGUAGGCG,12,4,13,6,35
5530,0,URS0000D68A4E_12908/1-35,AAAGGGGAAAUCGAAAACCUUGAAAAGAGUAGAAA,19,4,9,3,35
5531,0,URS0000D66BDB_12908/1-33,AUACCGUUAGCCGAAAAGGUAAAAGAGUAGGCA,14,5,9,5,33
5532,0,URS0000D6C871_12908/1-36,UAUAGGGUAGCCGAAAACUAUUUAAAAGAGUAGGCA,15,8,9,4,36
5533,0,URS0000D69C2C_12908/1-36,AGCGCGGCAGCCGAAAAGCGUUUAACAGAGUAGGCG,11,4,13,8,36
5534,0,URS0000D6D3EA_12908/1-35,CUGGUGUAACCCGAAAAACCACAAAAGAGUAGGGA,15,4,9,7,35
5535,0,URS0000D666D4_1189621/1-34,CUGGAGUAUCCCGAAAAUCCAUAAAGAGUAGGGA,13,6,9,6,34
5536,0,URS0000D663E4_12908/1-36,ACGCAGGAAGCCGAAAAUGCGGACAAAGAGUAGGCG,14,2,13,7,36
5537,0,URS0000D6ADAE_12908/1-35,CAGGUGGAUGCCGAAAAACCUUUAACGAGUAGGCG,11,6,11,7,35
5538,0,URS0000D66682_12908/1-34,AAGGUGGAUGCCGAAAAACCUGAAAGAGUAGGCA,14,4,11,5,34
5539,0,URS0000D69328_12908/1-35,AAGGUAGAUGCCGAAAAACCUUUAAAGAGUAGGUA,15,7,9,4,35
5540,0,URS0000D6CEAC_12908/1-36,ACGGAGUAUCCCCGAAAAUCCGGAAUAGAGUAGGGA,13,5,11,7,36
5541,0,URS0000D6943E_12908/1-35,UAAGGAGUCGCCGAAAACCUAUAAAAGAGUAGGCA,15,5,9,6,35
5542,0,URS0000D6B923_12908/1-35,UGGGAGGAGUCCGAAAAUCCCAAACAGAGUAGGAA,14,4,11,6,35
5543,0,URS0000D6897E_12908/1-35,CUGGAAUAUGCUGAAAAUCCUAAAAAGAGUAGGCA,15,7,8,5,35
5544,0,URS0000D6789F_12908/1-36,ACGGAGGUUCCGAAAAUCCAAUAAACAGAGUAGGAA,16,5,9,6,36
5545,0,URS0000D6CC55_12908/1-36,ACGGAGGUUCCGAAAAUCCAAAAAACAGAGUAGGAA,17,4,9,6,36
5546,0,URS0000D677A1_12908/1-36,ACGGAGGUUCCGAAAAUCCGAGAAAUAGAGUAGGAA,15,5,11,5,36
5547,0,URS0000D69D8D_12908/1-34,ACGGAGGUUCCGAAAAUCCAAGAAAGAGUAGGAA,15,4,10,5,34
5548,0,URS0000D65E4B_12908/1-35,ACAGGCGGUGCUGAAAACCUGAAAUAGAGUAGGCA,13,5,11,6,35
5549,0,URS0000D6B955_391596/1-35,GAAGGGUAAGCUGAAAACCUUUAACAGAGUAGGCG,13,6,11,5,35
5550,0,URS0000D6BDBA_525257/1-36,AUGGCGGCAUCUGAAAAGCCAUUAAAAGAGUAAGAA,16,6,9,5,36
5551,0,URS0000D6C297_12908/1-35,ACAGAGGUAGCCGAAAAUCUAUAAAAGAGUAGGCU,15,6,9,5,35
5552,0,URS0000D665F6_12908/1-35,AUAGAGGUAGCUGAAAAUCUAUAAAAGAGUAAGCA,17,7,8,3,35
5553,0,URS0000D665F6_857291/1-35,AUAGAGGUAGCUGAAAAUCUAUAAAAGAGUAAGCA,17,7,8,3,35
5554,0,URS0000D665F6_563031/1-35,AUAGAGGUAGCUGAAAAUCUAUAAAAGAGUAAGCA,17,7,8,3,35
5555,0,URS0000D66B45_12908/1-35,UAGGCAGUAUCCGAAAAGCCAGAACAGAGUAGGAC,14,4,10,7,35
5556,0,URS0000D65C41_12908/1-35,AUGACGGGUUUCGAAAAGUCAUAAUAGAGUAGGAA,14,8,10,3,35
5557,0,URS0000D65B42_12908/1-35,AUGACGGGUUCCGAAAAGUCAUAAUAGAGUAGGAA,14,7,10,4,35
5558,0,URS0000D6B1DA_12908/1-36,AACGCGUAUGCUGAAAAGCGUAUAACAGAGUAGGCU,13,7,10,6,36
5559,0,URS0000D68330_12908/1-36,AUCGCAUAUGCCGAAAAGCGUAUAAUAGAGUAGGCU,13,8,9,6,36
5560,0,URS0000D681C2_12908/1-35,ACAGCGAAUUCCGAAAAGCUGUGAGAGAGUAGGAG,13,5,12,5,35
5561,0,URS0000D66C31_926559/1-35,GAAGUGAAAACCGAAAAACUUAAAUAGAGUAGGUA,18,6,8,3,35
5562,0,URS0000D66D95_1144313/1-36,ACAGUGAAAACCGAAAAACUGAAAAAAGAGUAGGUA,20,4,8,4,36
5563,0,URS0000D68B64_12908/1-35,AAAGGAAAUGCCGAAAACCUUCAAAAGAGUAGGCA,17,4,8,6,35
5564,0,URS0000D6644F_12908/1-35,UUAGGGGAUACCGAAAACCUAAAAAAGAGUAGGUA,16,6,9,4,35
5565,0,URS0000D67F52_700598/1-35,UUAGGGGAUACCGAAAACCUAAAACAGAGUAGGUA,15,6,9,5,35
5566,0,URS0000D6743F_313596/1-35,CGGGAGGAUUCCGAAAAUCCGGAAAAGAGUAGGAG,13,4,13,5,35
5567,0,URS0000D6B5BF_12908/1-35,AUGGAGAAUGCCGAAAAGCCAUAAAUGAGUAGGCA,15,5,10,5,35
5568,0,URS0000D67759_12908/1-35,AUGGAGUAUGUCGAAAAUCCAUAAGAGAGUAGGCA,14,7,10,4,35
5569,0,URS0000D6CC90_1149865/1-35,AAAGGAGUAGCCGAAAACCUCAAACAGAGUAGGCA,16,3,9,7,35
5570,0,URS0000D674B4_12908/1-37,GCAGGGGAAGCUGAAAACCUGUAGAACCGAGUAGGCA,13,4,13,7,37
5571,0,URS0000D66166_12908/1-35,UCAGGGGAAGCUGAAAACCUGUAACAGAGUAAGCA,14,5,10,6,35
5572,0,URS0000D6840E_12908/1-35,ACAGGGGAUGCUGAAAACCUAUAAAAGAGUAAGCA,16,5,9,5,35
5573,0,URS0000D661B1_12908/1-35,AAAGACCAAGCCGAAAAUCUUUAAUAGAGUAGGCA,16,6,7,6,35
5574,0,URS0000D66892_12908/1-36,ACAGAGGAACCUGAAAAUCUGCAAACAGAGUAAGGA,17,4,9,6,36
5575,0,URS0000D666B1_12908/1-35,AAAGAGGCACCUGAAAAUCUUAAAAAGAGUAAGGA,18,5,8,4,35
5576,0,URS0000D668F1_12908/1-36,AACGGGGGUGCCGAAAACCGUGUGAAAGAGUAGGCG,11,4,15,6,36
5577,0,URS0000D6C9D2_620914/1-36,AGGGGGGAAGCCGAAAAACCUUUAAUAGAGUAAGCA,15,5,11,5,36
5578,0,URS0000D698E0_12908/1-35,GAGGCGGCAACCGAAAAGCCAUAAGAGAGUAGGUA,14,3,12,6,35
5579,0,URS0000D682B9_12908/1-35,UAGGCGGUGCCCGAAAGGCCUUAAAAGAGUAGGGA,11,5,13,6,35
5580,0,URS0000D678AC_12908/1-35,UAGGCGGUUCCCGAAAGGCCUUAAAAGAGUAGGGG,10,6,13,6,35
5581,0,URS0000D67E9C_12908/1-41,UCGGCGCAAACCGAAAAGCCGUAUACCAAACAGAGUAGGUA,16,5,10,10,41
5582,0,URS0000D6D150_12908/1-35,UAGGAGUUUUCUGAAAAUCCAUAAAAGAGUAGGAA,15,9,8,3,35
5583,0,URS0000D68F2C_12908/1-37,ACAGGAUUAGCCGAAAACCUGUAUAAGAGAGUAGGCG,14,6,11,6,37
5584,0,URS0000D65E65_12908/1-35,UCAGGGGCCGCCGAAAACCUGGAACAGAGUAGGCA,11,3,12,9,35
5585,0,URS0000D65B37_391587/1-35,AAAGGGUAAACUGAAAACCUUUAACAGAGUAAGUA,17,7,7,4,35
5586,0,URS0000D68434_700598/1-35,ACAGGGUUGGCCGAAAACCUGAAACAGAGUAGGCA,13,4,11,7,35
5587,0,URS0000D66253_12908/1-35,AUGGAGGAAGCCGAAAAUCCUUUGAAGAGUAGGCG,12,6,12,5,35
5588,0,URS0000D67E7C_12908/1-35,AUGGUGGAAGCCGAAAAACCAGAAGAGAGUAGGCG,14,3,13,5,35
5589,0,URS0000D6611F_12908/1-35,UAGGAGUAUGCUGAAAAUCCUAAAAAGAGUAGGUG,14,8,10,3,35
5590,0,URS0000D6A60D_12908/1-35,ACGGAGGAAGCCGAAAAUCCGUACUAGAGUAGGCG,12,4,12,7,35
5591,0,URS0000D6C4C7_12908/1-35,ACGGAGAAAGCCGAAAAUCCGUACUAGAGUAGGCG,13,4,11,7,35
5592,0,URS0000D6BB46_1144316/1-36,UGGGAGGUUGUCGAAAAUCCUUUAAAAGAGUAGGCA,12,9,11,4,36
5593,0,URS0000D68A30_12908/1-35,ACGGAGGAAGCCGAAAAUCUGAUCAAGAGUAGGCA,14,4,11,6,35
5594,0,URS0000D6AA3A_12908/1-35,AGGGAGGUAUCCGAAAAUCCUUAACAGAGUAGGAU,13,7,10,5,35
5595,0,URS0000D658ED_12908/1-35,UCGGGGGAUGCCGAAAACCCGCAACAGAGUAGGCA,11,3,12,9,35
5596,0,URS0000D6B069_12908/1-37,AGGGGAGAUGCCGAAAACCCGGGAAACAGAGUAGGCA,14,2,14,7,37
5597,0,URS0000D6CE16_12908/1-35,UUGGCACAUUCCGAAAAGCCUAAACAGAGUAGGAA,14,6,8,7,35
5598,0,URS0000D6684A_12908/1-35,AAAGAGAUCCCCGAAAAUCUAUAAAAGAGUAGGGA,17,5,8,5,35
5599,0,URS0000D6B636_12908/1-36,UUGGCGAAACCCGAAAAGCCAAAAAUAGAGUAGGGU,15,5,10,6,36
5600,0,URS0000D67009_12908/1-35,CUGGAGGAAGCCGAAAAUCCUGAAAAGAGUAGGUU,13,6,11,5,35
5601,0,URS0000D6AFE2_12908/1-35,UCGGAGAAUGCCGAAAAGCCGGAUAAGAGUAGGCA,13,4,12,6,35
5602,0,URS0000D698EE_12908/1-35,CCGGAGGUACCCGAAAAUCCAUUAAAGAGUAGGGA,13,5,10,7,35
5603,0,URS0000D68BD5_12908/1-35,AUAGAGGCACCCGAAAAUCUGUAAAAGAGUAGGGA,15,5,10,5,35
5604,0,URS0000D6919A_485917/1-35,AUGGCGAACGCUGAAAAGCCUUAACAGAGUAAGCA,14,5,9,7,35
5605,0,URS0000D66B2B_12908/1-39,AGGGCGUAUCCCGAAAAGCCCUUAUAAAACGAGUAGGGA,14,6,11,8,39
5606,0,URS0000D6B026_12908/1-37,UAGGUGGAUUCCGAAAAACCUGUAAAUAGAGUAGGAU,14,9,10,4,37
5607,0,URS0000D67A39_485918/1-37,UAUGGGUAUGCCGAAAACCAUCAGAAAAGAGUAGGCA,15,6,10,6,37
5608,0,URS0000D6688F_485918/1-37,AAGGGCGUACCCGAAAACCCUAAGAACAGAGUAGGGA,15,3,11,8,37
5609,0,URS0000D6BA48_946077/1-34,UAGGUGGAAGCUGAAAAACCUUAAAGAGUAGGCA,14,6,10,4,34
5610,0,URS0000D6BCF5_485917/1-40,CAGGUGGAAGCUGAAAAACCUGAUUAAAACAGAGUAGGCA,17,6,11,6,40
5611,0,URS0000D6AABF_485917/1-40,CAGGUGGAAGCCGAAAAACCUGAUUAAAACAGAGUAGGCA,17,5,11,7,40
5612,0,URS0000D68976_485917/1-40,CAGGUGGAAGCCGAAAAACCUGAUUGAAACAGAGUAGGCA,16,5,12,7,40
5613,0,URS0000D677D2_485917/1-40,CAGGUGGAAGCCGAAAAGCCUGAUUGAAACAGAGUAGGCA,15,5,13,7,40
5614,0,URS0000D67AE7_12908/1-37,ACAGGGUGUUCCGAAAACCUGUAGAAAAGAGUAGGAG,14,6,12,5,37
5615,0,URS0000D6C5CD_12908/1-36,ACCCCGUAAGCCGAAAAGGGGAACAAAGAGUAGGCA,15,2,11,8,36
5616,0,URS0000D6D2BE_12908/1-36,ACCUCGUAAGCCGAAAAGAGGAAAAUAGAGUAGGCA,16,4,10,6,36
5617,0,URS0000D67241_12908/1-36,AGAGAAGAUGCCGAAAAUCUCAUCAAAGAGUAGGCA,16,5,9,6,36
5618,0,URS0000D6CD35_12908/1-36,AUGGAGGAUGCUGAAAAUCCUAUAAAAGAGUAGGCU,14,8,10,4,36
5619,0,URS0000D69A65_12908/1-38,AUGGUGGAUUCUGAAAAACCUAUAAAACAGAGUAGGAA,17,8,9,4,38
5620,0,URS0000D672D9_12908/1-36,AAGGAAGUCGCCGAAAAUCCUAUCAAAGAGUAGGCA,15,5,9,7,36
5621,0,URS0000D6C800_12908/1-37,ACAGCGUAAGCCGAAAAGCUACAAAACAGAGUAGGCU,16,4,9,8,37
5622,0,URS0000D69B4F_12908/1-36,ACAGAGGAUCCCGAAAAUCUGAAAACAGAGUAGGGG,15,4,11,6,36
5623,0,URS0000D68644_12908/1-36,UAGGCAGUAUCCGAAAAGCCUUCAAUAGAGUAGGAG,13,7,10,6,36
5624,0,URS0000D6B6D5_12908/1-38,AAGGGGUAAUACCGAAAACCCUAGAAAUAGAGUAGGUA,17,6,10,5,38
5625,0,URS0000D6B3C6_12908/1-37,AAGGGGUAAUACCGAAAACCCUGAAAUAGAGUAGGUA,16,6,10,5,37
5626,0,URS0000D6A129_12908/1-33,AAGGGAGAAACCGAAAACCCAUUAGAGUAGGUA,15,4,9,5,33
5627,0,URS0000D6785E_12908/1-36,AGGGAGCAAGCCGAAAAUCCCGUAACAGAGUAGGCG,13,3,12,8,36
5628,0,URS0000D682E3_12908/1-41,UGGGUGCAAGCCGAAAAACCCGACAAAAAAAAGAGUAGGCA,19,3,11,8,41
5629,0,URS0000D6C890_12908/1-34,CGGGUGAAAGCCGAAAAACCCAAAAGAGUAGGCA,15,2,10,7,34
5630,0,URS0000D66252_12908/1-40,UGGGUGCAAGCCGAAAAACCCGACAAAAAAAGAGUAGGCA,18,3,11,8,40
5631,0,URS0000D6B1D5_504472/1-35,AGGGUGCAAGCCGAAAAACCCUAAAAGAGUAGGCG,14,3,11,7,35
5632,0,URS0000D6AA95_12908/1-39,AAGGAGGUUACUGAAAAUCCUUGAAUAAUAGAGUAGGAA,17,9,10,3,39
5633,0,URS0000D67854_12908/1-36,UAGGCGAAUUCCGAAAAGCCAAUGAGAGAGUAGGAG,14,5,12,5,36
5634,0,URS0000D672E7_12908/1-38,CAGGCAGAUUCCGAAAAGCCUUUGAUAUAGAGUAGGAG,13,8,11,6,38
5635,0,URS0000D6A8B7_313606/1-36,CAGGCGAACACCGAAAAGCCUAAAACAGAGUAGGUG,15,3,10,8,36
5636,0,URS0000D6CC2C_12908/1-37,GCAGGGGAAUCCGAAAACCUGAGCAAAAGAGUAGGAU,15,4,12,6,37
5637,0,URS0000D66A76_391587/1-36,AAGGUGUAAGCUGAAAAACCUAAAAUAGAGUAAGUA,18,7,8,3,36
5638,0,URS0000D682FF_12908/1-35,UCAGGAGAAACCGAAAACCUGUAACAGAGUAGGUG,14,5,10,6,35
5639,0,URS0000D67790_12908/1-36,UCAGGGGAAACCGAAAACCUGUUAACAGAGUAGGCU,13,6,10,7,36
5640,0,URS0000D672B0_12908/1-36,UCAGGGGAAACCGAAAACCUGUUAAAAGAGUAGGCG,14,5,11,6,36
5641,0,URS0000D68674_12908/1-37,CCAGGGGUAACCGAAAACCUGUAUAAAAGAGUAGGAA,16,5,10,6,37
5642,0,URS0000D656F2_12908/1-37,ACAGGGGUAACCGAAAACCUGUAUAAAAGAGUAGGCC,15,5,10,7,37
5643,0,URS0000D673EC_12908/1-37,GCAGGGGUAACCGAAAACCUGUAGAAAAGAGUAGGUA,15,5,12,5,37
5644,0,URS0000D65ACB_12908/1-38,CAGGACGCCGCCGAAAAUCCUAUUUAAUAGAGUAGGCA,13,7,9,9,38
5645,0,URS0000D66ED4_12908/1-38,UAAGCGGUUGCCGAAAAGCUAAUAGUAAAGAGUAGGCA,15,7,11,5,38
5646,0,URS0000D67F83_12908/1-33,UUCGCGGAAGCCGAAAAGCGCAAAGAGUAGGCG,11,3,12,7,33
5647,0,URS0000D6BC65_12908/1-36,AGGGAGUAAGCCGAAAAUCCCAAUCAAGAGUAGGCA,15,4,10,7,36
5648,0,URS0000D6B5CF_12908/1-36,AUGGAGUAAGCUGAAAAUCCUUAUAAAGAGUAGGCG,14,8,10,4,36
5649,0,URS0000D69353_12908/1-39,AUGGAGUAAGCUGAAAAUCCAAUAUUAAAAGAGUAAGCG,18,8,9,4,39
5650,0,URS0000D6D352_12908/1-37,AAGGAGAUAACCGAAAAUCCAAAAAAAAGAGUAGGUA,21,4,8,4,37
5651,0,URS0000D6BCBD_12908/1-34,ACGGCGGAACCGAAAAGCCGAAGAUGAGUAGGAA,14,2,12,6,34
5652,0,URS0000D66E49_12908/1-35,UAGGCGGAUGCCGAAAAGCCUUAAAUGAGUAGGCU,11,7,11,6,35
5653,0,URS0000D6BE1C_12908/1-35,UAGGCGGAUGCCGAAAAGCCUUAAAUGAGUAGGUU,11,8,11,5,35
5654,0,URS0000D6AD4B_12908/1-35,AAUGCAGAUGCCGAAAAGCUAUAAUAGAGUAGGCA,15,6,9,5,35
5655,0,URS0000D6A48B_12908/1-41,AUGGUGGAUUCUGAAAAACCAUAUAUUGAAAAGAGUAGGAG,17,10,11,3,41
5656,0,URS0000D6BB72_12908/1-35,GAAGAGGUGCCCGAAAAUCUUUGAAAGAGUAGGGA,13,6,12,4,35
5657,0,URS0000D667B8_12908/1-41,CCGGCGGAUUCCGAAAAGCCAUUCAGAAAACAGAGUAGGAG,15,5,12,9,41
5658,0,URS0000D67CC0_391587/1-36,CAGGCGUAAUUCUGAAAAGCCUCAAUAGAGUAGGAG,13,7,10,6,36
5659,0,URS0000D659E2_391587/1-40,ACGGUGGCAUCCGAAAAACCAACUAACAAUAGAGUAGGAA,18,5,9,8,40
5660,0,URS0000D6927B_12908/1-35,AUGGAGUAUUCCGAAAAUCCAGAACAGAGUAGGAA,15,6,9,5,35
5661,0,URS0000D6B057_12908/1-35,GAGGCGUAACCGAAAAGCCUAAGAUAGAGUAGGAA,15,4,11,5,35
5662,0,URS0000D6599F_12908/1-35,UUAGGGAAAGCCCAAAACCUAUAAAAGAGUAGGCA,16,5,8,6,35
5663,0,URS0000D68B42_12908/1-33,AAGGGCGAAGCCGAAAACCCAAUAGAGUAGGCA,14,2,10,7,33
5664,0,URS0000D6935D_12908/1-37,AAGGGGGAAGCUGAAAACCCUGACAAUCGAGUAGGCA,14,4,12,7,37
5665,0,URS0000D6A55D_12908/1-35,AGAGAGGAUGCCGAAAAUCUCAUAUAGAGUAGGCG,13,6,11,5,35
5666,0,URS0000D65C2D_12908/1-35,AGAGAGGAUGCCGAAAAUCUCAUAAAGAGUAGGCG,14,5,11,5,35
5667,0,URS0000D66CAC_12908/1-35,AGAGAGGAAGCCGAAAAUCUCAUAAAGAGUAGGCA,16,4,10,5,35
5668,0,URS0000D6A58D_12908/1-35,AGGGCGGAACCCGAAAAGCCCGAACAGAGUAAGGA,14,1,12,8,35
5669,0,URS0000D6A45E_12908/1-33,GAGGCGUACUCCGAAAAGCCUUAAGAGUAGGAA,12,5,10,6,33
5670,0,URS0000D671FA_714943/1-33,GGGGCGAAACCCGAAAAGCCUUAAGAGUAGGAA,13,3,11,6,33
5671,0,URS0000D6C855_12908/1-34,GUAGCGGUAUCCGAAAAGCUAUAAAGAGUAGGAA,14,6,10,4,34
5672,0,URS0000D673C8_12908/1-33,ACUGCGGAUUCCGAAAAGCAAAAAGAGUAGGAA,15,4,9,5,33
5673,0,URS0000D6817C_12908/1-33,ACUGCGGACUCCGAAAAGCAAAAAGAGUAGGAA,15,3,9,6,33
5674,0,URS0000D688AF_12908/1-33,CCUGGGGAAGCCGAAAACCAAACAGAGUAGGCA,13,2,10,8,33
5675,0,URS0000D65D3F_12908/1-36,AGCAGGGAAGCCGAAAACUGCAUCAAAGAGUAGGCA,15,3,11,7,36
5676,0,URS0000D65FE0_12908/1-36,AGCAGGGAAGCCGAAAACUGUAUAAUAGAGUAGGCG,14,5,12,5,36
5677,0,URS0000D65BF7_12908/1-35,AGCAGGGAAGCCGAAAACUGUUAUUAGAGUAGGCA,13,6,11,5,35
5678,0,URS0000D6CE06_12908/1-36,AACAGGGAAGCCGAAAACUGAAAUAAAGAGUAGGCA,18,3,10,5,36
5679,0,URS0000D6829F_929562/1-35,AACAGGGUAGCCGAAAACUGUAGAUAGAGUAGGUA,14,6,11,4,35
5680,0,URS0000D68A34_12908/1-33,AACAGGGAAGCCGAAAACUGAACAGAGUAGGCA,15,2,10,6,33
5681,0,URS0000D6AAD2_391598/1-33,AACAGGGAAGCCGAAAACUGAAUAGAGUAGGUA,15,4,10,4,33
5682,0,URS0000D69987_12908/1-33,AACAGGGAAGCCGAAAACUGAAUAGAGUAGGCA,15,3,10,5,33
5683,0,URS0000D6D1C0_12908/1-33,AUCAGGGAAGCCGAAAACUGAAAAGAGUAGGCG,14,3,11,5,33
5684,0,URS0000D6C9D6_12908/1-33,CUCAGGGAAGCCGAAAACUGAAUAGAGUAGGCA,13,4,10,6,33
5685,0,URS0000D691F6_12908/1-33,CUCAGGGAAGCCGAAAACUGAAAAGAGUAGGCA,14,3,10,6,33
5686,0,URS0000D657C5_12908/1-33,AUCAGGGAAGCCGAAAACUGUAUAGAGUAGGCA,13,5,10,5,33
5687,0,URS0000D6759E_12908/1-33,AACAGGUAUGCCGAAAACUGAACAGAGUAGGCA,14,4,9,6,33
5688,0,URS0000D66AAA_12908/1-33,UAAGCGGAAGCCGAAAAGCUCAAAGAGUAGGUA,14,4,10,5,33
5689,0,URS0000D68223_12908/1-35,AAUGAGGUAGCCGAAAAGCAUAUAUAGAGUAGGCA,15,6,10,4,35
5690,0,URS0000D6963C_12908/1-33,AAAGGGGAUGCCGAAAACCUGAAAGAGUAGGUG,13,4,12,4,33
5691,0,URS0000D66790_12908/1-33,AAAGGGGAUGCCGAAAACCUGAAAGAGUAGGUA,14,4,11,4,33
5692,0,URS0000D6BFFD_12908/1-37,AAAGGGAAAGCCGAAAACCUUUACAAAAGAGUAGGUG,17,5,10,5,37
5693,0,URS0000D66045_755732/1-33,AAAGGGGAUGCCGAAAACCUUAUAGAGUAGGUC,12,6,10,5,33
5694,0,URS0000D686B4_743722/1-35,UCAGGGGAUGCCGAAAACCUUAAAAAGAGUAGGUG,13,6,11,5,35
5695,0,URS0000D69DDC_12908/1-38,ACGGGGGAAUUCCGAAAACCCGCUGAACAGAGUAGGAA,14,4,12,8,38
5696,0,URS0000D69594_12908/1-35,AACGCGGAUGCUGAAAAGCGAUAACAGAGUAAGCA,15,4,10,6,35
5697,0,URS0000D68179_12908/1-35,AACGCGGAUGCCGAAAAGCGAUAACAGAGUAAGCA,15,3,10,7,35
5698,0,URS0000D69E0F_12908/1-38,UAGGGGCAAGCUGAAAACCCUAGAGAAAAGAGUAGGCA,16,4,12,6,38
5699,0,URS0000D66493_12908/1-33,AUAGCGGAAACCGAAAAGCUAAAAGAGUAGGUG,15,4,10,4,33
5700,0,URS0000D66A91_12908/1-35,AUAGCGGAAACCGAAAAGCUAAAAAAGAGUAGGUG,17,4,10,4,35
5701,0,URS0000D6CEFD_12908/1-33,AAAGCGGAAACCGAAAAGCUAAUAGAGUAGGUG,15,4,10,4,33
5702,0,URS0000D69E8F_12908/1-33,ACAGCGGAAACCGAAAAGCUUUAAGAGUAGGUG,13,5,10,5,33
5703,0,URS0000D686C1_12908/1-35,CAAGCGGUUACCGAAAAGCUUAAAUAGAGUAGGUG,13,7,10,5,35
5704,0,URS0000D6BE7E_12908/1-36,AUGGAGCAUCCCCGAAAAUCCUAAACAGAGUAGGGA,14,5,9,8,36
5705,0,URS0000D6917D_12908/1-35,CAAGGACAAGCCGAAAACCUUAAAAAGAGUAGGCC,16,3,8,8,35
5706,0,URS0000D6AFB3_156586/1-33,UAAGCGACAGCCGAAAAGCUUAUAGAGUAGGCA,13,5,9,6,33
5707,0,URS0000D6A6B7_12908/1-35,GAAGCGGACACCGAAAAGCUUUGAUAGAGUAGGUA,13,6,11,5,35
5708,0,URS0000D6D19D_12908/1-33,GGAGCGGAAACCGAAAAGCUUAUAGAGUAGGCA,13,4,11,5,33
5709,0,URS0000D6B5CD_12908/1-33,GGAGCGGAAACCGAAAAGCUUAUAGAGUAGGUA,13,5,11,4,33
5710,0,URS0000D67519_12908/1-33,AAAGCGAAAGCCGAAAAGCUUUUAGAGUAGGCA,14,5,9,5,33
5711,0,URS0000D6C2EE_12908/1-33,GGAGCGAAAGCCGAAAAGCUUUUAGAGUAGGCA,12,5,11,5,33
5712,0,URS0000D66B4C_12908/1-33,GGAGCGAAAGCCGAAAAGCUUAUAGAGUAGGUA,13,5,11,4,33
5713,0,URS0000D67C94_12908/1-33,AAAACGGAAGCCGAAAAGUUUUUAGAGUAGGCA,14,6,9,4,33
5714,0,URS0000D6A0AE_12908/1-36,CAGGAGGAAGCCGAAAAUCCUUGAUUAGAGUAGGCC,12,6,11,7,36
5715,0,URS0000D680C6_12908/1-37,UAUGGAGAAGCCGAAAACCAUAGAAACAGAGUAGGCA,17,4,10,6,37
5716,0,URS0000D6B126_12908/1-38,AUAGCGGGUGCCGAAAAGCUGAGAGAAUAGAGUAGGCG,13,5,15,5,38
5717,0,URS0000D698E2_12908/1-36,GGGGACGAAGCCGAAAAUCCCUUAUCAGAGUAGGCA,12,5,11,8,36
5718,0,URS0000D68789_12908/1-36,AGGGACGAAGCCGAAAAUCCCUUAUCAGAGUAGGCA,13,5,10,8,36
5719,0,URS0000D68ECD_12908/1-33,AACGGGGUUGCUGAAAACCGAAUAGAGUAGGCG,11,5,12,5,33
5720,0,URS0000D6845A_12908/1-37,ACGGAGGAAGCCGAAAAUCCGUAACUAAGAGUAGGAA,16,4,11,6,37
5721,0,URS0000D6AC28_12908/1-35,ACCCGGGAAGCCGAAAACGGGAUAUAGAGUAGGCA,13,3,12,7,35
5722,0,URS0000D69C9A_12908/1-35,CACGCGAAAACCGAAAAGCGAAAACAGAGUAGGCA,17,1,9,8,35
5723,0,URS0000D6C5D4_12908/1-35,AUAGGGGAAACCGAAAACCUUAAAGAGAGUAGGUA,16,5,10,4,35
5724,0,URS0000D681EA_12908/1-33,AGAGCGGAACCCGAAAAGCUUGUAGAGUAGGGA,12,4,12,5,33
5725,0,URS0000D67E67_12908/1-33,UGAGCGGUACCCGAAAAGCUCAUAGAGUAGGGA,11,5,11,6,33
5726,0,URS0000D6AFE3_12908/1-33,UUAGCGGUACCCGAAAAGCUUAUAGAGUAGGGA,11,7,10,5,33
5727,0,URS0000D6A7DA_1034807/1-37,AGAGCGAUACCCGAAAAGCUUAAAAAUAGAGUAGGGA,17,5,10,5,37
5728,0,URS0000D69B71_12908/1-33,GAAGCGGAACCCGAAAAGCUUGAAGAGUAGGGA,13,3,12,5,33
5729,0,URS0000D6CCE3_12908/1-36,UAGGAGUAACCCGAAAAGCCUUUAAUAGAGUAGGGA,14,7,10,5,36
5730,0,URS0000D670BA_12908/1-37,CCAGAGGAUUCCGAAAAUCUGUAAAAAAGAGUAGGAA,17,6,9,5,37
5731,0,URS0000D689FF_12908/1-37,CCAGAGGAUUCCGAAAAUCUGUAAAAAAGAGUAGGGC,15,6,10,6,37
5732,0,URS0000D67CD3_12908/1-35,UCAGAGGAUUCCGAAAAUCUGUAAAAGAGUAGGAC,14,7,9,5,35
5733,0,URS0000D65751_12908/1-35,UCAGAGGAUUCCGAAAAUCUGUAAAAGAGUAGGAA,15,7,9,4,35
5734,0,URS0000D66F2A_12908/1-33,UUAGAGGAAUCCGAAAAUCUAACAGAGUAGGAA,15,6,8,4,33
5735,0,URS0000D69A91_12908/1-37,ACCGCGGAACCCGAAAAGCGGAAAAAGAGAGUAGGGA,16,1,13,7,37
5736,0,URS0000D684AE_12908/1-33,AAAGCGGGAGCCGUAAAGCUUAAAGAGUAGGCA,13,4,11,5,33
5737,0,URS0000D6A858_12908/1-35,AAUGGGGAAGCCGAAAACCAAUUUAAGAGUAGGCG,14,5,11,5,35
5738,0,URS0000D6ABD9_12908/1-39,GCCGGGAAUGCCGAAAACCGGGAUUUAAAAGAGUAGGCA,14,5,13,7,39
5739,0,URS0000D6C377_12908/1-33,GGCGCGGAAUCCGAAAAGCGAAAAGAGUAGGAA,14,2,12,5,33
5740,0,URS0000D6CDAC_12908/1-33,AACGCGGAUACCGAAAAGCGAAUAGAGUAGGUA,14,4,10,5,33
5741,0,URS0000D6A716_12908/1-33,AAAGAGGAUUCCGAAAAUCUUUAAGAGUAGGAU,14,8,8,3,33
5742,0,URS0000D6CE91_12908/1-37,ACCGGGAAUGCCGAAAACCGAAAUAUUAGAGUAGGCA,15,5,10,7,37
5743,0,URS0000D67E66_12908/1-33,AUUGCGGAUGCCGAAAAGCAUAUAGAGUAGGCU,11,7,10,5,33
5744,0,URS0000D65D05_12908/1-35,GAGGAAGAACCCGAAAAUCCUUAAAAAAGUAGGGA,17,4,9,5,35
5745,0,URS0000D68DE9_12908/1-33,AAAGCGGUUGCCGAAAAGCUUUUAGAGUAGGCU,10,8,10,5,33
5746,0,URS0000D6B587_12908/1-33,AAAGCGGAUGCCGAAAAGCUCAUAGAGUAGGCU,12,5,10,6,33
5747,0,URS0000D66035_12908/1-33,UCCGGAGAUGCCGAAAACCGAAUAGAGUAGGCA,12,4,10,7,33
5748,0,URS0000D6813B_12908/1-33,AGAGCGGAUACCGAAAAGCUAAAAGAGUAGGAA,16,3,10,4,33
5749,0,URS0000D68D91_12908/1-33,UACGCGGUAGCCGAAAAGCGCAGAGAGUAGGCA,11,3,12,7,33
5750,0,URS0000D66F70_700598/1-36,GAUGGGGAAGCCGAAAACCAUAAAAUCGAGUAGGCG,14,4,12,6,36
5751,0,URS0000D6C79B_12908/1-37,UGGGCGGUUGCCGAAAAGCCCAGAAAAAGAGUAGGCU,12,5,13,7,37
5752,0,URS0000D6694D_12908/1-35,AGGGCGGAUGCCGAAAAGCCCGAAAAGAGUAGGCA,13,2,13,7,35
5753,0,URS0000D6CDB6_12908/1-33,GGGGCGGAUGCCGAAAAGCCCAAAGAGUAGGCG,10,2,14,7,33
5754,0,URS0000D69430_12908/1-35,AAAGCGUUGGCCGAAAAGCUUUGACAGAGUAGGCA,12,6,11,6,35
5755,0,URS0000D67D68_12908/1-35,UACGGGGAUGCCGAAAACCGUUGACAGAGUAGGCU,10,6,12,7,35
5756,0,URS0000D657FC_12908/1-37,AAAGGGGAUUGCUGAAAACCUUUCAAUCGAGUAGGCA,13,8,10,6,37
5757,0,URS0000D69C42_12908/1-33,AAUAGGGAAGCUGAAAACUAUAUAGAGUAGGCA,15,6,9,3,33
5758,0,URS0000D6605D_12908/1-35,AAAGGGAAAGCUGAAAACCUUGAACAGAGUAGGCA,16,4,10,5,35
5759,0,URS0000D68595_12908/1-33,AAAGCGUUAACCGAAAAGCUUAUAGAGUAGGGA,14,6,9,4,33
5760,0,URS0000D68158_12908/1-33,UAAGCGGAAACCGAAAAGCUUUAAGAGUAGGCA,14,5,9,5,33
5761,0,URS0000D66F96_12908/1-35,ACAGCGUAAGCCGAAAAGCUGGGAGAGAGUAGGCG,12,3,14,6,35
5762,0,URS0000D69B39_12908/1-36,UGAGGGGAAGCCGAAAACCUUGGAAGAGAGUAGGCG,12,4,15,5,36
5763,0,URS0000D6B4C1_755732/1-35,AAUGGGGAAUCCGAAAACCAUAUUUAGAGUAGGAA,15,7,9,4,35
5764,0,URS0000D67178_12908/1-36,ACGGAGCAACCCGAAAAUCCGAUCAAAGAGUAGGGA,15,3,10,8,36
5765,0,URS0000D6BD25_12908/1-35,AACGGGGAAACCGAAAACCGAGAAAAGAGUAGGUG,16,2,12,5,35
5766,0,URS0000D6BDAF_531844/1-35,AAGGGGGAAGCCGAAAACCCGUGUCAGAGUAGGCA,12,3,13,7,35
5767,0,URS0000D6BB42_12908/1-40,ACGGAGGAACCGAAAAUCCGAAUAGUGAAGAGAGUAGGAA,18,4,13,5,40
5768,0,URS0000D68A0A_12908/1-34,AUGGCGGAACCGAAAAGCCAUAACAGAGUAGGCC,13,3,10,8,34
5769,0,URS0000D68B5E_12908/1-41,AUGGCGGAAUCCGAAAAGCCAAAUCUCAAACAGAGUAGGGU,16,6,11,8,41
5770,0,URS0000D6835E_12908/1-35,CCAGGGACAGCCGAAAACCUGGAAUAGAGUAGGCA,13,3,11,8,35
5771,0,URS0000D6A221_12908/1-35,ACAGGCGCAGCCGAAAACCUGGAAUAGAGUAGGCA,13,3,11,8,35
5772,0,URS0000D66410_485918/1-35,ACAGAGGAAGCCGAAAAUCUGCGACAGAGUAGGCG,13,3,12,7,35
5773,0,URS0000D6B28F_12908/1-35,ACAGAGGAAUCCGAAAAUCUGCGACAGAGUAGGAG,14,4,11,6,35
5774,0,URS0000D6B741_12908/1-35,ACAGAGGAUUCCGAAAAUCUGCAAGAGAGUAGGAG,14,5,11,5,35
5775,0,URS0000D662AD_12908/1-35,AACGGAGAAGCCGAAAACCGAUUAUAGAGUAGGCA,15,4,10,6,35
5776,0,URS0000D6AE0E_12908/1-33,AACGGAGAAGCCGAAAACCGAUUAGAGUAGGCA,14,3,10,6,33
5777,0,URS0000D6BF89_929556/1-33,AACGGAGAUGCCGAAAACCGGAUAGAGUAGGCA,13,3,11,6,33
5778,0,URS0000D659B5_12908/1-39,ACAGAGGCAGCCGAAAAUCUGGUUAUAAUAGAGUAGGCA,15,7,11,6,39
5779,0,URS0000D67872_485918/1-37,CAAGGGAUAGCCGAAAACCUUUAAAAAAGAGUAGGCA,17,5,9,6,37
5780,0,URS0000D6BCB6_12908/1-33,CAAGGGAUAGCCGAAAACCUUAUAGAGUAGGCA,13,5,9,6,33
5781,0,URS0000D67F46_12908/1-35,ACCGGGGAAGCCGAAAACCGGAUUUAGAGUAGGCG,11,4,13,7,35
5782,0,URS0000D67EA0_525257/1-36,ACAGGAGACGCCGAAAACCUGAACAAAGAGUAGGCA,16,2,10,8,36
5783,0,URS0000D6C742_12908/1-37,ACAGGCGAAGCCGAAAACCUGUAGAAACGAGUAGGUA,15,4,11,7,37
5784,0,URS0000D675A6_12908/1-35,ACAGGGGAAGCCGAAAACCUGUAAUAGAGUAGGCA,14,4,11,6,35
5785,0,URS0000D6784F_700598/1-37,ACAGGCGAAGCCGAAAACCUGCAUAACAGAGUAGGCA,15,3,10,9,37
5786,0,URS0000D66956_12908/1-37,ACAGGCGAAGCCGAAAACCUGUAAAAAAGAGUAGGCA,17,3,10,7,37
5787,0,URS0000D6CC6A_12908/1-37,ACAGGCGAAGCCGAAAACCUGAAUAAAAGAGUAGGCA,17,3,10,7,37
5788,0,URS0000D65DB9_12908/1-37,ACAGGCGAAGCCGAAAACCUGUAUAAAAGAGUAGGCA,16,4,10,7,37
5789,0,URS0000D69FAA_700598/1-35,ACAGGCCUAGCCGAAAACCUGUAACAGAGUAGGCA,13,4,9,9,35
5790,0,URS0000D684EE_12908/1-35,ACAGGAGAAGCCGAAAACCUGAACAAGAGUAGGCA,16,2,10,7,35
5791,0,URS0000D6C8C6_12908/1-33,AACGGGGAAGCCGAAAACCGUGAAGAGUAGGCA,13,2,12,6,33
5792,0,URS0000D67814_12908/1-37,AAAGGGGAAACCGAAAACCUUUAAGUUAGAGUAGGUG,15,7,11,4,37
5793,0,URS0000D6973E_1144313/1-37,AAUGGGAAAGCCGAAAACCACUAUAAUAGAGUAGGCA,17,5,9,6,37
5794,0,URS0000D6A0B0_1202532/1-33,AAUGGGAAAGCCGAAAACCAAAGAGAGUAGGCA,16,2,10,5,33
5795,0,URS0000D6A0B0_376686/1-33,AAUGGGAAAGCCGAAAACCAAAGAGAGUAGGCA,16,2,10,5,33
5796,0,URS0000D6741D_485918/1-37,AAUGGGGAAGCCGAAAACCAUUAGAAGAGAGUAGGCG,15,4,13,5,37
5797,0,URS0000D67A82_12908/1-33,AAUGGGGACGCCGAAAACCAUACAGAGUAGGCA,13,3,10,7,33
5798,0,URS0000D69A26_12908/1-33,AAUGGAGAAGCCGAAAACCAGAUAGAGUAGGCA,15,3,10,5,33
5799,0,URS0000D692D7_1144316/1-33,GCAGGGGAAGCCGAAAACCUUAUAGAGUAGGCA,12,4,11,6,33
5800,0,URS0000D6AA58_867902/1-33,GAAGGGGAAACCGAAAACCUUAUAGAGUAGGCA,14,4,10,5,33
5801,0,URS0000D6B7C6_12908/1-33,AACGGGAAAGCCGAAAACCGAUUAGAGUAGGUA,14,4,10,5,33
5802,0,URS0000D6D411_12908/1-33,AACGGGGAAGCCGAAAACCGAACUGAGUAGGCA,13,2,11,7,33
5803,0,URS0000D67917_12908/1-33,AACGGGGAAGCCGAAAACCGACCAGAGUAGGCA,13,1,11,8,33
5804,0,URS0000D66CBA_12908/1-33,AAUGGGGAUGCCGAAAACCGUAUAGAGUAGGCA,12,5,11,5,33
5805,0,URS0000D68D09_12908/1-36,GAAGGGGAAGCUGAAAACCUUUAAUUAGAGUAAGCA,15,7,10,4,36
5806,0,URS0000D68688_12908/1-33,AAAGGGGAAGCCGAAAACCUGUAAGAGUAGGCG,13,3,12,5,33
5807,0,URS0000D6D1FE_12908/1-35,AACGGAAAAGCCGAAAACCGAUAAAAGAGUAGGCA,18,2,9,6,35
5808,0,URS0000D65AB4_12908/1-33,AACGGAGAAGCCGAAAACCGAAAAGAGUAGGCG,15,1,11,6,33
5809,0,URS0000D6CED7_12908/1-33,CACGGAGAAGCCGAAAACCGAAAAGAGUAGGCA,15,1,10,7,33
5810,0,URS0000D6B43F_12908/1-39,AACGGGAAAGCCGAAAACCGUAUACGAACAGAGUAGGUA,17,4,11,7,39
5811,0,URS0000D68275_1185876/1-33,AACGGGGCCGCCGAAAACCGAACAGAGUAGGCA,12,1,11,9,33
5812,0,URS0000D673E5_12908/1-33,AACGGGGAAGCCGAAAACCGAACAGAGUAGGCG,13,1,12,7,33
5813,0,URS0000D6787D_12908/1-35,ACCGGGGACGCCGAAAACCGGAAACAGAGUAGGCG,12,1,13,9,35
5814,0,URS0000D6690C_12908/1-35,AACGGGGACGCCGAAAACCGGAAACAGAGUAGGCG,13,1,13,8,35
5815,0,URS0000D69E1E_12908/1-33,AUAGGGGAAACUGAAAACCUUUUAGAGUAGGAA,14,7,9,3,33
5816,0,URS0000D67965_12908/1-34,AUAGGAGAAGCUGAAAACCUUUAUAGAGUAGGCA,14,7,9,4,34
5817,0,URS0000D6786F_12908/1-35,AUAGGGAAAGCCGAAAACCUCAAAUAGAGUAGGCA,16,4,9,6,35
5818,0,URS0000D68564_12908/1-33,GUAGGGAAAGCCGAAAACCUAAUAGAGUAGGCA,14,4,10,5,33
5819,0,URS0000D6BDCB_12908/1-36,ACAGGGGAAGCCGAAAACCUGAUUUUAGAGUAGGCG,12,6,12,6,36
5820,0,URS0000D6B4EA_1144316/1-36,AACGGGGAAGCCGAAAACCGUGUUUCAGAGUAGGCA,12,5,12,7,36
5821,0,URS0000D6B4EA_525257/1-36,AACGGGGAAGCCGAAAACCGUGUUUCAGAGUAGGCA,12,5,12,7,36
5822,0,URS0000D6ADB0_12908/1-33,AACGGGGAAGCCGAAAACCGUACAGAGUAGGCA,13,2,11,7,33
5823,0,URS0000D6C731_12908/1-35,AGAGGGGAAGCCGAAAACCUUUAACAGAGUAGGCA,14,4,11,6,35
5824,0,URS0000D69876_12908/1-33,AUAGGGGAAGCCGAAAACCUUUUAGAGUAGGUG,11,7,11,4,33
5825,0,URS0000D6D401_12908/1-33,AUAGGGGAAGCCGAAAACCUUUCAGAGUAGGUG,11,6,11,5,33
5826,0,URS0000D6AC5C_12908/1-33,ACAGGGGAAGCCGAAAACCUUUCAGAGUAGGCG,11,4,11,7,33
5827,0,URS0000D66B33_12908/1-33,GUAGGGGAAGCCGAAAACCUUUUAGAGUAGGCA,11,6,11,5,33
5828,0,URS0000D67ADB_12908/1-33,AUAGGGGAAGCUGAAAACCUUUCAGAGUAGGCA,12,6,10,5,33
5829,0,URS0000D697FA_12908/1-33,AUAGGGGAAGCUGAAAACCUUUUAGAGUAGGCA,12,7,10,4,33
5830,0,URS0000D6CDB2_12908/1-33,AUAGGAGAAGCCGAAAACCUUUUAGAGUAGGCG,12,6,10,5,33
5831,0,URS0000D67741_12908/1-33,AUAGGGGAAGCCGAAAACCUUUAAGAGUAGGCG,12,5,11,5,33
5832,0,URS0000D67ED4_12908/1-33,AUAGGGGAAGCCGAAAACCUUUCAGAGUAGGCG,11,5,11,6,33
5833,0,URS0000D68565_12908/1-33,AUAGGGGAAGCUGAAAACCUUUCAGAGUAGGCG,11,6,11,5,33
5834,0,URS0000D684D5_12908/1-33,AUAGGGGAUGCCGAAAACCUUUUAGAGUAGGCG,10,7,11,5,33
5835,0,URS0000D6C7E6_12908/1-33,AUAGGGGAAGCCGAAAACCUUUUAGAGUAGGCG,11,6,11,5,33
5836,0,URS0000D67925_12908/1-33,AUAGGGGAAGCUGAAAACCUUUUAGAGUAGGCG,11,7,11,4,33
5837,0,URS0000D65FD1_12908/1-33,AUAGGGAAAGCCGAAAACCUUUUAGAGUAGGCA,13,6,9,5,33
5838,0,URS0000D68B05_12908/1-33,AUAGGGAAAGCCGAAAACCUUUCAGAGUAGGCA,13,5,9,6,33
5839,0,URS0000D6B277_12908/1-33,AUAGGGGAAGCCGAAAACCUUUUAGAGUAGGCA,12,6,10,5,33
5840,0,URS0000D6B277_936370/1-33,AUAGGGGAAGCCGAAAACCUUUUAGAGUAGGCA,12,6,10,5,33
5841,0,URS0000D681F0_12908/1-33,AUAGGGGAUGCCGAAAACCUUUUAGAGUAGGUA,11,8,10,4,33
5842,0,URS0000D684E6_12908/1-33,AUAGGGGAUGCCGAAAACCUUAUAGAGUAGGCA,12,6,10,5,33
5843,0,URS0000D6C0A4_12908/1-34,AUAGGGGAUGCCGAAAACCUUAUUAGAGUAGGCA,12,7,10,5,34
5844,0,URS0000D6A4F7_12908/1-33,AUAGGGGAUGCCGAAAACCUUUCAGAGUAGGCA,11,6,10,6,33
5845,0,URS0000D69582_531844/1-35,AAAGGGGAAGCCGAAAACCUUUUUCAGAGUAGGCA,13,6,10,6,35
5846,0,URS0000D675C9_12908/1-33,AAAGGGGAAGCCGAAAACCUUUCAGAGUAGGCA,13,4,10,6,33
5847,0,URS0000D67315_12908/1-32,AUAGGGGAAGCCGAAAACCUUCAGAGUAGGCA,12,4,10,6,32
5848,0,URS0000D6BC08_12908/1-33,AUAGGGGAAGCCGAAAACCUUUCAGAGUAGGCA,12,5,10,6,33
5849,0,URS0000D6A963_12908/1-33,AUAGGGGAUGCCGAAAACCUUUCAGAGUAGGCG,10,6,11,6,33
5850,0,URS0000D6A392_12908/1-33,AUAGGGGACGCCGAAAACCUUACAGAGUAGGCA,12,4,10,7,33
5851,0,URS0000D6C669_12908/1-33,ACUGGGGAAGCUGAAAACCAUAUAGAGUAGGCA,13,5,10,5,33
5852,0,URS0000D6890B_12908/1-33,ACUGGGUAAGCCGAAAACCAUAUAGAGUAGGCA,13,5,9,6,33
5853,0,URS0000D6A923_12908/1-33,ACUGGGGAAGCCGAAAACCAUAUAGAGUAGGCA,13,4,10,6,33
5854,0,URS0000D6B987_12908/1-33,AAUGGGGAAGCCGAAAACCAUAUAGAGUAGGCA,14,4,10,5,33
5855,0,URS0000D67EDF_12908/1-33,AUUGGAGAAGCCGAAAACCAUAUAGAGUAGGCA,14,5,9,5,33
5856,0,URS0000D69E05_12908/1-33,AUUGGGAAAGCCGAAAACCAUAUAGAGUAGGCA,14,5,9,5,33
5857,0,URS0000D69E05_553177/1-33,AUUGGGAAAGCCGAAAACCAUAUAGAGUAGGCA,14,5,9,5,33
5858,0,URS0000D6D0AD_12908/1-33,AUUGGGAAAGCCGAAAACCAUAUAGAGUAGGCN,13,5,9,5,33
5859,0,URS0000D6B561_12908/1-33,AUUGGGAAAGCCGAAAACCAUUUAGAGUAGGCA,13,6,9,5,33
5860,0,URS0000D67792_12908/1-33,AUUGGGGAAGCCGAAAACCAUUUAGAGUAGGCA,12,6,10,5,33
5861,0,URS0000D67792_521097/1-33,AUUGGGGAAGCCGAAAACCAUUUAGAGUAGGCA,12,6,10,5,33
5862,0,URS0000D67792_873517/1-33,AUUGGGGAAGCCGAAAACCAUUUAGAGUAGGCA,12,6,10,5,33
5863,0,URS0000D6619D_12908/1-33,AUUGGGGAAGCCGAAAACCAUAUAGAGUAGGCA,13,5,10,5,33
5864,0,URS0000D6619D_1125721/1-33,AUUGGGGAAGCCGAAAACCAUAUAGAGUAGGCA,13,5,10,5,33
5865,0,URS0000D68675_12908/1-33,AUUGGGGAAUCCGAAAACCAUAUAGAGUAGGCA,13,6,9,5,33
5866,0,URS0000D687A0_12908/1-33,AUUGGGGAAGCUGAAAACCAUAUAGAGUAGGCA,13,6,10,4,33
5867,0,URS0000D69395_485918/1-36,UAUGGGGAAGCCGAAAACCAUCGAAGAGAGUAGGCA,14,4,12,6,36
5868,0,URS0000D6CA81_12908/1-33,AACGGGGAUGCUGAAAACCGAAUAGAGUAAGCA,14,4,10,5,33
5869,0,URS0000D6A09B_12908/1-33,AAAAGGGAAGCCGAAAACUUAAUAGAGUAGGCG,15,4,10,4,33
5870,0,URS0000D66983_12908/1-33,AAAAGGGAAGCCGAAAACUUUACAGAGUAGGCG,14,4,10,5,33
5871,0,URS0000D6D430_12908/1-33,AAAAGGGAAACCGAAAACUUUACAGAGUAGGUG,15,5,9,4,33
5872,0,URS0000D66623_12908/1-33,AAAAGGGAAGCCGAAAACUUUAUAGAGUAGGCA,15,5,9,4,33
5873,0,URS0000D69068_12908/1-33,AGAAGGGAAGCCGAAAACUUUAUAGAGUAGGCA,14,5,10,4,33
5874,0,URS0000D6655A_12908/1-33,UAAGGACAAGCCGAAAACCUUAUAGAGUAGGCA,14,5,8,6,33
5875,0,URS0000D676E0_12908/1-33,AUAGGGGAAGCCGAAAACCUGAUAGAGUAGGCA,13,4,11,5,33
5876,0,URS0000D65CDD_12908/1-33,GUAGGGGAAGCCGAAAACCUGAUAGAGUAGGCA,12,4,12,5,33
5877,0,URS0000D66C55_12908/1-33,GUAGGGGAAGCCGAAAACCUGAUAGAGUAGGUA,12,5,12,4,33
5878,0,URS0000D6C4DA_12908/1-33,GUAGGGGAAGCCGAAAACCUCAUAGAGUAGGUA,12,5,11,5,33
5879,0,URS0000D6C3AF_12908/1-33,AUAGGGGAAGCCGAAAACCUGAUAGAGUAGGUA,13,5,11,4,33
5880,0,URS0000D6B967_12908/1-33,AUAGGGGAAGCUGAAAACCUGAUAGAGUAAGCA,14,5,10,4,33
5881,0,URS0000D6BD59_12908/1-35,ACAGGGGAUGCUGAAAACCUGGGAUAGAGUAAGCA,13,5,12,5,35
5882,0,URS0000D65C48_12908/1-33,AACGGGGAAGCCGAAAACCUGAUAGAGUAGGCA,13,3,11,6,33
5883,0,URS0000D6AB1A_12908/1-33,ACCGGGGACGCUGAAAACCGAAAAGAGUAGGCA,13,2,11,7,33
5884,0,URS0000D6AFF9_12908/1-35,AAAGGGUAAGCCGAAAACCUUAAAAAGAGUAGGCA,17,4,9,5,35
5885,0,URS0000D6C78D_12908/1-33,AAGGGGCAAGCCGAAAACCUUAAAGAGUAGGCA,14,3,10,6,33
5886,0,URS0000D669D2_12908/1-37,ACCGGGGUAGCCGAAAACCGAUGAAACAGAGUAGGCA,14,3,12,8,37
5887,0,URS0000D69204_12908/1-33,ACCGGGGAAGCCGAAAACCGAAAAGAGUAGGCA,14,1,11,7,33
5888,0,URS0000D68A3D_886377/1-35,ACAGGGGAAGCCGAAAACCUAGAAAAGAGUAGGCA,16,2,11,6,35
5889,0,URS0000D6CB26_12908/1-34,CAAGGGGAAGCCGAAAACCUAAAAAGAGUAGGCA,16,2,10,6,34
5890,0,URS0000D6C59F_391587/1-33,AAAGGGGAAGCCGAAAAACUAAUAGAGUAGGCA,16,3,10,4,33
5891,0,URS0000D686E5_12908/1-36,AAAGGGGAAUGCCGAAAACCUAAAAUAGAGUAGGCA,17,4,10,5,36
5892,0,URS0000D6652B_867902/1-33,AAAGGGGAAGCCGAAAACCUUAUAGAGUAGGCA,14,4,10,5,33
5893,0,URS0000D6586A_12908/1-33,AAAGGCGAAGCCGAAAACCUUAUAGAGUAGGCG,13,4,10,6,33
5894,0,URS0000D6835B_12908/1-36,AAAGGGGAAGCCGAAAACCUUAUCAUAGAGUAGGCG,14,5,11,6,36
5895,0,URS0000D6C298_700598/1-33,UAAGGGGAAGCCGAAAACCUUAUAGAGUAGGCA,13,5,10,5,33
5896,0,URS0000D6696D_485918/1-37,UAGGGGGAAGCCGAAAACCUUCAGAACAGAGUAGGCA,14,4,12,7,37
5897,0,URS0000D67117_12908/1-35,AUAGGCGAAGCCGAAAACCUUAAAUAGAGUAGGCA,15,5,9,6,35
5898,0,URS0000D6C61F_12908/1-36,ACCGGGGUCGCCGAAAACCGGGUAAUAGAGUAGGCA,11,4,13,8,36
5899,0,URS0000D6B629_12908/1-33,ACCGGGGUAGCCGAAAACCGGAUAGAGUAGGCA,11,3,12,7,33
5900,0,URS0000D69E87_12908/1-33,AAAAGGGUAGCUGAAAACUUAAUAGAGUAGGCA,15,6,9,3,33
5901,0,URS0000D662C7_859657/1-35,CCCGGGGUCGCCGAAAACCGGAAAAAGAGUAGGCA,12,2,12,9,35
5902,0,URS0000D6A639_267608/1-36,CCCGGGGUCGCCGAAAACCGGAAAACAGAGUAGGCA,12,2,12,10,36
5903,0,URS0000D65BC9_859656/1-36,CCCGGGGUCGCCGAAAACCGGCAAACAGAGUAGGCA,11,2,12,11,36
5904,0,URS0000D65BC9_1031711/1-36,CCCGGGGUCGCCGAAAACCGGCAAACAGAGUAGGCA,11,2,12,11,36
5905,0,URS0000D65BC9_564066/1-36,CCCGGGGUCGCCGAAAACCGGCAAACAGAGUAGGCA,11,2,12,11,36
5906,0,URS0000D66782_12908/1-36,AACGGACAAGCCGAAAACCGUUUCAAAGAGUAGGCA,15,4,9,8,36
5907,0,URS0000D6CF6A_12908/1-35,AAAGGGUAAGCUGAAAACCUAAAAAAGAGUAAGCA,19,4,8,4,35
5908,0,URS0000D6AEC1_1149865/1-35,ACAGAAGAAGCUGAAAAUCUAUAACAGAGUAGGCA,17,5,8,5,35
5909,0,URS0000D69A6C_12908/1-39,ACAGAGUCUGCCGAAAAUCUGACGAUAACAGAGUAGGCA,15,6,10,8,39
5910,0,URS0000D6A569_12908/1-39,ACAGAGGAAGCCGAAAAUCUGACGAUAACAGAGUAGGCA,17,4,11,7,39
5911,0,URS0000D676B8_714943/1-35,ACAGGGUUAGCUGAAAACCUGUAAUAGAGUAGGCA,13,7,10,5,35
5912,0,URS0000D6C777_12908/1-34,AACGGGAAAGACCGAAAACCGAACAGAGUAGGCA,16,1,10,7,34
5913,0,URS0000D66D5E_12908/1-35,UGGGAGUACGCCGAAAAUCCUAUAAAGAGUAGGCA,13,6,10,6,35
5914,0,URS0000D6A638_525257/1-34,AUGGGGAAAGCCGAAAACCCGAUCAGAGUAGGCA,13,3,11,7,34
5915,0,URS0000D67615_12908/1-34,AAGGUGUAUCCGAAAAACCUAAAAAGAGUAAGAA,18,5,7,4,34
5916,0,URS0000D6D081_12908/1-34,AUGGAGGAACCGAAAAUCCCAAAUAGAGUAGGAA,16,4,9,5,34
5917,0,URS0000D657CE_12908/1-35,AAAGCAGAUUCCGAAAAGCUAAAAAAGAGUAGGAU,18,5,8,4,35
5918,0,URS0000D69B62_12908/1-34,GAAGCGGAUGCCGAAAAGCUUAAUAGAGUAGGCC,12,5,11,6,34
5919,0,URS0000D66F84_12908/1-34,GGAGCGGAUGCCGAAAAGCUUAAUAGAGUAGGCC,11,5,12,6,34
5920,0,URS0000D69B35_12908/1-33,GGAGCGGAUGCCGAAAAGCUAACAGAGUAGGCA,12,3,12,6,33
5921,0,URS0000D6ACA9_12908/1-33,GGAGCGUAUGCCGAAAAGCUUAUAGAGUAGGCG,10,6,12,5,33
5922,0,URS0000D66BB8_12908/1-38,GGAGCGGAUGCCGAAAAGCUUAUCUUAAAGAGUAGGCA,13,7,12,6,38
5923,0,URS0000D67FBD_12908/1-35,AAGGAAAAAGCCGAAAAUCCUGCAAAGAGUAGGCA,17,3,9,6,35
5924,0,URS0000D67650_12908/1-35,UAGGAGAUUUCUGAAAAUCCUUUAAAGAGUAGGGA,13,10,9,3,35
5925,0,URS0000D6721F_12908/1-35,UAGGAGAUACCUGAAAAUCCUUUAAAGAGUAGGGA,14,8,9,4,35
5926,0,URS0000D66DB0_12908/1-35,AAGGAGAUACCUGAAAAUCCUUUAAAGAGUAGGGA,15,7,9,4,35
5927,0,URS0000D66B88_12908/1-34,AAAGCGGAACCCGAAAAGCUAUUUAGAGUAGGGA,14,5,10,5,34
5928,0,URS0000D668A0_485917/1-35,AAUGAGGAAGCCGAAAAUCAAUAACAGAGUAGGCA,17,4,9,5,35
5929,0,URS0000D670AE_12908/1-38,AUGGAGGAAGCCGAAAAUCCAAUCUAACAGAGUAGGCA,16,5,10,7,38
5930,0,URS0000D66628_12908/1-35,GUGGAGGAAGUCGAAAAUCCAUAAAAGAGUAGGCA,15,5,11,4,35
5931,0,URS0000D69FED_12908/1-36,CAGGCAGAACCCGAAAAGCCUUGAACAGAGUAGGGA,14,3,11,8,36
5932,0,URS0000D661C0_12908/1-36,AAGGCCGAACCCGAAAAGCCUUGAACAAAGUAGGGA,15,3,10,8,36
5933,0,URS0000D699D0_525257/1-35,AAGGCAGCACCCGAAAAGCCGGAACAGAGUAGGGA,14,1,12,8,35
5934,0,URS0000D6C3A1_12908/1-35,AAGGCAGAACCCGAAAAGCCGAAACAGAGUAGGGA,16,1,11,7,35
5935,0,URS0000D69891_269798/1-35,AAGGCGGAAACCGAAAAGCCCUGAAAGAGUAGGUA,15,3,11,6,35
5936,0,URS0000D65C39_12908/1-35,AUGGCAGUAUCCGAAAAGCCCAAACAGAGUAGGAA,15,4,9,7,35
5937,0,URS0000D6B17C_12908/1-35,AUGGCAGGAUCCGAAAAGCCCAAACAGAGUAGGAA,15,3,10,7,35
5938,0,URS0000D68C70_12908/1-35,AUGGAGGGUGCCGAAAAUCCAAUAAAGAGUAGGCA,14,5,11,5,35
5939,0,URS0000D690F0_12908/1-35,ACGGCGGAUUCCGAAAAGCCGGAAAAGAGUAGGAG,13,3,13,6,35
5940,0,URS0000D65801_12908/1-35,AAGGAGUAUUCUGAAAAUCCUAAAAAGAGUAAGAA,18,7,7,3,35
5941,0,URS0000D6B225_12908/1-35,ACGGAGGCCGCCGAAAAUCCAGAACAGAGUAGGCA,13,2,11,9,35
5942,0,URS0000D6CB8F_12908/1-35,AAGGAGGCCGCCGAAAAUCCGGAAAAGAGUAGGCA,14,2,12,7,35
5943,0,URS0000D6B037_12908/1-35,ACGGAGGCCACCGAAAAUCCGGAAAAGAGUAGGCG,13,2,12,8,35
5944,0,URS0000D6B044_12908/1-35,ACGGAGUCGGCCGAAAAUCCGGAAAAGAGUAGGCG,12,3,13,7,35
5945,0,URS0000D6D310_12908/1-36,CAAGGGGAUGCCGAAAACCUUAUCAAAGAGUAGGCA,14,5,10,7,36
5946,0,URS0000D6A87A_12908/1-33,GUAGGGGAUGCCGAAAACCUCAAAGAGUAGGCA,12,4,11,6,33
5947,0,URS0000D686E3_12908/1-35,CAAGGGGAUUCCGAAAACCUUUGAAAGAGUAGGAA,14,6,10,5,35
5948,0,URS0000D66E1B_12908/1-37,UAAGGGGAAUCUGAAAACCUUUUUAAUAGAGUAGGAA,15,10,9,3,37
5949,0,URS0000D6CB35_12908/1-35,CAAGGGGAACCGAAAACCUUUUAAAAGAGUAGGAA,16,5,9,5,35
5950,0,URS0000D6B3BD_12908/1-35,AUGGAGGAUGCCGAAAAUCCAAAGAAGAGUAGGCG,14,4,12,5,35
5951,0,URS0000D671E1_12908/1-36,ACGGAGUGUGCCGAAAAUCCGAUCAUAGAGUAGGCA,12,6,11,7,36
5952,0,URS0000D6BBD2_12908/1-36,ACGGAGUCUGCCGAAAAUCCGAUCAAAGAGUAGGCA,13,5,10,8,36
5953,0,URS0000D69717_12908/1-36,UUGGAGUAUGCCGAAAAUCCGAACAAAGAGUAGGCA,14,6,10,6,36
5954,0,URS0000D69E95_12908/1-35,AUGGAAGUAGCCGAAAAUCCAACAAAGAGUAGGCA,16,4,9,6,35
5955,0,URS0000D66B2C_12908/1-35,UUGGAAGAAGCCGAAAAUCCAACAAAGAGUAGGCA,16,4,9,6,35
5956,0,URS0000D6A9C3_12908/1-36,AUGGAGUUAUGCCGAAAAUCCAACAAAGAGUAGGCA,15,6,9,6,36
5957,0,URS0000D65939_12908/1-35,AUGGAGAAGGCCGAAAAUCCAACAAAGAGUAGGCG,15,3,11,6,35
5958,0,URS0000D6CD6B_12908/1-35,AUGGAGAAGGCCGAAAAUCCAACAAAGAGUAGGCA,16,3,10,6,35
5959,0,URS0000D66342_12908/1-35,ACGGAGUAUGCUGAAAAUCCGACAAAGAGUAGGCA,14,5,10,6,35
5960,0,URS0000D65878_12908/1-35,ACGGAGAAUGCCGAAAAUCCGACAAAGAGUAGGCA,15,3,10,7,35
5961,0,URS0000D68B7A_12908/1-35,AAGGAGAUUGCCGAAAAUCCGAUAAAGAGUAGGCA,15,5,10,5,35
5962,0,URS0000D69146_12908/1-35,ACGGAGUUUGCCGAAAAUCCGAUAAAGAGUAGGCA,13,6,10,6,35
5963,0,URS0000D6B47C_12908/1-35,AAGGAGGCAUCCGAAAAUCCUGAAGAGAGUAGGAA,15,4,11,5,35
5964,0,URS0000D6A03D_12908/1-35,AAGGCGGAUCCCGAAAAGCCGUAACAGAGUAAGGA,14,3,11,7,35
5965,0,URS0000D6B9BC_12908/1-35,AAGGAGUAAGCUGAAAAUCCUUAGAAGAGUAGGCA,15,6,10,4,35
5966,0,URS0000D6AB71_700598/1-38,AAGGAGUAAUGCUGAAAAUCCUUAUAAAAGAGUAAGCA,18,8,8,4,38
5967,0,URS0000D6882B_12908/1-35,AAGGAGUAAGCUGAAAAUCCUGCAAAGAGUAAGCA,16,5,9,5,35
5968,0,URS0000D6B1C0_12908/1-35,AAGGAGUUUGCCGAAAAUCCUUAAAAGAGUAAGCA,15,7,8,5,35
5969,0,URS0000D669E9_12908/1-35,CAGGAGUAGUCCGAAAAUCCUUAAAAGAGUAGGGA,14,6,10,5,35
5970,0,URS0000D69E03_12908/1-35,AAGGAAGCAGCCGAAAAUCCUUAAAAGAGUAGGCG,15,4,10,6,35
5971,0,URS0000D661A6_12908/1-36,AAGGCCGAAUCCGAAAAGCCGGGAAGAGAGUAGGAA,15,2,13,6,36
5972,0,URS0000D65F73_12908/1-35,GCGGAGGUUGCCGAAAAUCCGGGAAAGAGUAGGCG,10,4,15,6,35
5973,0,URS0000D6C9B8_12908/1-35,AAGGAGUUCGCCGAAAAUCCUUUGAAGAGUAGGCA,12,7,10,6,35
5974,0,URS0000D678A1_12908/1-35,AAGGAGAAUGCCGAAAAUCCUGUGAAGAGUAGGCA,14,5,11,5,35
5975,0,URS0000D67860_12908/1-35,AAGGAGUAUGCCGAAAAUCCUAUGAAGAGUAGGCA,14,6,10,5,35
5976,0,URS0000D67515_1144313/1-34,AUGGAGGAAGCCGAAAAGCCAAAAAGAGUAGGUA,16,3,11,4,34
5977,0,URS0000D67515_12908/1-34,AUGGAGGAAGCCGAAAAGCCAAAAAGAGUAGGUA,16,3,11,4,34
5978,0,URS0000D67DF8_12908/1-35,ACGGAGGAAGCCGAAAAGCCAAAAAAGAGUAGGUA,17,2,11,5,35
5979,0,URS0000D6A77A_12908/1-36,ACGGAGGAAGUCGAAAAUCCAUAAAGAGAGUAGGUA,16,5,11,4,36
5980,0,URS0000D66D0C_12908/1-35,ACGGAGUAAGCUGAAAAUCCGGUAAAGAGUAGGCA,14,5,11,5,35
5981,0,URS0000D667BD_12908/1-35,ACGGAGUAAGCCGAAAAUCCGAUAAAAAGUAGGCA,16,4,9,6,35
5982,0,URS0000D6CD9D_391587/1-37,CAGGCGGUAAUCCGAAAAGCCUUGAUUAGAGUAGGAA,13,7,11,6,37
5983,0,URS0000D68E43_12908/1-36,GAGGAGGAAUCCGAAAAGCCUUGAUUAGAGUAGGAA,14,6,12,4,36
5984,0,URS0000D6C0EB_12908/1-35,UUGGAGCAAGCCGAAAAUCCUGAAAAGAGUAGGCA,14,5,10,6,35
5985,0,URS0000D67537_485918/1-35,AUGGCGUAUACCGAAAAGCCUGAAAAGAGUAGGUA,14,6,10,5,35
5986,0,URS0000D68F7C_391598/1-32,AUGGUGUAUUCCGAAAAACCAAAGAGUAGGAA,14,6,8,4,32
5987,0,URS0000D65972_12908/1-35,AUGGUGGAAUCCGAAAAACCAUAAAAGAGUAGGAA,17,5,9,4,35
5988,0,URS0000D69C26_12908/1-36,UUGGUGGAAUCCGAAAAACCAAAAACAGAGUAGGAA,17,5,9,5,36
5989,0,URS0000D6B1E0_313606/1-36,UAGGCGGUUGCCGAAAAGCCUUGAAGAGAGUAGGUA,11,7,13,5,36
5990,0,URS0000D669A0_12908/1-36,AGCGAGGAAGCCGAAAAUCGCAUCAAAGAGUAGGCA,15,3,11,7,36
5991,0,URS0000D66ECF_12908/1-35,UGGGCGGAAUCCGAAAAGCCAUAACAGAGUAGGAA,14,4,11,6,35
5992,0,URS0000D6A73A_12908/1-38,AAGGAGGAAACCGAAAAUCCUAUUGAACAGAGUAGGUA,17,6,10,5,38
5993,0,URS0000D694C2_12908/1-35,AAGGAGGCAGCCGAAAAUCCUGUAAAGAGUAGGCA,14,4,11,6,35
5994,0,URS0000D67471_12908/1-35,AUGGAAAAAGCCGAAAAUCCCAAAAAGAGUAGGCA,18,3,8,6,35
5995,0,URS0000D6A87E_12908/1-36,GCGGAGUAAGCCGAAAAUCCGAUAAAAGAGUAGGCU,14,5,11,6,36
5996,0,URS0000D67DB1_12908/1-37,AAGGAGAAAACCGAAAAUCCAACUAAAAGAGUAGGUG,19,4,9,5,37
5997,0,URS0000D6C037_12908/1-35,AAAGAGAAAACCGAAAAUCUUUAAAAGAGUAGGGA,19,5,8,3,35
5998,0,URS0000D663EA_12908/1-35,UAAGAGAAAGCCGAAAAUCUUUAAAAGAGUAGGUA,17,7,8,3,35
5999,0,URS0000D6B393_12908/1-35,AUGGAGAAUGCCGAAAAUCCAAAAUAGAGUAGGUA,16,6,9,4,35
6000,0,URS0000D6C421_12908/1-35,AAAGCGGAAUCCGAAAAGCUUAAAAAGAGUAGACU,17,5,8,5,35
6001,0,URS0000D66EB5_12908/1-35,AAGGCGGAACCCGAAAAGCCGGAAUAGAGUAGGGC,13,2,13,7,35
6002,0,URS0000D6809F_12908/1-37,CAGGUGGAUGCCGAAAAGCCUCAGAAAAGAGUAGGUG,13,5,13,6,37
6003,0,URS0000D67443_12908/1-37,AUGGAGCAAGCCGAAAAUCCGCAAAAUAGAGUAGGCA,16,4,10,7,37
6004,0,URS0000D68139_12908/1-40,AAGGCGUAACCCGAAAAGCCAAUAGCCAAUAGAGUAGGGA,17,4,11,8,40
6005,0,URS0000D6D03F_12908/1-35,AUAGCGGAUACCGAAAAGCUAAGAUAGAGUAGGUA,15,6,10,4,35
6006,0,URS0000D6C136_12908/1-35,UAGGCGAAACCCGAAAAGCCAUAAAAGAGUAGGGC,15,3,10,7,35
6007,0,URS0000D69B7A_12908/1-38,AAGGAGUAAGCUGAAAAUCCUUAUUAAUAGAGUAAGUA,17,10,8,3,38
6008,0,URS0000D679AB_12908/1-36,CCGGAGGAAUCCGAAAAGCCGAUAAAUGAGUAGGAA,15,4,11,6,36
6009,0,URS0000D6C028_12908/1-35,CAGGAGGAAGCUGAAAAUCCGUAAGAGAGUAGGCA,14,4,12,5,35
6010,0,URS0000D6AD8A_12908/1-35,UAGGAGGAAGCUGAAAAUCCGUAAGAGAGUAGGCA,14,5,12,4,35
6011,0,URS0000D657F4_12908/1-35,AAGGCGGCAGCCGAAAAGCCAUAACAGAGUAGGCA,14,2,11,8,35
6012,0,URS0000D6962C_12908/1-35,CUGGAGGAUGCCGAAAAUCCAUAAAAGAGUAGGUA,14,6,10,5,35
6013,0,URS0000D67E9A_12908/1-35,AUGGACGAUGCCGAAAAUCCAGAAAAGAGUAGGCA,15,4,10,6,35
6014,0,URS0000D6A94A_12908/1-35,AAGGAGGAUGCCGAAAAUCCUGAAGAGAGUAAGCG,14,4,12,5,35
6015,0,URS0000D6AE4B_12908/1-35,AAGGAGGAAGUCGAAAAUCCAUAAAAGAGUAGACA,18,4,9,4,35
6016,0,URS0000D68EC6_12908/1-35,AAGGUGAAACCCGAAAAACCUUUAAAGAGUAGGGA,16,5,9,5,35
6017,0,URS0000D6CE4B_12908/1-35,AAGGCGUCCCCGAAAAGCCUGUAACAGAGUAGGGA,12,4,11,8,35
6018,0,URS0000D6666D_12908/1-35,AGGGAGUCUGCCGAAAAUCCUUAACAGAGUAGGCG,11,6,11,7,35
6019,0,URS0000D6B9A8_12908/1-36,AGGGAAGAAUGCUGAAAAUCCUUAACAGAGUAGGCA,15,6,10,5,36
6020,0,URS0000D6970E_12908/1-35,UGGGAAGAUGCCGAAAAUCCUUAACAGAGUAGGCA,13,6,10,6,35
6021,0,URS0000D67831_12908/1-35,ACAGCGAAUUCCGAAAAGCUGAAACAGAGUAGGAA,16,4,9,6,35
6022,0,URS0000D69D96_12908/1-35,AAGGAGAAGGCCGAAAAUCCGGAAAAGAGUAGGUG,15,3,13,4,35
6023,0,URS0000D69232_12908/1-35,UAGGCGGAUAUCGAAAAGCCUUAAUAGAGUAGAUA,14,8,9,4,35
6024,0,URS0000D66FCA_12908/1-35,AUGGCGUAACCGAAAAGCCAAAAAUAGAGUAGGAC,16,4,9,6,35
6025,0,URS0000D66F92_12908/1-35,ACGGACGAUGCCGAAAAUCCGAAACAGAGUAGGCA,14,3,10,8,35
6026,0,URS0000D67A4D_12908/1-38,ACGGAGGAUGCCGAAAAUCCGAUAUAACAGAGUAGGCU,14,6,11,7,38
6027,0,URS0000D65F4F_12908/1-35,AUAGCGGAAGCCGAAAAGCUAUAAUAGAGUAAACA,17,5,8,5,35
6028,0,URS0000D69D36_12908/1-40,AAGGGGAAAGCCGAAAACCCUCGUAUUAACAGAGUAGGCA,16,5,11,8,40
6029,0,URS0000D6854D_12908/1-35,AUGGCGAAAACCGAAAAGCCAACAAAGAGUAGGUA,17,3,9,6,35
6030,0,URS0000D6CDD4_12908/1-35,AUGGCGGAAACCGAAAAGCCAGCAAUGAGUAGGUA,14,4,11,6,35
6031,0,URS0000D6CDD4_553175/1-35,AUGGCGGAAACCGAAAAGCCAGCAAUGAGUAGGUA,14,4,11,6,35
6032,0,URS0000D6C379_12908/1-35,AUGGCGGAAACCGAAAAGCCAGCAAUGAGUAGGUG,13,4,12,6,35
6033,0,URS0000D66BFF_12908/1-35,AUGGCGGAAACCGAAAAGCCAACAAUGAGUAGGUA,15,4,10,6,35
6034,0,URS0000D6BE3E_12908/1-35,AAGGAGGUAGCCGAAAAUCUUAAAAAGAGUAGGUA,16,6,10,3,35
6035,0,URS0000D6A75B_12908/1-35,ACAGAGGGCCCCGAAAAUCUUUAAAAGAGUAGGGA,14,5,10,6,35
6036,0,URS0000D6619A_12908/1-35,ACAGAGGGGGCCGAAAAUCUUUAAAAGAGUAGGGA,14,5,12,4,35
6037,0,URS0000D687B7_12908/1-35,AAGGAGGAGGCUGAAAAUCCUGAACAGAGUAGGCU,13,5,12,5,35
6038,0,URS0000D6CDCB_391587/1-35,CAGGCGGAAUCUGAAAAGCCUUAACAGAGUAAGAA,15,5,9,6,35
6039,0,URS0000D6BE40_746697/1-37,AUGGAGGAACCCGAAAAGCCAGUUUAUAGAGUAGGGA,14,6,12,5,37
6040,0,URS0000D66C16_12908/1-36,UAGGCAGAAUCCGAAAAGCCAGAAAAAGAGUAGGAA,18,3,10,5,36
6041,0,URS0000D6D19A_12908/1-36,ACAGGGGAAUCCGAAAACCUGCGAAAAGAGUAGGAG,15,3,12,6,36
6042,0,URS0000D68350_12908/1-35,AAGGAGUAUGCCGAAAAUCCUGGAAAGAGUAGGCG,13,5,12,5,35
6043,0,URS0000D6B61A_12908/1-35,AUGGAGGAUGCCGAAAAUCCCGAAAAGAGUAGGCG,13,4,12,6,35
6044,0,URS0000D6B0A1_12908/1-35,CAGGAGAUUACCGAAAAUCCUUUAAAGAGUAGGUA,14,8,8,5,35
6045,0,URS0000D69C30_12908/1-36,UAGGAGGAAGCCGAAAAUCCAAUAAUAGAGUAGGUA,16,6,10,4,36
6046,0,URS0000D6CC65_391587/1-36,AAGGUGUAAUCCGAAAAACCUUUAACAGAGUAGGAA,16,7,8,5,36
6047,0,URS0000D6CDF7_12908/1-36,UAGGUGGAAUCCGAAAAACCUUCAACAGAGUAGGAA,15,6,9,6,36
6048,0,URS0000D6CF4B_12908/1-36,UAGGUGGAAUCCGAAAAGCCUUCAACAGAGUAGGAA,14,6,10,6,36
6049,0,URS0000D69315_12908/1-36,CAGGUGGAAUCCGAAAAGCCUUCAAUAGAGUAGGAA,14,6,10,6,36
6050,0,URS0000D6C889_12908/1-36,CAGGUGGAAUCCGAAAAGCCUUCAACAGAGUAGGAA,14,5,10,7,36
6051,0,URS0000D692B5_12908/1-36,CAGGUGGAAUCCGAAAAACCUUCAACAGAGUAGGAA,15,5,9,7,36
6052,0,URS0000D693EC_12908/1-36,CAGGUGGAAUCCGAAAAACCUUAAAAAGAGUAGGAA,17,5,9,5,36
6053,0,URS0000D6CA56_12908/1-36,CAGGUGGAAUCCGAAAAGCCUUAAAAAGAGUAGGAA,16,5,10,5,36
6054,0,URS0000D67FE0_12908/1-35,UAGGUGGAAUCCGAAAAACCGGAAAAGAGUAGGAA,16,4,11,4,35
6055,0,URS0000D6B94D_12908/1-35,UAGGUGGAAUCCGAAAAACCAGAAAAGAGUAGGAA,17,4,10,4,35
6056,0,URS0000D675DB_12908/1-35,UAGGUGGAAUCCGAAAAACUAGAAAAGAGUAGGAA,17,5,10,3,35
6057,0,URS0000D6C0DA_12908/1-37,CCGGUGGAAUCCGAAAAACCAUAGAAAAGAGUAGGAA,17,4,10,6,37
6058,0,URS0000D68AC7_12908/1-37,CCGGUGGAAUCCGAAAAACCAUAGAAGAGAGUAGGAA,16,4,11,6,37
6059,0,URS0000D6C87C_12908/1-36,CCGGUGGAAUCCGAAAAACCAUAAAGAGAGUAGGAA,16,4,10,6,36
6060,0,URS0000D65D83_12908/1-35,AAGGAGGAAACCGAAAAACCUUAAUAGAGUAGGUA,17,5,9,4,35
6061,0,URS0000D68687_12908/1-35,UAGGUGGAAACCGAAAAACCUUAAUAGAGUAGGUA,15,7,9,4,35
6062,0,URS0000D6B13E_12908/1-36,UAGGUGGAAACCGAAAAACCUUAAAUAGAGUAGGUA,16,7,9,4,36
6063,0,URS0000D67C1A_12908/1-36,UAGGUGGGAACCGAAAAACCUUAAAUAGAGUAGGUA,15,7,10,4,36
6064,0,URS0000D696C9_12908/1-36,CAGGUGGAAACCGAAAAACCUUAAUAAGAGUAGGUA,16,6,9,5,36
6065,0,URS0000D68A7B_12908/1-36,CAGGCGAAAUCCGAAAAGCCUUACAAAGAGUAGGAA,16,4,9,7,36
6066,0,URS0000D6D253_12908/1-38,AUGGACCAAGCCGAAAAUCCAUAUCAAAAGAGUAGGCA,17,5,8,8,38
6067,0,URS0000D6980E_1144316/1-36,AUGGCAAAUUCCGAAAAGCCAAUAAGAGAGUAGGAA,17,5,9,5,36
6068,0,URS0000D6D0F3_12908/1-36,ACGGAGAAAGCCGAAAAUCCUUCAACAGAGUAGGCA,15,4,9,8,36
6069,0,URS0000D6A4C9_12908/1-36,AAGACAAAAUCCGAAAAGCCUAAAAAAGAGUAGGAA,21,3,7,5,36
6070,0,URS0000D6AF88_12908/1-36,ACGGCGUCCUCCGAAAAGCCGAAGACAGAGUAGGAA,13,3,11,9,36
6071,0,URS0000D6A4B0_12908/1-36,ACGGUGGAUUCCGAAAAACCGAAGAAAGAGUAGGAA,16,4,11,5,36
6072,0,URS0000D66882_12908/1-36,ACGGCGAGUUCCGAAAAGCCGAAGAUAGAGUAGGAU,13,5,12,6,36
6073,0,URS0000D693BE_12908/1-36,ACGGCGGGUUCCGAAAAGCCGAAGAUAGAGUAGGAA,13,4,13,6,36
6074,0,URS0000D69ED8_12908/1-36,ACGGCGGGUUCCGAAAAGCCGACGAUAGAGUAGGAA,12,4,13,7,36
6075,0,URS0000D67E2D_12908/1-35,ACGGCGGGUCCGAAAAGCCGAUGAUAGAGUAGGAA,12,4,13,6,35
6076,0,URS0000D6C886_12908/1-36,ACGGCGGAUUCCGAAAAGCCGAAGAAAGAGUAGGAA,15,3,12,6,36
6077,0,URS0000D6C886_817/1-36,ACGGCGGAUUCCGAAAAGCCGAAGAAAGAGUAGGAA,15,3,12,6,36
6078,0,URS0000D6C886_862962/1-36,ACGGCGGAUUCCGAAAAGCCGAAGAAAGAGUAGGAA,15,3,12,6,36
6079,0,URS0000D68B77_12908/1-36,ACGGCGGAUUCCGAAAAGCCGAAUAAAGAGUAGGAA,15,4,11,6,36
6080,0,URS0000D6605E_12908/1-36,ACGGCGGGUUCCGAAAAGCCGAUUAAAGAGUAGGAA,13,5,12,6,36
6081,0,URS0000D681C9_12908/1-36,UAGGCGGAAUCCGAAAAGCCUAAGAAAGAGUAGGAG,15,4,12,5,36
6082,0,URS0000D6B372_12908/1-36,UGGGAGGCAUCCGAAAAUCCUUUAAAAGAGUAGGAA,14,7,10,5,36
6083,0,URS0000D6C696_12908/1-36,UGGGUGGAAUCCGAAAAUCCUUUAAUAGAGUAGGAA,13,9,10,4,36
6084,0,URS0000D6D3CF_12908/1-38,UAGGCGGAUUCUGAAAAGCCUGAUAGAAAGAGUAAGAA,16,7,11,4,38
6085,0,URS0000D69E41_12908/1-36,UAGGCGGAUUCUGAAAAGCCUAAGACAGAGUAGGAA,14,6,11,5,36
6086,0,URS0000D6B220_12908/1-36,GAGGCAGAAUCCUGAAAAGCCUAAAAAGAGUAGGGA,16,4,11,5,36
6087,0,URS0000D6B189_12908/1-39,AAGGCGAACCCGAAAAGCCUAUUUUAAACAGAGUAGGAA,17,6,9,7,39
6088,0,URS0000D657CB_761193/1-36,AAGGCAGUUUCUGAAAAGCCUGUAAGAGAGUAGGAA,14,7,11,4,36
6089,0,URS0000D6B14F_12908/1-36,AUGGAGUAACCCGAAAAUCCUAAGACAGAGUAGGGA,15,5,10,6,36
6090,0,URS0000D6B434_12908/1-36,AAGGUAGUAACCGAAAAACCUUUAACAGAGUAGGUA,16,7,8,5,36
6091,0,URS0000D68E22_12908/1-36,AAGGUAGUAACCGAAAAACCUUUAAUAGAGUAGGUA,16,8,8,4,36
6092,0,URS0000D698AD_12908/1-36,GGGGCGGGUUCCGAAAAGCCUAUGAUAGAGUAGGAA,11,6,14,5,36
6093,0,URS0000D67422_12908/1-38,CAGGAGGCUGCCGAAAAUCCUAUUUAACAGAGUAGGCU,12,8,10,8,38
6094,0,URS0000D66494_313606/1-38,AAGGCGGCACCUGAAAAGCCUCAAAAAUAGAGUAGGGA,16,4,11,7,38
6095,0,URS0000D6CAA0_12908/1-36,UAGGCGAAUCCCGAAAAGCCUUAGAUAGAGUAGGAA,14,6,10,6,36
6096,0,URS0000D67859_12908/1-36,CGGGCGGAAUCCGAAAAGCCCUUCAAAGAGUAGGAA,13,4,11,8,36
6097,0,URS0000D66113_12908/1-36,CCGGCGGGUUCCGAAAAGCCUGAAAGAGAGUAGGAA,12,4,13,7,36
6098,0,URS0000D65BBD_12908/1-36,UAGGCAGAUUCCGAAAAGCCUUGUAGAGAGUAGGAA,13,7,11,5,36
6099,0,URS0000D6A35D_12908/1-36,UAGGCAGAUUCCGAAAAGCCUUGUAGAGAGUAGGAG,12,7,12,5,36
6100,0,URS0000D65B8A_391587/1-36,AAGGAAGAAACCGAAAAUCCUAAAACAGAGUAGGUC,18,4,8,6,36
6101,0,URS0000D6BAAF_12908/1-36,AAGGCGAAUGCCGAAAAGCCUGUAACAGAGUAGGCC,13,4,11,8,36
6102,0,URS0000D66D35_553178/1-36,UAGACAAAACCCGAAAAGCCUGUAAAAGAGUAGGAA,18,4,8,6,36
6103,0,URS0000D6A469_12908/1-36,UAGGAGGAAGCCGAAAAUCCAGUAAGAGAGUAGGCG,14,4,13,5,36
6104,0,URS0000D68031_12908/1-37,GCGGAGGAAUCCGAAAAUCCGUAAAACAGAGUAGGGA,15,4,12,6,37
6105,0,URS0000D6B37B_12908/1-37,GCGGAGGAACCCGAAAAUCCGUAAAACAGAGUAGGGA,15,3,12,7,37
6106,0,URS0000D6CEFF_12908/1-37,GCGGAAAAACCCGAAAAUCCGUAAAACAGAGUAGGGA,17,3,10,7,37
6107,0,URS0000D692C6_12908/1-37,GCGGAGGGAUCCGAAAAUCCGUAGAAAAGAGUAGGAA,15,4,13,5,37
6108,0,URS0000D6BD2E_12908/1-41,ACGGCGUGUUCCGAAAAGCCGAAUGGUAAACAGAGUAGGAA,15,6,13,7,41
6109,0,URS0000D6A27E_12908/1-41,ACGGCGGAUUCCGAAAAGCCGGAUAGUGGAGAGAGUAGGAA,14,5,16,6,41
6110,0,URS0000D6B391_12908/1-41,ACGGCAGUUUCCGAAAAGCCGAAUAGUAAACAGAGUAGGAA,17,6,11,7,41
6111,0,URS0000D66927_12908/1-33,AUUGCGGAAGCCGAAAAGCAGGAAGAGUAGGCA,13,3,12,5,33
6112,0,URS0000D6B2BC_12908/1-33,UUUGCGGAAGCCGAAAAGCAUUCAGAGUAGGCA,11,6,10,6,33
6113,0,URS0000D6AB55_12908/1-33,UUUGCGGAAGCCGAAAAGCACACAGAGUAGGCA,12,4,10,7,33
6114,0,URS0000D66821_12908/1-33,GACGCGAAAGCCGAAAAGCGAAUAGAGUAGGCA,14,2,11,6,33
6115,0,URS0000D69385_12908/1-32,GAUGCGAAAGCCGAAAAGCAAUAGAGUAGGCA,14,3,10,5,32
6116,0,URS0000D68D36_12908/1-32,AAUGCGAAAGCCGAAAAGCAAAAGAGUAGGCA,16,2,9,5,32
6117,0,URS0000D6AE5F_525257/1-33,UAUGCGGAAGCCGAAAAGCAAAAAGAGUAGGUG,14,4,11,4,33
6118,0,URS0000D66AEA_376686/1-32,AAUGCGGAAGCCGAAAAGCAAAAGAGUAGGCG,14,2,11,5,32
6119,0,URS0000D66032_12908/1-34,AUGGAGUAACCGAAAAGCCAAAAAAGAGUAGGAA,18,3,9,4,34
6120,0,URS0000D67E4F_12908/1-33,AUAGCAGAAGCCGAAAAGCUUUUAGAGUAGGCA,13,6,9,5,33
6121,0,URS0000D696A9_12908/1-35,AUAGCAUAAGCCGAAAAGCUUUAAUAGAGUAGGCA,15,7,8,5,35
6122,0,URS0000D6A0AD_12908/1-37,ACGGACAAACCCGAAAAUCCGUAAAAAAGAGUAGGAA,19,3,8,7,37
6123,0,URS0000D6BCEC_12908/1-32,AGGGAGAAACCCGAAAAUCCAAAGAGUAGGAA,16,2,9,5,32
6124,0,URS0000D663B6_12908/1-40,ACGGAGAACCCGAAAAUCCGGACAUGAAAAAGAGUAGGAA,19,3,11,7,40
6125,0,URS0000D68C0A_12908/1-37,GCGGAGUAAUCCGAAAAUCCGUAAAAAAGAGUAGGAA,17,5,10,5,37
6126,0,URS0000D678C6_12908/1-35,AAGGAGUAUGCCGAAAAUCCUUCAAAGAGUAGGCA,14,6,9,6,35
6127,0,URS0000D6C92E_12908/1-35,AUAGCGUAAGCCGAAAAGCUAAAAAUGAGUAGGCA,16,5,9,5,35
6128,0,URS0000D6B4F9_12908/1-36,UUAGCGGAUGCCGAAAAGCUAUUCAAAGAGUAGGCA,13,7,10,6,36
6129,0,URS0000D6672C_12908/1-35,CAGGCGGAACCGAAAAGCCGGAAAUAGAGUAGGAA,15,2,12,6,35
6130,0,URS0000D688F4_12908/1-35,CGGGCGGAACCGAAAAGCCGGAAAUAGAGUAGGAA,14,2,13,6,35
6131,0,URS0000D6CC4A_12908/1-34,ACGGAAGAACCGAAAAUCCAGAAUAGAGUAGGAA,17,3,9,5,34
6132,0,URS0000D6B447_12908/1-34,ACGGAGGAACCGAAAAUCCAUAAUAGAGUAGGAA,16,4,9,5,34
6133,0,URS0000D6A8C2_12908/1-34,ACGGAGGAACCGAAAAUCCAUAAUAGAAUAGGAA,17,4,8,5,34
6134,0,URS0000D68D6E_1202532/1-32,AAGGAGAAACCGAAAAUCCUUAAGAGUAGGGA,15,4,9,4,32
6135,0,URS0000D6A57A_866536/1-36,AAGGAGAAAGCCGAAAAUCCUUAUUUAGAGUAGGCA,15,7,9,5,36
6136,0,URS0000D6A1E1_12908/1-35,GAGGUGGAAUCCGAAAAGCCUUAAAAGAGUAGGAG,14,5,12,4,35
6137,0,URS0000D67E97_12908/1-35,GAGGUGGAAUCCGAAAAACCUUAAAAGAGUAGGAG,15,5,11,4,35
6138,0,URS0000D69535_12908/1-36,CUGGCGGUAUCCGAAAAGCCAUAAACAGAGUAGGAA,14,5,10,7,36
6139,0,URS0000D6AEF9_12908/1-40,CUGGCGGAUUCCGAAAAGCCAAUAUUAAACAGAGUAGGAA,16,7,10,7,40
6140,0,URS0000D6B35B_12908/1-32,GAAGCGGAAGCCGAAAAGCUAGAGAGUAGGCA,13,2,12,5,32
6141,0,URS0000D6C11F_12908/1-32,AAAGCGUAACUGAAAAGCUUAUAGAGUAGGAG,14,6,9,3,32
6142,0,URS0000D6A473_929704/1-41,AGGGCGUAUUCCGAAAAGCCCGAUUUUGAACAGAGUAGGAA,14,8,12,7,41
6143,0,URS0000D67715_12908/1-36,AAGGCGUAUUUCCGAAAAGCCAUAACAGAGUAGGAG,14,6,10,6,36
6144,0,URS0000D686EE_12908/1-32,AAUGCGGAAGCCGAAAAGCAAAUGAGUAGGCA,14,3,10,5,32
6145,0,URS0000D6C94B_12908/1-36,AUGGCGGAAUCCGAAAAGCCAAAGAUAGAGUAGGAA,16,4,11,5,36
6146,0,URS0000D67DB9_12908/1-41,GGGGCGGAUUCCGAAAAGCCUGAUGAUAAACAGAGUAGGAA,15,6,14,6,41
6147,0,URS0000D6819D_886377/1-35,AUGGCGGAUUCCGAAAAGCCAGAAUAGAGUAGGAA,14,5,11,5,35
6148,0,URS0000D6D274_12908/1-32,AAGGCGGAACCGAAAAGCCUUACGAGUAGGAA,13,3,10,6,32
6149,0,URS0000D66C69_391587/1-36,ACGGCGGAAUCCGAAAAGCCAUAAAUAGAGUAGGUU,14,6,10,6,36
6150,0,URS0000D6B444_12908/1-36,UGGGCGGGUUCCGAAAAGCCAGGAAAAGAGUAGGAA,13,4,14,5,36
6151,0,URS0000D6C279_12908/1-36,UAGGCGGAUUCUGAAAAGCCUUGGAGAGAGUAGGAG,11,7,14,4,36
6152,0,URS0000D6CECB_12908/1-36,UAGGCGGAUUCCGAAAAGCCUUAGAGAGAGUAGGAG,12,6,13,5,36
6153,0,URS0000D67666_12908/1-36,CAGGCGGGUUCCGAAAAGCCUAAGACAGAGUAGGAA,13,4,12,7,36
6154,0,URS0000D6A32B_12908/1-36,CAGGCGGGUUCCGAAAAGCCUAAGAUAGAGUAGGAA,13,5,12,6,36
6155,0,URS0000D6858D_12908/1-36,UGGGCGGGUUCCGAAAAGCCUGGAAUAGAGUAGGAA,11,6,14,5,36
6156,0,URS0000D6AA43_12908/1-36,UAGGCGGGUUCCGAAAAGCCUAAGAAAGAGUAGGAA,14,5,12,5,36
6157,0,URS0000D663DA_12908/1-36,UAGGCGAGUUCCGAAAAGCCUUAGAAAGAGUAGGAA,14,6,11,5,36
6158,0,URS0000D67510_12908/1-36,UAGGCGGGUUCCGAAAAGCCUUUGAAAGAGUAGGAG,11,7,13,5,36
6159,0,URS0000D685C2_12908/1-36,UAGGCGGGUUCCGAAAAGCCUUUGAAAGAGUAGGAA,12,7,12,5,36
6160,0,URS0000D67A62_12908/1-36,UAGGCGGAUUCCGAAAAGCCUUUGAAAGAGUAGGAA,13,7,11,5,36
6161,0,URS0000D660A2_12908/1-36,UAGGCGGGUUCCGAAAAGCCUUGGAUAGAGUAGGAA,11,7,13,5,36
6162,0,URS0000D6B44E_12908/1-36,UAGGCGGGUUCCGAAAAGCCUUGGAGAGAGUAGGAA,11,6,14,5,36
6163,0,URS0000D672AD_457424/1-36,UAGGCGGGUUCCGAAAAGCCUUUAAGAGAGUAGGAA,12,7,12,5,36
6164,0,URS0000D6B55E_12908/1-36,UAGGCGGGUUCCGAAAAGCCUUUGAGAGAGUAGGAA,11,7,13,5,36
6165,0,URS0000D6C20D_12908/1-36,UAGGCGGGUUCUGAAAAGCCUUGAAUAGAGUAGGAA,12,8,12,4,36
6166,0,URS0000D6B135_12908/1-36,UAGGCGGAUUCCGAAAAGCCUUGAAUAGAGUAGGAA,13,7,11,5,36
6167,0,URS0000D6B135_457424/1-36,UAGGCGGAUUCCGAAAAGCCUUGAAUAGAGUAGGAA,13,7,11,5,36
6168,0,URS0000D6854A_12908/1-36,UAGGCGGAUUCCGAAAAGCCUGGAAUAGAGUAGGAA,13,6,12,5,36
6169,0,URS0000D67AD3_12908/1-36,UAGGCGGAUUCCGAAAAGCCUGGAAGAGAGUAGGAA,13,5,13,5,36
6170,0,URS0000D67296_12908/1-36,UAGGUGGGUUCCGAAAAGCCUUGAAUAGAGUAGGAA,12,8,12,4,36
6171,0,URS0000D65E15_12908/1-36,UAGGCGGGUUCCGAAAAGCCUUGAAUAGAGUAGGAA,12,7,12,5,36
6172,0,URS0000D6A6E0_12908/1-36,UAGGCGGGUUCCGAAAAGCCGAAAAGAGAGUAGGAG,13,4,14,5,36
6173,0,URS0000D6AEE8_12908/1-36,UAGGCGGGUUCCGAAAAGCCGAGAAGAGAGUAGGAA,13,4,14,5,36
6174,0,URS0000D67088_12908/1-36,UAGGCGGGUUCCGAAAAGCCGAAAAGAGAGUAGGAA,14,4,13,5,36
6175,0,URS0000D69673_12908/1-36,UAGGCGGGGUCCGAAAAGCCGAGAAAAGAGUAGGAA,14,3,14,5,36
6176,0,URS0000D69DC1_12908/1-36,UAGGCGGGUUCCGAAAAGCCGAGAAAAGAGUAGGAA,14,4,13,5,36
6177,0,URS0000D6B423_12908/1-38,UAGGCGGAUUCCGAAAAGCCGAGAAAAGAGAGUAGGAU,15,5,13,5,38
6178,0,URS0000D6A710_12908/1-36,UAGGCGAGUUCCGAAAAGCCGGAAAGAGAGUAGGAA,14,4,13,5,36
6179,0,URS0000D69CC3_12908/1-36,UAGGCGGAUUCCGAAAAGCCUGAAAGAGAGUAGGAG,13,5,13,5,36
6180,0,URS0000D69578_12908/1-36,UAGGCGGGUUCCGAAAAGCCUGAAAGAGAGUAGGAG,12,5,14,5,36
6181,0,URS0000D65AB0_12908/1-36,UAGGCGGGUUCCGAAAAGCCAGAAAGAGAGUAGGAG,13,4,14,5,36
6182,0,URS0000D68FB5_929562/1-36,AAGGAGCAACUCGAAAAUCCUGUAAAAGAGUAGGGG,15,5,11,5,36
6183,0,URS0000D68B81_12908/1-36,AAGGAGGAAUCCGAAAAUCCGAUAAAAGAGUAGGGA,17,4,11,4,36
6184,0,URS0000D6AB99_12908/1-35,AAAGAGGAUGCCGAAAAUCUUAGAUAGAGUAGGCU,14,7,10,4,35
6185,0,URS0000D6B133_12908/1-35,AAAGAAGAUGCCGAAAAUCUUAGAUAGAGUAGGCU,15,7,9,4,35
6186,0,URS0000D677BA_12908/1-35,AAGGAGUAGCCUGAAAAUCCUAAAAAGAGUAAGGA,17,5,9,4,35
6187,0,URS0000D6ADA0_12908/1-39,AAGGAGUAACCCUGAAAAUCCUUAAAAAAAGAGUAAGGA,20,6,8,5,39
6188,0,URS0000D6D35D_12908/1-33,GCGGCGGAAUCCGAAAAGCCGACAGAGUAGGAA,12,2,12,7,33
6189,0,URS0000D681EE_12908/1-33,AUAGCGGUAUCCGAAAAGCUCACAGAGUAGGAA,13,5,9,6,33
6190,0,URS0000D6C3AC_12908/1-33,CAAGCAGUAUCCGAAAAGCUUAUAGAGUAGGAA,14,6,8,5,33
6191,0,URS0000D6D386_12908/1-33,UACGCGGAAUCCGAAAAGCUUAUAGAGUAGGAA,13,6,9,5,33
6192,0,URS0000D6B7CF_12908/1-35,UUAGCGGAAUCCGAAAAGCUAUGACAGAGUAGGAA,14,6,10,5,35
6193,0,URS0000D66F86_12908/1-35,ACAGCGGAAUCCGAAAAGCUAUAAUAGAGUAGGAU,15,6,9,5,35
6194,0,URS0000D6914F_525257/1-33,AUAGCGGAAUCCGAAAAGCUUACAGAGUAGGAA,14,5,9,5,33
6195,0,URS0000D6663B_12908/1-32,AUAGCGGAACCGAAAAGCUUAUAGAGUAGGAA,14,5,9,4,32
6196,0,URS0000D684EA_12908/1-32,AUAGCGAAACCGAAAAGCUUAUAGAGUAGGAA,15,5,8,4,32
6197,0,URS0000D65EEC_12908/1-33,AAAGCGGAAUUCGAAAAGCUAAAAGAGUAGGAA,17,4,9,3,33
6198,0,URS0000D6804A_12908/1-33,AAAGCGGAAUCCGAAAAGCUAAUAAAGUAGGAA,17,4,8,4,33
6199,0,URS0000D68230_12908/1-36,AAAGCGGAAUCCGAAAAAGCUUGAAAAGAGUAGGAG,17,4,11,4,36
6200,0,URS0000D65855_12908/1-33,AAAGCAAAAUCCGAAAAGCUUAUAGAGUAGGAA,17,5,7,4,33
6201,0,URS0000D66DE6_12908/1-35,AAAGCGGCAUCCGAAAAGCUUCAAUAGAGUAGGAA,15,5,9,6,35
6202,0,URS0000D6C4E6_12908/1-33,AAAGCGGAAUCCAAAAAGCUAAAAGAGUAGGAA,18,3,8,4,33
6203,0,URS0000D67DF9_1144316/1-35,UAAGCGGAAUCCGAAAAGCUUCAAAAGAGUAGGAA,16,5,9,5,35
6204,0,URS0000D664D9_12908/1-35,CAAGCGGAAUCCGAAAAGCUUUAAUAGAGUAGGAA,15,6,9,5,35
6205,0,URS0000D6B80A_12908/1-35,AAAGCGGAAUCCGAAAAGCUUUAAUAGAGUAGGAA,16,6,9,4,35
6206,0,URS0000D6C1DF_12908/1-33,AAAGCGGAAUCCGAAAAGCUAAUAGAGUAGGAA,16,4,9,4,33
6207,0,URS0000D6C3B6_12908/1-34,AAAGCGGAAUCCGAAAAGCUAAAUAGAGUAGGAA,17,4,9,4,34
6208,0,URS0000D6B837_12908/1-33,AAAGCGGAAUCCGAAAAGCUAAAAGAGUAGGAA,17,3,9,4,33
6209,0,URS0000D65942_12908/1-34,AAAGCGGAAUCCGAAAAGCUAAAAAGAGUAGGAA,18,3,9,4,34
6210,0,URS0000D6BD2A_12908/1-35,AAAGCGGAAUCCGAAAAGCUUAAAAAGAGUAGGAA,18,4,9,4,35
6211,0,URS0000D65B1C_12908/1-35,AAAGCGGGAUCCGAAAAGCUUAAAAAGAGUAGGAA,17,4,10,4,35
6212,0,URS0000D6A5AB_12908/1-33,AAAGCAGAAUCCGAAAAGCUUAUAGAGUAGGAA,16,5,8,4,33
6213,0,URS0000D690C6_12908/1-33,ACAGCAGAAUCCGAAAAGCUUAUAGAGUAGGAA,15,5,8,5,33
6214,0,URS0000D6A1A5_12908/1-33,AAAGCGGUAUCCGAAAAGCUUAUAGAGUAGGAA,14,6,9,4,33
6215,0,URS0000D6B849_12908/1-33,AAAGCGGUGUCCGAAAAGCUAACAGAGUAGGAA,14,4,10,5,33
6216,0,URS0000D6ABDC_12908/1-35,AAAGCGGUAUCCGAAAAGCUUCAACAGAGUAGGAA,15,5,9,6,35
6217,0,URS0000D6679A_12908/1-33,AAAGCGGUGUCCGAAAAGCUAACAGAGUAGGAG,13,4,11,5,33
6218,0,URS0000D68C9B_12908/1-32,AAAGCGGAAACCGAAAAGCUUACGAGUAGGUA,14,4,9,5,32
6219,0,URS0000D6B9B2_12908/1-33,AAAGCGGAAACCGAAAAGCUUUACGAGUAGGUA,14,5,9,5,33
6220,0,URS0000D67EEF_525257/1-32,AAAGCGGAACCGAAAAGCUAAACGAGUAGGAA,16,2,9,5,32
6221,0,URS0000D6942F_12908/1-33,AAAGCGGAAACCGAAAAGCUAAACGAGUAGGUA,16,3,9,5,33
6222,0,URS0000D6B481_12908/1-32,GAAGAGGAACCGAAAAUCUUAAAGAGUAGGAA,16,4,9,3,32
6223,0,URS0000D6B5A8_12908/1-35,AGAGAGGAAUCCGAAAAUCUCAGAUAGAGUAGGAA,16,5,10,4,35
6224,0,URS0000D6BB40_12908/1-35,AAAGAGGAAUCCGAAAAUCUUUGAUAGAGUAGGAG,15,7,10,3,35
6225,0,URS0000D6ABF6_12908/1-35,CAAGAGGAAUCCGAAAAUCUAUGAUAGAGUAGGAA,16,6,9,4,35
6226,0,URS0000D6B5B1_12908/1-33,AAAGAGGAAUCCGAAAAUCUGAUAGAGUAGGAA,16,5,9,3,33
6227,0,URS0000D69048_12908/1-35,ACAGAGGAAUCCGAAAAUCUUGAAAAGAGUAGGAG,16,5,10,4,35
6228,0,URS0000D68E6C_12908/1-35,ACAGAGGAAUCCGAAAAUCUUGAAAAGAGUAGGAA,17,5,9,4,35
6229,0,URS0000D6B4C6_12908/1-35,AGAGAGGAAUCCGAAAAUCUUGAAAAGAGUAGGAA,17,5,10,3,35
6230,0,URS0000D6A84A_12908/1-35,ACAGAGGAAUCCGGAAAUCUUGAAAAGAGUAGGAA,16,5,10,4,35
6231,0,URS0000D6B599_12908/1-35,GCAGAGGAAUCCGAAAAUCUUGAAAAGAGUAGGAA,16,5,10,4,35
6232,0,URS0000D6B351_12908/1-35,AAAGAGGUAUCCGAAAAUCUUAAUAAGAGUAGGAA,17,7,8,3,35
6233,0,URS0000D6B662_12908/1-35,AAAGAGGUAUCCGAAAAUCUUUAAAAGAGUAGGAG,16,7,9,3,35
6234,0,URS0000D6CA2D_12908/1-35,AAAGAGGUAUCCGAAAAUCUUUAAAAGAGUAGGAA,17,7,8,3,35
6235,0,URS0000D68943_12908/1-35,AAAGAGGUAUCCGAAAAUCUUUAACAGAGUAGGAA,16,7,8,4,35
6236,0,URS0000D6BCD1_12908/1-35,AAAGAGGUAUCCGAAAAUCUUAAAAAGAGUAGGAA,18,6,8,3,35
6237,0,URS0000D663C9_12908/1-33,ACAGAGGUAUCCGAAAAUCUUAAAGAGUAGGAA,15,6,8,4,33
6238,0,URS0000D696BF_12908/1-36,CAAGAGGAAUCCGAAAAUCUUUUAAUAGAGUAGGAA,16,8,8,4,36
6239,0,URS0000D699A9_12908/1-33,AAAGAGGAAUCCGAAAAUCUUAUAGAGUAGGAA,16,6,8,3,33
6240,0,URS0000D65DCD_12908/1-33,AAAGAGGAAUCCGAAAAUCUUAAAGAGUAGGAA,17,5,8,3,33
6241,0,URS0000D6B3C2_12908/1-34,AAAGCGGAUUCCGAAAAGCUUUAUAGAGUAGGAA,14,7,9,4,34
6242,0,URS0000D68006_12908/1-34,GGAGCGGAUUCCGAAAAGCUUUAUAGAGUAGGAA,12,7,11,4,34
6243,0,URS0000D66D1E_12908/1-35,AAUGCGGAAUCCGAAAAGCUAUAACAGAGUAGGAA,16,5,9,5,35
6244,0,URS0000D6753F_391587/1-41,AUGGCGGAAUCCGAAAAGCCUUUAUAAAAACAGAGUAGGAA,18,7,10,6,41
6245,0,URS0000D6C36B_12908/1-33,AAUGCAGAAUCCGAAAAGCUAAAAGAGUAGGAA,17,4,8,4,33
6246,0,URS0000D69D19_12908/1-33,UAAGCGGAAUCCGAAAAGCUAGUAGAGUAGGAA,14,5,10,4,33
6247,0,URS0000D6A5B3_12908/1-34,ACAGAGGAACCCGAAAAUCUUAUAAGAGUAGGGA,15,5,9,5,34
6248,0,URS0000D68C48_12908/1-35,AAAGAGGAACCCGAAAAUCUUCAAAAGAGUAGGGA,17,4,9,5,35
6249,0,URS0000D6B5B7_12908/1-35,AAAGAGGGACCCGAAAAUCUUCAAAAGAGUAGGGA,16,4,10,5,35
6250,0,URS0000D6B773_12908/1-35,UAAGAGAAACCCGAAAAUCUUCAAAAGAGUAGGGA,17,5,8,5,35
6251,0,URS0000D6656C_12908/1-35,UAAGAGGAACCCGAAAAUCUUCAAAAGAGUAGGGA,16,5,9,5,35
6252,0,URS0000D6814E_12908/1-35,AAAGAGGAACCCGAAAAUCUUCAAAAGAGUAGAGA,18,4,8,5,35
6253,0,URS0000D6B1C3_702446/1-33,GUGGCGGAAUCCGAAAAGCCAAAAGAGUAGGAA,14,3,11,5,33
6254,0,URS0000D6CC8A_12908/1-33,AAUGCGAAAUCCGAAAAGCAUAUAGAGUAGGAA,16,5,8,4,33
6255,0,URS0000D6940D_12908/1-33,CAAGAGGAAGCCGAAAAUCUUAAAGAGUAGGCA,15,4,9,5,33
6256,0,URS0000D6B801_12908/1-33,CAAGAGGAUGCCGAAAAUCUUACAGAGUAGGCA,13,5,9,6,33
6257,0,URS0000D6D2D1_12908/1-33,CAAGAGGAUGCCGAAAAUCUUAUAGAGUAGGCA,13,6,9,5,33
6258,0,URS0000D66793_12908/1-33,UAAGAGGAUGCCGAAAAUCUUAUAGAGUAGGCA,13,7,9,4,33
6259,0,URS0000D680FB_12908/1-33,CAGGCGAAACCCGAAAAGCCAAACGAGUAGGAA,15,1,9,8,33
6260,0,URS0000D680F5_12908/1-35,AUGGCGGAACCCGAAAAGCCAGAAAAGAGUAGGGA,15,2,12,6,35
6261,0,URS0000D6A560_12908/1-33,AUGGCGGAACCCGAAAAGCCAAAAGAGUAGGGA,14,2,11,6,33
6262,0,URS0000D66B99_883098/1-34,AUGGCGGAAUCCCGAAAAGCCAAAAGAGUAGGGA,14,3,11,6,34
6263,0,URS0000D6CBDD_12908/1-36,AAGGAAAAACCCGAAAAUCCUUUAAUAGAGUAGGGA,17,6,8,5,36
6264,0,URS0000D6CBDD_888059/1-36,AAGGAAAAACCCGAAAAUCCUUUAAUAGAGUAGGGA,17,6,8,5,36
6265,0,URS0000D6682B_655815/1-34,UAGGAGAAGCCGAAAAUCCUUCAAAGAGUAGGUA,14,6,9,5,34
6266,0,URS0000D68877_12908/1-36,CAGGAGUAAACCGAAAAUCCUAUCAAAGAGUAGGUG,15,6,9,6,36
6267,0,URS0000D6C3A8_12908/1-36,AUGGAGGAAUCCGAAAAUCCUUUAAAAGAGUAGGGA,15,7,10,4,36
6268,0,URS0000D6C42F_12908/1-36,UAGGAGGAAUCCGAAAAUCCUUUAAAAGAGUAGGGA,15,7,10,4,36
6269,0,URS0000D6736B_12908/1-34,UAGGAGGAACCGAAAAUCCUUUAAAGAGUAGGGA,14,6,10,4,34
6270,0,URS0000D6961A_411154/1-34,UAGGAGAAGCCGAAAAUCCUAUAAAGAGUAGGUA,15,6,9,4,34
6271,0,URS0000D691E4_12908/1-34,UAGGAGAAACCGAAAAUCCUUUAAAGAGUAGGUA,15,7,8,4,34
6272,0,URS0000D6666B_12908/1-34,AAGGCGUAUCCGAAAAGCCUGAAAAGAGUAGGAA,15,4,10,5,34
6273,0,URS0000D6BDC8_12908/1-41,ACGGCGAGUUCCGAAAAGCCGGAUAGUAAACAGAGUAGGAA,16,5,13,7,41
6274,0,URS0000D6A949_12908/1-41,ACGGCGGAUUCCGAAAAGCCGGAUAGUAAACAGAGUAGGAA,16,5,13,7,41
6275,0,URS0000D6CB16_12908/1-41,ACGGCGGGUUCCGAAAAGCCGGAUAGUAAACAGAGUAGGAA,15,5,14,7,41
6276,0,URS0000D6D3E3_12908/1-35,AAGGCGGAGUCCGAAAAGCCUGAACAGAGUAGGAA,14,3,12,6,35
6277,0,URS0000D6895F_12908/1-32,AAGGCGGAUUCCGAAAAGCCAACGAGUAGGAA,13,3,10,6,32
6278,0,URS0000D68448_12908/1-41,ACGGCGGGUUCCGAAAAGCCGGAUAGUAAAGAGAGUAGGGA,14,5,16,6,41
6279,0,URS0000D6906D_12908/1-35,AAGGUAUAUCCGAAAAGCCUAAAAAAGAGUAGGAA,18,5,8,4,35
6280,0,URS0000D69AC6_391587/1-35,AAGGCGUAUUCCGAAAAGCCUAAAUAGAGUAGGAG,14,6,10,5,35
6281,0,URS0000D6850A_12908/1-35,AGGGCGGCAUCCGAAAAGCCCGAAAAGAGUAGGAA,14,2,12,7,35
6282,0,URS0000D6A2CE_525257/1-37,ACGGCAGCAUCCGAAAAGCCAUCAAAAAGAGUAGGAA,17,3,9,8,37
6283,0,URS0000D6BA9C_12908/1-35,AAGGCAAUAUCCGAAAAGCCUGAAAAGAGUAGGAA,17,4,9,5,35
6284,0,URS0000D6A6AD_12908/1-35,AAGGCGGCAUCCGAAAAGUCUGAAAAGAGUAGGAA,15,4,11,5,35
6285,0,URS0000D673A0_12908/1-35,AAGGCAGUAUCCGAAAAGCCUGAAAAGAGUAGGAA,16,4,10,5,35
6286,0,URS0000D6AEEA_12908/1-36,AAGGCGGUGUCCGAAAAGCCUUAAAAAGAGUAGGAA,15,5,11,5,36
6287,0,URS0000D6C8A0_12908/1-36,AAGGCGAUAUUCGAAAAGCCUAAAAAAGAGUAGGAA,18,5,9,4,36
6288,0,URS0000D6CAF5_12908/1-36,AAGGCGAUAUCCGAAAAGCCUAAAAAAUAGUAGGAA,18,5,8,5,36
6289,0,URS0000D658E3_12908/1-36,AAGGCGAUAUCCGAAAAGCCUGAAAAAGAGUAGGAA,17,4,10,5,36
6290,0,URS0000D689B6_12908/1-36,AAGGCGAUAUCCGAAAAGCCUUAAAAAGAGUAGGAA,17,5,9,5,36
6291,0,URS0000D68C59_12908/1-36,AAGGCGAUAUCCGAAAAGCCUAAAAAAGAGUAGGAA,18,4,9,5,36
6292,0,URS0000D65A18_12908/1-36,AAGGCGACAUCCGAAAAACCUAAAAAAGAGUAGGAA,19,3,8,6,36
6293,0,URS0000D66AE5_12908/1-35,AAGGCGACAUCCGAAAAGCCUAAAAAGAGUAGGAA,17,3,9,6,35
6294,0,URS0000D67EC6_12908/1-36,AAGGCGACAUCCGAAAAGCCUAAAAAAGAGUAGGAA,18,3,9,6,36
6295,0,URS0000D68C18_12908/1-36,AAGGCGGUAUCCGAAAAGCCUAAAAAAGAGUAGGAA,17,4,10,5,36
6296,0,URS0000D68EC9_12908/1-35,AAGGCGGUAUCCGAAAAGCCUAAAAAGAGUAGGAA,16,4,10,5,35
6297,0,URS0000D68DA2_12908/1-35,AAGGCGGCAUCCGAAAAGCCUAAAAAGAGUAGGAA,16,3,10,6,35
6298,0,URS0000D677EF_12908/1-37,AAGGCGGCAUCCGAAAAGCCUAAAAAAAGAGUAGGAA,18,3,10,6,37
6299,0,URS0000D6CF75_12908/1-36,AAGGCAGCAUCCGAAAAGCCUAAAAAAGAGUAGGAA,18,3,9,6,36
6300,0,URS0000D6BEB3_12908/1-35,AAGGCAGCAUCCGAAAAGCCUAAAAAGAGUAGGAA,17,3,9,6,35
6301,0,URS0000D681E8_12908/1-36,AAGGUGAUAUCCGAAAAGCCUAAAAAAGAAUAGGAA,19,5,8,4,36
6302,0,URS0000D6D080_12908/1-36,AAGGUGAUAUCCGAAAAGCCUAAAAAAGAGUAGGAA,18,5,9,4,36
6303,0,URS0000D693A9_12908/1-37,AAGGUGACAUCCGAAAAGCCUAAAAAAAGAGUAGGAA,19,4,9,5,37
6304,0,URS0000D673D9_12908/1-35,AAGGCGGUAUCCGAAAAGCCUGAAAAGAGUAGGAA,15,4,11,5,35
6305,0,URS0000D699DD_12908/1-35,AAGGCGGCAUCCGAAAAGCCUGAAAAGAGUAGGAA,15,3,11,6,35
6306,0,URS0000D67E81_12908/1-35,AAGGCAGCAUCCGAAAAGCCUGAAAAGAGUAGGAA,16,3,10,6,35
6307,0,URS0000D671D1_12908/1-35,AAGGCGGUAUCCAAAAAGCCUAAAAAGAGUAGGAA,17,4,9,5,35
6308,0,URS0000D6AE3E_12908/1-35,AAGGCGGCAUCCGAAAAGCCUAAAAAGAGUAGAAA,17,3,9,6,35
6309,0,URS0000D66B39_12908/1-36,AAGGUGGUAUCCGAAAAGCCUAAAAAAGAGUAGGUA,16,6,10,4,36
6310,0,URS0000D6737F_391587/1-41,UAGGCGGUAUCCGAAAAGCCUACAAUCAAAUAGAGUAGGAA,17,7,10,7,41
6311,0,URS0000D665DD_12908/1-35,UAGGCGGUAUCCGAAAAGCCUUAACAGAGUAGGAA,13,6,10,6,35
6312,0,URS0000D67B54_12908/1-36,UAGGCGGCAUCCGAAAAGCCCUUAACAGAGUAGGAA,13,5,10,8,36
6313,0,URS0000D6C428_12908/1-36,UAGGCAGCAUCCGAAAAGCCCUUAACAGAGUAGGAA,14,5,9,8,36
6314,0,URS0000D6AFBA_12908/1-36,UAGGCGGUAUCCGAAAAGCCCUUAACAGAGUAGGAA,13,6,10,7,36
6315,0,URS0000D68797_12908/1-35,ACGGCGGUAUCCGAAAAGCCUAAAAAGAGUAGGAG,14,4,11,6,35
6316,0,URS0000D67D0D_12908/1-35,AAGGCGGCAUCCGAAAAGCUUGAAAAGAGUAGAAA,16,4,10,5,35
6317,0,URS0000D6AFB4_12908/1-37,AAGGCGGUAACCGAAAAGCCUGAACAGAGAGUAGGUA,15,4,12,6,37
6318,0,URS0000D6A3ED_12908/1-35,AAGGCGGAACCCGAAAAGCCAUAAUAGAGUAGGGG,14,3,12,6,35
6319,0,URS0000D6A860_12908/1-35,AAGGCGGAACCCGAAAAGCCAUAACAGAGUAGGAG,15,2,11,7,35
6320,0,URS0000D69982_12908/1-35,AAGGCGGAACCCGAAAAGCCAUAACAGAGUAGGGG,14,2,12,7,35
6321,0,URS0000D6B49B_12908/1-36,ACGGCAGUAUCCGAAAAGCCAACAAAAGAGUAGGAA,17,3,9,7,36
6322,0,URS0000D689AB_12908/1-40,ACGGCAGAAUCCGAAAAGCCAAUUAAUAAAAGAGUAGGAA,20,5,9,6,40
6323,0,URS0000D6655E_12908/1-40,AUGGCAGAAUCCGAAAAGCCAACUAAUAAAAGAGUAGGAA,20,5,9,6,40
6324,0,URS0000D6C040_12908/1-40,ACGGCAGAAUCCGAAAAGCCAACUAAUAAAAGAGUAGGAA,20,4,9,7,40
6325,0,URS0000D69147_12908/1-34,AAGGCGUAUCCGAAAAGCCUAAAAAGAGUAGGAA,16,4,9,5,34
6326,0,URS0000D681FF_12908/1-35,AAGGCGUAUCCGAAAAGCCUUAAAAAGAGUAGGAA,16,5,9,5,35
6327,0,URS0000D6606A_12908/1-35,CAGGCGGAUACCGAAAAGCCUGAAAAGAGUAGGUA,14,4,11,6,35
6328,0,URS0000D6929F_12908/1-35,AUGGCGAAAACCGAAAAGCCUAAACAGAGUAGGUA,16,4,9,6,35
6329,0,URS0000D67389_12908/1-35,AAGGCGAAACCCAAAAAGCCUAAAAAGAGUAGGGA,18,2,9,6,35
6330,0,URS0000D661C7_12908/1-35,AAGGCGGCAACCGAAAAGCCUGAACAGAGUAGGNN,13,2,11,7,35
6331,0,URS0000D66AD0_12908/1-36,ACGGCGGAAUCCGAAAAGCCUUUUACAGAGUAGGAA,13,6,10,7,36
6332,0,URS0000D65C65_12908/1-41,AUGGCGGUUACCGAAAAGCCUAAUAGUAAACAGAGUAGGUA,16,8,11,6,41
6333,0,URS0000D6AB0C_12908/1-38,AAGGAGAAAGCCGAAAAUCCUAAUGAACAGAGUAGGUG,17,5,11,5,38
6334,0,URS0000D6BA3A_12908/1-35,AAGGAGAAAACCGAAAAUCCUAAACAGAGUAGGUG,17,4,9,5,35
6335,0,URS0000D6C530_12908/1-37,AAGGCGGUCACCGAAAAGCCUUUGAAUAGAGUAGGUG,12,7,12,6,37
6336,0,URS0000D66F95_12908/1-35,AAGGCGGAAACCGAAAAGCCCAAAUAGAGUAGGUA,16,3,10,6,35
6337,0,URS0000D6D1F1_12908/1-35,AAGGCGCAAACCGAAAAGCCUGAACAGAGUAGGUG,14,3,11,7,35
6338,0,URS0000D69356_746697/1-40,AAGGAGGAAACUGAAAAUCCUAUAAUAAAUAGAGUAGGUA,20,8,9,3,40
6339,0,URS0000D66942_12908/1-35,AAGGAGGAAACCGAAAAUCCUAAAUAGAGUAGGUG,16,5,10,4,35
6340,0,URS0000D6B8E0_12908/1-38,AAGGAGGAAACCGAAAAUCCUGAAAAAAAGAGUAGGUG,19,4,11,4,38
6341,0,URS0000D6C38D_12908/1-35,UAGGCGGAAACCGAAAAGCCUUGAUAGAGUAGGUA,13,6,11,5,35
6342,0,URS0000D6AF38_12908/1-35,UAGGCGGAAAUCGAAAAGCCUUGAUAGAGUAGGUA,13,7,11,4,35
6343,0,URS0000D67833_12908/1-36,AAGGCGGUAUCUGAAAAGCCUAUAAGAGAGUAAGAA,16,6,10,4,36
6344,0,URS0000D66EAE_12908/1-36,AAGGCGGUAUCUGAAAAGCCUGUAAUAGAGUAGGAG,13,7,12,4,36
6345,0,URS0000D6A9F3_12908/1-36,AAGGCGGUAUCUGAAAAGCCUAUAAUAGAGUAGGAA,15,7,10,4,36
6346,0,URS0000D6C3D5_12908/1-36,AAGGCGGUAUCUGAAAAGCCUAUAAUAGAGUAGGAG,14,7,11,4,36
6347,0,URS0000D68E75_12908/1-36,AAGACGGUAUCUGAAAAGCCUAUAAUAGAGUAGGAA,16,7,9,4,36
6348,0,URS0000D69D88_12908/1-36,AAGGCGAUAUCUGAAAAGCCUGUAAUAGAGUAGGAG,14,7,11,4,36
6349,0,URS0000D6589D_12908/1-36,AAGGCGCUAUCUGAAAAGCCUGUAAUAGAGUAGGAG,13,7,11,5,36
6350,0,URS0000D693E6_12908/1-36,AAAGCGGUAUCUGAAAAGCCUGUAAUAGAGUAGGAA,15,7,10,4,36
6351,0,URS0000D65B7A_12908/1-36,AAGGCGGUAUCUGAAAAGCCUGUAAUAGAGUAGGAA,14,7,11,4,36
6352,0,URS0000D67107_12908/1-35,AAGGCAGAUCCGAAAAGCCUAUAACAGAGUAAGAA,17,4,8,6,35
6353,0,URS0000D67E37_12908/1-35,AAGGCAGAUCCGAAAAGCCUAUAACAGAGUAGGAA,16,4,9,6,35
6354,0,URS0000D69F17_12908/1-36,AAGGCGGAACCUGAAAAGCCUAUAACAGAGUAGGAC,15,4,10,7,36
6355,0,URS0000D659D6_12908/1-36,AAGGCGAAUCCCGAAAAGCCUGUAAAAGAGUAGAAA,17,4,9,6,36
6356,0,URS0000D6AA9C_12908/1-36,AAGGUGUAUCCCCAAAAACCUGUAAUAGAGUAGGGA,14,7,9,6,36
6357,0,URS0000D6A141_12908/1-36,AAGGCGAAUCCCGAAAAGCCUAUAAAAGAGUAGGGA,16,4,10,6,36
6358,0,URS0000D6991D_12908/1-36,AAGGCGAAUCCCGAAGAGCCUAUAAUAGAGUAGGGA,14,5,11,6,36
6359,0,URS0000D666E0_12908/1-36,AAGGAGAAUCCCGAAAAGCCUAUAAGAGAGUAGGGA,16,4,11,5,36
6360,0,URS0000D68236_12908/1-36,AAGGUGAAUCCCGAAAAGCCUAUAAGAGAGUAGGGA,15,5,11,5,36
6361,0,URS0000D6916E_12908/1-39,AAGGCGUAUCCCGAAAAGCCUGUAUUAAAAGAGUAGGGA,15,7,11,6,39
6362,0,URS0000D6AC6A_12908/1-36,AAGGCGAAUCCUGAAAAGCCUGUAAGAGAGUAGGGA,14,5,12,5,36
6363,0,URS0000D6BB11_12908/1-36,UAGGCGAAACCCGAAAAGCCUGUAAUAGAGUAGGAG,14,5,11,6,36
6364,0,URS0000D68919_12908/1-36,UAGGCGCUACCCGAAAAGCCUGUAAUAGAGUAGGGA,12,6,11,7,36
6365,0,URS0000D6B2AC_12908/1-36,AAGGCGAAACUCGAAAAGCCUGUAAUAGAGUAGAGA,16,5,10,5,36
6366,0,URS0000D66684_12908/1-36,AAGGCAGUGCCCGAAAAGCCUAUAAUAGAGUAGGGA,14,5,11,6,36
6367,0,URS0000D68A5E_12908/1-36,AAGGCAGUGCCCGAAAAGCCUGUAAUAGAGUAGGGA,13,5,12,6,36
6368,0,URS0000D68A5E_706436/1-36,AAGGCAGUGCCCGAAAAGCCUGUAAUAGAGUAGGGA,13,5,12,6,36
6369,0,URS0000D65A46_12908/1-36,CAGGCGGAAACCGAAAAGCCCUGAAAAGAGUAGGUA,15,3,11,7,36
6370,0,URS0000D6A417_12908/1-36,GAGGCGAAAUCCCGAAAAGCCUAAAAAGAGUAGGGA,16,3,11,6,36
6371,0,URS0000D6AFD8_12908/1-36,AAGGCGAAAUCCUGAAAAGCCUAAAAAGAGUAGGGA,17,4,10,5,36
6372,0,URS0000D677B3_12908/1-36,AAGGCGGAAUCCUGAAAAGCCUAAAAAGAGUAAGGA,17,4,10,5,36
6373,0,URS0000D66B23_761193/1-38,AAGGCGAAACCUGAAAAGCCUAUGAAACAGAGUAGGGA,17,4,11,6,38
6374,0,URS0000D6BBE0_12908/1-36,AAGGCACAUCCCGAAAAGCCUGUAAUAGAGUAGGAA,15,5,9,7,36
6375,0,URS0000D6C525_12908/1-36,AAGGCGAAAACCGAAAAGCCUAUAAUAGAGUAGGUA,17,5,9,5,36
6376,0,URS0000D67092_12908/1-36,AAGGCGUAAACCGAAAAGCCUAUAAUAGAGUAGGUA,16,6,9,5,36
6377,0,URS0000D67092_873517/1-36,AAGGCGUAAACCGAAAAGCCUAUAAUAGAGUAGGUA,16,6,9,5,36
6378,0,URS0000D6CA5A_12908/1-36,UAGGCGGAAACCGAAAAGCCUAUAACAGAGUAGGUA,15,5,10,6,36
6379,0,URS0000D6860A_12908/1-36,UAGGCGAAAACCGAAAAGCCUAUAACAGAGUAGGUA,16,5,9,6,36
6380,0,URS0000D6A8CF_12908/1-36,AAGGCGAAAACCGAAAAGCCUAUAACAGAGUAGGUU,16,5,9,6,36
6381,0,URS0000D6CACF_12908/1-36,AAGGCGAAAACCGAAAAGCCUAUAACAGAGUAGGUA,17,4,9,6,36
6382,0,URS0000D6A0BE_12908/1-36,AAGGCUAAAACCGAAAAGCCUAUAACAGAGUAGGUA,17,5,8,6,36
6383,0,URS0000D66406_860228/1-36,AAGGCAACACCCGAAAAGCCUGUAAUAGAGUAGGGG,14,4,11,7,36
6384,0,URS0000D69BF0_12908/1-36,AAGGCGAAAACUGAAAAGCCUGUAACAGAGUAAGUA,17,5,9,5,36
6385,0,URS0000D67EC3_12908/1-36,AAGGCGGAAACUGAAAAGCCUGUAAUAGAGUAGGUA,15,6,11,4,36
6386,0,URS0000D6CAB6_12908/1-36,AAGGCGGAAACUGAAAAGCCUAUAACAGAGUAAGUA,17,5,9,5,36
6387,0,URS0000D67633_12908/1-36,AAGGCGGAAACUGAAAAGCCUGUAACAGAGUAAGUA,16,5,10,5,36
6388,0,URS0000D66A7E_12908/1-36,AAGGCGGAAACUGAAAAGCUUGUAACAGAGUAAGUA,16,6,10,4,36
6389,0,URS0000D66898_12908/1-36,AAGGCGGAAACUGAAAAGCCUGUAACAGAGUAGGUA,15,5,11,5,36
6390,0,URS0000D65CED_12908/1-36,AAGGCGGAAGCUGAAAAGCCUGUAACAGAGUAGGUA,14,5,12,5,36
6391,0,URS0000D697AF_12908/1-36,AAGGCGGAAACUGAAAAGCCUGUAACAGAUUAGGUA,15,6,10,5,36
6392,0,URS0000D69E2C_12908/1-36,GAGGCGAAACCCGAAAAGCCUAUAAAAGAGUAGGGG,15,3,12,6,36
6393,0,URS0000D6BD9B_12908/1-36,GAGGCGAUACCCGAAAAGCCUGUAAAAGAGUAGGGG,13,4,13,6,36
6394,0,URS0000D68F74_12908/1-36,GAGGCGAUACCCGAAAAGCCUGUAAAAGAGUAGGGA,14,4,12,6,36
6395,0,URS0000D65A5B_12908/1-36,AAGGCGGGAACCGAAAAGCCUGUAAUAGAGUAGGGG,13,4,14,5,36
6396,0,URS0000D68B15_12908/1-36,AAGGCAGUACCCGAAAAGCCUAUAACAGAGUAGGGA,15,4,10,7,36
6397,0,URS0000D6B456_525257/1-35,CCGGCGGAAUCCGAAAAGCCAUAAAAGAGUAGGAA,15,3,10,7,35
6398,0,URS0000D6A668_12908/1-36,CCGGCGGAAUCCGAAAAGCCAUUAAAAGAGUAGGAA,15,4,10,7,36
6399,0,URS0000D67AD6_12908/1-35,AUGGCGGAACCGAAAAGCCAUUAAUAGAGUAGGAA,15,5,10,5,35
6400,0,URS0000D6C580_12908/1-35,ACGGCGGAAUCCGAAAAGCCUUAAUAGAGUAGGAA,14,5,10,6,35
6401,0,URS0000D6CD04_1094466/1-32,ACGGCGGAACCGAAAAGCCAAUAGAGUAGGAA,14,2,10,6,32
6402,0,URS0000D6C014_12908/1-35,ACGGCGGAUUCCGAAAAGCCUUAAUAGAGUAGGAA,13,6,10,6,35
6403,0,URS0000D65D1E_1144316/1-36,ACGGCGGAAUCCGAAAAGCCAUGAAAAGAGUAGGAA,16,3,11,6,36
6404,0,URS0000D6839A_742767/1-32,GAGGCGGAACCGAAAAGCCAAAAGAGUAGGAU,14,2,11,5,32
6405,0,URS0000D68055_12908/1-34,AAGGCGAAACCGAAAAGCCUGAAUAGAAUAGGAA,17,3,9,5,34
6406,0,URS0000D67924_12908/1-35,AAGGCGGAGCCGAAAAGCCUAUAACAGAGUAGGAA,15,3,11,6,35
6407,0,URS0000D65E52_12908/1-36,CAGGCGGAAACCGAAAAGCCUUAAAAAGAGUAGGUA,16,4,10,6,36
6408,0,URS0000D695A7_12908/1-35,CAGGCGGAAACCGAAAAGCCUAGAAAGAGUAGGUA,15,3,11,6,35
6409,0,URS0000D65A19_12908/1-35,AAGGCGGUAACCGAAAAACCUGAAUAGAGUAGGUA,15,5,10,5,35
6410,0,URS0000D69273_12908/1-35,AAGGCGGUAACCGAAAAGCCUGAAUAGAGUAGGUA,14,5,11,5,35
6411,0,URS0000D69C24_12908/1-36,AAGGCAAUAACCGAAAAGCCUGUAAUAGAGUAGGUA,16,6,9,5,36
6412,0,URS0000D6B8C4_12908/1-36,AAGGCAGUAACCGAAAAGCCUGUAAUAGAGUAGGUA,15,6,10,5,36
6413,0,URS0000D6B916_12908/1-36,AAGGCAGUAACCGAAAAGCCUGUAACAGAGUAGGUA,15,5,10,6,36
6414,0,URS0000D6BA08_12908/1-35,AAGGCAGUAACCGAAAAGCCUGAACAGAGUAGGUA,15,4,10,6,35
6415,0,URS0000D69122_12908/1-35,AAGGCGGUAACCGAAAAGCCUGAACAGAGUAGGUA,14,4,11,6,35
6416,0,URS0000D69122_521097/1-35,AAGGCGGUAACCGAAAAGCCUGAACAGAGUAGGUA,14,4,11,6,35
6417,0,URS0000D69122_553177/1-35,AAGGCGGUAACCGAAAAGCCUGAACAGAGUAGGUA,14,4,11,6,35
6418,0,URS0000D6A603_12908/1-35,AAGGCAGCAACCGAAAAGCCUGAACAGAGUAGGUA,15,3,10,7,35
6419,0,URS0000D6AB94_12908/1-35,AAGGCGGAACCGAAAAGCCUGUAAAAGAGUAGGAU,15,4,11,5,35
6420,0,URS0000D670EF_12908/1-35,AAGGCGGAACCGAAAAGCCUAUAAAAGAGUAGGGA,16,3,11,5,35
6421,0,URS0000D6BA91_12908/1-36,AAGGCGAAAUCCGAAAAGCCUGUAAUAGAGUAGGAA,16,5,10,5,36
6422,0,URS0000D69860_12908/1-35,AAGGCGGAACCGAAAAGCCUGUAAUAGAGUAGGAA,15,4,11,5,35
6423,0,URS0000D691E3_12908/1-36,AAGGCAGAAUCCGAAAAGCCUGUAAUAGAGUAGGAA,16,5,10,5,36
6424,0,URS0000D691E3_873517/1-36,AAGGCAGAAUCCGAAAAGCCUGUAAUAGAGUAGGAA,16,5,10,5,36
6425,0,URS0000D691E3_521097/1-36,AAGGCAGAAUCCGAAAAGCCUGUAAUAGAGUAGGAA,16,5,10,5,36
6426,0,URS0000D65C7E_12908/1-35,AAGGCGGAACCGAAAAGCCAAUAACAGAGUAGGGA,16,2,11,6,35
6427,0,URS0000D686BD_12908/1-36,AAGGCGAAUCCCGAAAAGCCUGUGACAGAGUAGGGA,13,4,12,7,36
6428,0,URS0000D6D3E9_12908/1-36,AAGGCAGAACCCGAAAAGCCUGUAAAAGAGUAGAAA,18,3,9,6,36
6429,0,URS0000D67BFE_12908/1-36,AAGGCGGAACCCGAAAAACCUAUAACAGAGUAGGAA,17,3,9,7,36
6430,0,URS0000D68303_12908/1-36,AAGGCGUAUCCUGAAAAGCCUAUAAGAGAGUAGGGA,14,6,11,5,36
6431,0,URS0000D67AAB_12908/1-36,AAGGCAUAUCCCGAAAAGCCUAUAAGAGAGUAGGGA,15,5,10,6,36
6432,0,URS0000D67625_12908/1-36,AAGGCGUAUCCCGAAAAGCCUAUAAGAGAGUAGGGA,14,5,11,6,36
6433,0,URS0000D67625_888059/1-36,AAGGCGUAUCCCGAAAAGCCUAUAAGAGAGUAGGGA,14,5,11,6,36
6434,0,URS0000D68B28_12908/1-36,AAGGCGUAUCCCGAAAAGCCUAUAACAGAGUAGGGA,14,5,10,7,36
6435,0,URS0000D6C419_12908/1-36,AAGGCGUAUCCCGAAAAGCCUAUAAUAGAGUAGGGA,14,6,10,6,36
6436,0,URS0000D668BF_12908/1-36,AAGGCACAUCCCGAAAAGCCUAUAAGAGAGUAGGGA,15,4,10,7,36
6437,0,URS0000D6CA6B_12908/1-36,AAGGCGCAUCCCGAAAAGCCUAUAAGAGAGUAGGAA,15,4,10,7,36
6438,0,URS0000D6AA10_12908/1-36,AAGGCGCAUCCCGAAAAGCCUAUAAGAGAGUAGGGA,14,4,11,7,36
6439,0,URS0000D670D3_12908/1-36,AGGGCGUAUCCCGAAAAGCCUGUAAUAGAGUAGGGA,12,6,12,6,36
6440,0,URS0000D68793_12908/1-36,AGGGCGUAUCCCGAAAAGCCUGUAAUAGAGUAGGGG,11,6,13,6,36
6441,0,URS0000D6746B_12908/1-36,AAGGCGUAUCCCCAAAAGCCUGUAAUAGAGUAGGGA,13,6,10,7,36
6442,0,URS0000D6C7C6_12908/1-36,AAGGCGAAACCCGAAAAGCUUGUAAUAGAGUAGGGA,15,5,11,5,36
6443,0,URS0000D674AA_12908/1-36,AAGGCAUAUCCCGAAAAGCCUGUAAUAGAGUAGGGA,14,6,10,6,36
6444,0,URS0000D65D0E_936370/1-36,AAGGCGAAUCCCGAAAAGCCUGUAAUAGAGUAGGGG,13,5,12,6,36
6445,0,URS0000D6BEE0_888059/1-36,AAGGCGAAACCCGAAAAGCCUGUAAUAGAGUAAGGG,15,4,11,6,36
6446,0,URS0000D683E4_860228/1-36,AAGGCGAAACCCGAAAAGCCUGUAAUAGAGUAGGGG,14,4,12,6,36
6447,0,URS0000D6B9F7_12908/1-37,AAGGCGAAAACCCGAAAAGCCUGUAAAAGAGUAGGGG,16,3,12,6,37
6448,0,URS0000D6AB44_12908/1-36,AAGGCGGGAAUCGAAAAGCCUGUAAAAGAGUAGGAA,16,4,12,4,36
6449,0,URS0000D6C7BB_12908/1-36,AAGGCGGGAACCGAAAAGCCUGUAAAAGAGUAGGAA,16,3,12,5,36
6450,0,URS0000D67EC5_12908/1-36,AAGGCGGGAACCGAAAAGCCUGUAAAAGAGUAGGAU,15,4,12,5,36
6451,0,URS0000D6C6AC_12908/1-36,AAGGUGGAAACCGAAAAGCCUGUAAAAGAGUAGGAA,17,4,11,4,36
6452,0,URS0000D69EA9_12908/1-36,AAGGCGGAACCCGAAAAGCCUGUAAAAGAGUAGAAA,17,3,10,6,36
6453,0,URS0000D6604B_12908/1-36,AAGGCGAAACCCGAAAAGCCUGUAACAGAGUAGGAA,16,3,10,7,36
6454,0,URS0000D690ED_12908/1-36,AAGGCGGAAACCGAAAAGCCUGAAAAAGAGUAGGAA,18,2,11,5,36
6455,0,URS0000D69B9D_12908/1-35,AAGGCGGAACCGAAAAGCCUGUAAAAGAGUAGGAA,16,3,11,5,35
6456,0,URS0000D66527_12908/1-36,AAGGCGGAACCCGAAAAGCCUGUAAAAGAGUAGGAA,16,3,11,6,36
6457,0,URS0000D65885_12908/1-36,AAGGCGGAAACCGAAAAGCCUGUAAAAGAGUAGGAA,17,3,11,5,36
6458,0,URS0000D69D31_12908/1-36,AAGGCGAAACCCGAAAAGCCUAUAAAAGAGUAGGAA,18,3,9,6,36
6459,0,URS0000D66D81_12908/1-36,AAGGCGAAACCCGAAAAGCCUGUAAAAGAGUAGGAA,17,3,10,6,36
6460,0,URS0000D682D3_12908/1-36,AAGGCAGAACCCGAAAAGCCUGUAAGAGAGUAGGAA,16,3,11,6,36
6461,0,URS0000D6C4CD_12908/1-36,AAGGCGGAAACCGAAAAGCCUGUAAGAGAGUAGGAA,16,3,12,5,36
6462,0,URS0000D6C4CD_1125721/1-36,AAGGCGGAAACCGAAAAGCCUGUAAGAGAGUAGGAA,16,3,12,5,36
6463,0,URS0000D66C02_12908/1-35,AAGGCGGAACCGAAAAGCCUGUAAGAGAGUAGGAA,15,3,12,5,35
6464,0,URS0000D6A206_12908/1-36,AAGGCGGAACCCGAAAAGCCUGUAAGAGAGUAGGAA,15,3,12,6,36
6465,0,URS0000D68CC5_12908/1-36,UAGGCGGAAACCGAAAAGCCUGUAAGAGAGUAGGAU,14,5,12,5,36
6466,0,URS0000D6B7D2_12908/1-36,UAGGCGGAAACCGAAAAGCCUGUAAGAGAGUAGGAA,15,4,12,5,36
6467,0,URS0000D6719D_12908/1-36,AAGGCGGAAACCGAAAAGCCUGCAAGAGAGUAGGAA,16,2,12,6,36
6468,0,URS0000D6CC24_12908/1-36,AAGGCGGAAACCGAAAAGCCUGCAAAAGAGUAGGGA,16,2,12,6,36
6469,0,URS0000D6B58E_12908/1-35,AAGGCGGAACCGAAAAGCCUGCAAAAGAGUAGGAA,16,2,11,6,35
6470,0,URS0000D6731D_12908/1-36,AAGGCGGAAACCGAAAAGCCUGCAAAAGAGUAGGAA,17,2,11,6,36
6471,0,URS0000D6BE05_12908/1-36,AAGGCAGAAUCCGAAAAGCCUGUAACAGAGUAGGGA,15,4,11,6,36
6472,0,URS0000D68803_12908/1-36,AAGGCGGAAACCGAAAAGCCUGUAAUAGAGUAGGGA,15,4,12,5,36
6473,0,URS0000D69D5C_12908/1-36,AAGGCGGAAUCCGAAAAGCCUAUAACAGAGUAGGGA,15,4,11,6,36
6474,0,URS0000D6C3BA_12908/1-36,AAGGCGGAACCCGAAAAGCCUAUAACAGAGUAGGGA,15,3,11,7,36
6475,0,URS0000D671B2_12908/1-36,AAGGCGGAACCCGAAAAGCCUAUAAUAGAGUAGGGA,15,4,11,6,36
6476,0,URS0000D657C9_12908/1-36,AAGGCGGAAACCGAAAAGCCUAUAAUAGAGUAGGGA,16,4,11,5,36
6477,0,URS0000D65B95_12908/1-36,AAGGCGGAAACCGAAAAGCCUAUAAUAGAGUAGGGG,15,4,12,5,36
6478,0,URS0000D6A61F_12908/1-36,AAGGCAGAAUCCGAAAAGCCUAUAACAGAGUAGGGA,16,4,10,6,36
6479,0,URS0000D6A673_12908/1-36,AAGGCGGAACCCGAAAAGCCUAUAAAAGAGUAGGAC,16,3,10,7,36
6480,0,URS0000D68B2B_12908/1-36,AAGGCAGAACCCGAAAAGCCUAUAAAAGAGUAGGAA,18,3,9,6,36
6481,0,URS0000D6D3F3_12908/1-36,AAGGCCGAACCCGAAAAGCCUAUAAAAGAGUAGGAA,17,3,9,7,36
6482,0,URS0000D65E22_12908/1-36,AAGGCGGAACCCGAAAAGCCUAUAACAGAGUAGGAA,16,3,10,7,36
6483,0,URS0000D68C2D_12908/1-35,AAGGCGGAACCGAAAAGCCUAUAAAAGAGUAGGAA,17,3,10,5,35
6484,0,URS0000D68A3E_12908/1-36,AAGGCGGAACCCGAAAAGCCUAUAAAAGAGUAGGAA,17,3,10,6,36
6485,0,URS0000D67631_12908/1-36,AAGGCAAAACCCGAAAAGCCUGUAAAAGAGUAGGGA,17,3,10,6,36
6486,0,URS0000D6BAB2_12908/1-36,AAGGCGAAACCCGAAAAGCCUGUAAAAGAGUAGGGA,16,3,11,6,36
6487,0,URS0000D6BDA5_12908/1-36,AAGGCGAAAUCCGAAAAGCCUGUAACAGAGUAGGGA,15,4,11,6,36
6488,0,URS0000D67D6A_12908/1-36,AAGGCGAAACCCGAAAAGCCUGUAACAGAGUAGGGA,15,3,11,7,36
6489,0,URS0000D679B2_12908/1-36,AAGGCGAAUCCCGAAAAGCCUGUAACAGAGUAGGGA,14,4,11,7,36
6490,0,URS0000D66884_12908/1-36,AAGGCGAAACCCGAAAAGCCUAUAACAGAGUAGGGA,16,3,10,7,36
6491,0,URS0000D6634E_12908/1-36,AAGGCAGAACCCGAAAAGCCUGUAAAAGAGUAGGAA,17,3,10,6,36
6492,0,URS0000D68D52_12908/1-36,AAGGCGUAUUCCGAAAAGCCUGUAAUAGAGUAAGGA,14,7,10,5,36
6493,0,URS0000D6928F_12908/1-36,AAGGUGAAUCCCGAAAAGCCUGUAAUAGAGUAGGGA,14,6,11,5,36
6494,0,URS0000D669C8_12908/1-36,AAGGUGAAACCCGAAAAGCCUGUAAUAGAGUAGGGA,15,5,11,5,36
6495,0,URS0000D68FB9_12908/1-36,AAGGCGUAUCUCGAAAAGCCUGUAAUAGAGUAGGGA,13,7,11,5,36
6496,0,URS0000D6C5A3_12908/1-36,AAGGCGAAUCUCGAAAAGCCUGUAAUAGAGUAGGGA,14,6,11,5,36
6497,0,URS0000D6C749_12908/1-36,AAGGCGUAUCUCGAAAAGCCUGUAAUAGAGUAGAGA,14,7,10,5,36
6498,0,URS0000D6B28A_12908/1-36,AAGGCGAAUCCCGAAAAGCCUGUAAUAGAGUAGGGA,14,5,11,6,36
6499,0,URS0000D68005_12908/1-36,AAGGCGUAUUCCGAAAAGCCUGUAAUAGAGUAGGGA,13,7,11,5,36
6500,0,URS0000D66115_12908/1-36,AAGGCGUAUCCCGAAAAGCCUGUAAUAGAGUAGGGA,13,6,11,6,36
6501,0,URS0000D6A4F6_12908/1-36,AAGGCGAAACCUGAAAAGCCUGUAAUAGAGUAGGGA,15,5,11,5,36
6502,0,URS0000D69E1F_12908/1-36,AAGGCGAAACCCGAAAAGCCUGUAAGAGAGUAGGGA,15,3,12,6,36
6503,0,URS0000D6C6E3_12908/1-37,AAGGCGAAAACCCGAAAAGCCUGUAAGAGAGUAGGGA,16,3,12,6,37
6504,0,URS0000D6B571_12908/1-37,AAGGCGAAAACCCGAAAAGCCUGUAAUAGAAUAGGGA,17,4,10,6,37
6505,0,URS0000D6A41E_12908/1-36,AAGGCGAAACCCGAAAAGCCUAUAAUAGAGUAGGGA,16,4,10,6,36
6506,0,URS0000D66866_12908/1-37,AAGGCGAAAACCCGAAAAGCCUAUAAUAGAGUAGGGA,17,4,10,6,37
6507,0,URS0000D68DC1_12908/1-37,AAGACGAAAACCCGAAAAGCCUAUAAUAGAGUAGGGA,18,4,9,6,37
6508,0,URS0000D6920A_12908/1-37,AAGGCGAAAACCCGAAAAGCCUGUAAUAGAGUAGGGA,16,4,11,6,37
6509,0,URS0000D67442_12908/1-36,AAGGCGAAACCCGAAAAGCCUGUAAUAGAGUAGGGA,15,4,11,6,36
6510,0,URS0000D657BB_12908/1-37,AAGGCGAUAACCCGAAAAGCCUGUAAUAGAGUAGGGA,15,5,11,6,37
6511,0,URS0000D68BA7_12908/1-36,AAGGCGAAACCCGAAAAGCCUAUAAUAGAGUAGAGA,17,4,9,6,36
6512,0,URS0000D6CBAB_12908/1-36,AAGGCGAAUCCCGAAAAGCCUGUAAUAGAGUAAGGA,15,5,10,6,36
6513,0,URS0000D6B63A_12908/1-36,AAGGCGAAAACCGAAAAGCCUGUAAGAGAGUAGGAA,17,3,11,5,36
6514,0,URS0000D6A557_12908/1-36,AAGGCGAAAACCGAAAAGCCUGUAAGAGAGUAGGGA,16,3,12,5,36
6515,0,URS0000D6B616_12908/1-35,AAGGCGGAAACCGAAAAGCCUAAAAAGAGUAGGUA,17,3,10,5,35
6516,0,URS0000D69727_12908/1-35,AAGGCGGAGCCGAAAAGCCUGUAAAAGAGUAGGAN,14,3,12,5,35
6517,0,URS0000D6CE98_12908/1-35,AAGGCGGAGCCGAAAAGCCUGUAAAAGAGUAGGAA,15,3,12,5,35
6518,0,URS0000D6C245_12908/1-35,GAGGCAGAACCGAAAAGCCUAUAACAGAGUAGGGA,15,3,11,6,35
6519,0,URS0000D6BAFE_12908/1-35,AAGGCGGAAACCGAAAAGCCUGAAAAGAGUAGGUG,15,3,12,5,35
6520,0,URS0000D6B1E6_12908/1-35,AAGGCGGAAACCGAAAAGCCUAAAAAGAGUAGGUG,16,3,11,5,35
6521,0,URS0000D67CFD_12908/1-35,AAGGCGGAAACCGAAAAGCCUGAAGAGAGUAGGUA,15,3,12,5,35
6522,0,URS0000D67CFD_521097/1-35,AAGGCGGAAACCGAAAAGCCUGAAGAGAGUAGGUA,15,3,12,5,35
6523,0,URS0000D6BA81_12908/1-35,AAGGCGGAAACCGAAAAGCCUGAAAAGAGUAGGUA,16,3,11,5,35
6524,0,URS0000D6C520_12908/1-35,AAGGCGGCAACCGAAAAGCCUGAAAAGAGUAGGUA,15,3,11,6,35
6525,0,URS0000D6A86D_12908/1-35,AAGGCGGCAACCGAAAAGCCUGAAGAGAGUAGGUG,13,3,13,6,35
6526,0,URS0000D6925C_12908/1-35,AAGGCGACAACCGAAAAGCCUGAACAGAGUAGGUA,15,3,10,7,35
6527,0,URS0000D68DD2_12908/1-35,AAGGCGGCAACCGAAAAGCCUGAACAGAGUAGGUA,14,3,11,7,35
6528,0,URS0000D6C16A_12908/1-35,AAGGCGGCAACCGAAAAGCCUGAACAGAGUAGGUG,13,3,12,7,35
6529,0,URS0000D65744_12908/1-35,AAGGCGGCAACCGAAAAGCCUGAACAGAGUAGGAG,14,2,12,7,35
6530,0,URS0000D697F4_12908/1-35,AAGGCGGUAACCGAAAAGCCUAAACAGAGUAGGUA,15,4,10,6,35
6531,0,URS0000D697F4_873517/1-35,AAGGCGGUAACCGAAAAGCCUAAACAGAGUAGGUA,15,4,10,6,35
6532,0,URS0000D6B979_12908/1-35,AAGGCGGCAACCGAAAAGCCUAAACAGAGUAGGUA,15,3,10,7,35
6533,0,URS0000D68025_12908/1-35,AAGGCAGAAACCGAAAAGCCUGAAGAGAGUAGGUG,15,3,12,5,35
6534,0,URS0000D67E23_12908/1-35,AAGGCGGAAACCGAAAAGCCUGAAGAGAGUAGGUG,14,3,13,5,35
6535,0,URS0000D6A9D6_12908/1-35,GAGGCGAACCCGAAAAGCCUAUAACAGAGUAGGAA,15,3,10,7,35
6536,0,URS0000D6BD74_12908/1-34,AAGGCGAAACCGAAAAGCCUGAAUAGAGUAGGAA,16,3,10,5,34
6537,0,URS0000D6BBE9_12908/1-37,AAGGCGAUAACCCGAAAAGCCUUUAACAGAGUAGGGA,15,5,10,7,37
6538,0,URS0000D6A6BD_12908/1-37,CAGGCGAUAACCCGAAAAGCCUUUAACAGAGUAGGGA,14,5,10,8,37
6539,0,URS0000D69D35_12908/1-37,AAGGCGACACCCCGAAAAGCCUUUAAUAGAGUAGGGA,14,5,10,8,37
6540,0,URS0000D6AFCC_12908/1-37,AAGGCGACACCCCGAAAAGCCUUUAACAGAGUAGGGA,14,4,10,9,37
6541,0,URS0000D6AFCC_873517/1-37,AAGGCGACACCCCGAAAAGCCUUUAACAGAGUAGGGA,14,4,10,9,37
6542,0,URS0000D6B2DE_860228/1-36,AAGGCGUAACCUGAAAAGCCUGUAAUAGAGUAGGGG,13,6,12,5,36
6543,0,URS0000D6C961_485918/1-35,AGGGCGGAUCCGAAAAGCCUUUAAAAGAGUAGGGA,13,5,12,5,35
6544,0,URS0000D6AC2C_12908/1-35,UAGGCGGUAACCGAAAAGCCCGAAAAGAGUAGGUA,14,4,11,6,35
6545,0,URS0000D6D396_12908/1-35,UAGGCGGUAACCGAAAAGCCUGAAAAGAGUAGGUG,13,5,12,5,35
6546,0,URS0000D69BB3_12908/1-35,UAGGCGGUAACCGAAAAGCCUGAAAAGAGUAGGUA,14,5,11,5,35
6547,0,URS0000D6CF2F_12908/1-37,UAGGCGGAAACCGAAAAGCCUUUGAAUAGAGUAGGUG,13,7,12,5,37
6548,0,URS0000D68BF0_12908/1-36,UAGGCGGAAAUCGAAAAGCCUUGAAUAGAGUAGGUG,13,7,12,4,36
6549,0,URS0000D69F21_12908/1-36,UAGGCAGUAACCGAAAAGCCUGAAAAAGAGUAGGUA,16,5,10,5,36
6550,0,URS0000D68493_562729/1-35,UCGGCGGCAACCGAAAAGCCUUAACAGAGUAGGUA,12,5,10,8,35
6551,0,URS0000D65D1D_620914/1-40,AAGGCGUAAACCGAAAAGCCUUUUUUCAAAAGAGUAGGUA,16,9,9,6,40
6552,0,URS0000D672D8_12908/1-37,AAGGCGGAAACCGAAAAGCCUUUAAUUAGAGUAGGAU,15,7,10,5,37
6553,0,URS0000D65A95_12908/1-36,AAGGUGGAAACCGAAAAGCCUUUAAUAGAGUAGGAU,15,7,10,4,36
6554,0,URS0000D68C94_12908/1-36,AAGGCGGAAACCGAAAAGCCUUUAAUAGAGUAGGAU,15,6,10,5,36
6555,0,URS0000D6766F_12908/1-36,AAGGCGGAAACUGAAAAGCCUUUAAUAGAGUAGGAU,15,7,10,4,36
6556,0,URS0000D6A234_12908/1-36,AAGGCGGAAACUGAAAAGCCUUUAAUAGAGUAGAAU,16,7,9,4,36
6557,0,URS0000D6BA0B_12908/1-35,AAGGCGGAACCGAAAAGCCUGGAAUAGAGUAGGAG,14,3,13,5,35
6558,0,URS0000D6CEA3_12908/1-34,AAGGCGGAACCGAAAAGCCUCAACAGAGUAGGAG,14,2,11,7,34
6559,0,URS0000D6C4A0_12908/1-34,UCGGAGGAAGCCGAAAAUCCGGAAAGAGUAGGCG,12,3,13,6,34
6560,0,URS0000D68F6A_12908/1-35,CAGGAGAAAUCCGAAAAUCCUUAAAAGAGUAGGAA,17,5,8,5,35
6561,0,URS0000D6A0BF_12908/1-34,CAGGAGAAACCGAAAAUCCUGAAAAGAGUAGGAA,17,3,9,5,34
6562,0,URS0000D6D2A3_391587/1-39,AAGGAGAAAGCCGAAAAGCCUUUUUAAAAAGAGUAGGUA,18,7,10,4,39
6563,0,URS0000D6838A_12908/1-35,AAGGAGAAUGCCGAAAAUCCUAAAAAGAGUAGGUA,17,5,9,4,35
6564,0,URS0000D6A4FB_12908/1-34,AAGGAGAAUCCGAAAAUCCUUAAAAGAGUAGGAA,17,5,8,4,34
6565,0,URS0000D69B6A_12908/1-36,CAGGAGGAAUCCGAAAAUCCAAUAAAAGAGUAGAAA,19,4,8,5,36
6566,0,URS0000D6851A_376686/1-34,CUGGAGAAGCCGAAAAUCCAAAAAAGAGUAGGCA,16,3,9,6,34
6567,0,URS0000D659C2_12908/1-35,UCGGAGGAAACCGAAAAUCCGGAAAAGAGUAGGUG,14,4,12,5,35
6568,0,URS0000D69AB2_12908/1-34,ACGGAGGAACCGAAAAUCCGGAAAAGAGUAGGGG,14,2,13,5,34
6569,0,URS0000D6A977_12908/1-35,ACGGAGGAAGCCGAAAAUCCGGAAAAGAGUAGGUG,14,3,13,5,35
6570,0,URS0000D69890_12908/1-35,ACGGAGUAAGCCGAAAAUCCGGAAAAGAGUAGGUG,14,4,12,5,35
6571,0,URS0000D6CE3B_12908/1-35,ACGGAGGAAACCGAAAAUCCGGAAUAGAGUAGGUG,14,4,12,5,35
6572,0,URS0000D6BC54_12908/1-35,GCGGAGGAAGCCGAAAAUCUGGAAAAGAGUAGGCA,14,3,13,5,35
6573,0,URS0000D66A6F_12908/1-35,GCGGAGGAAGCCGAAAAUCCGGAAAAGAGUAGGCC,13,2,13,7,35
6574,0,URS0000D68996_12908/1-35,GCGGAGGAAGCCGAAAAUCCGGAAAAGAGUAGGCG,13,2,14,6,35
6575,0,URS0000D66E22_12908/1-35,ACGGAGGAAGCCGAAAAUCCAGAAAAGAGUAGGCG,15,2,12,6,35
6576,0,URS0000D6B6BB_12908/1-35,ACGGAGCAAGCCGAAAAUCCAGAAAAGAGUAGGCA,16,2,10,7,35
6577,0,URS0000D68A59_12908/1-35,UCGGAGUAAGCCGAAAAUCCAGAAAAGAGUAGGCA,15,4,10,6,35
6578,0,URS0000D692A0_12908/1-36,AUGGACAAAGCCGAAAAUCCAAUAAAAGAGUAGGCA,18,4,8,6,36
6579,0,URS0000D675F6_12908/1-35,AUGGAGAAAGCCGAAAAUCCAGAAAAGAGUAGGCA,17,3,10,5,35
6580,0,URS0000D6C4C1_12908/1-35,ACGGAGAAAGCCGAAAAUCCGGAAAAGAGUAGGCA,16,2,11,6,35
6581,0,URS0000D68666_12908/1-35,ACGGGGAAAGCCGAAAAUCCGGAAAAGAGUAGGCA,15,2,12,6,35
6582,0,URS0000D6A00F_12908/1-35,ACGGAGUAAGCCGAAAAUCCUGAAAAGAGUAGGCA,15,4,10,6,35
6583,0,URS0000D6C7FC_12908/1-35,ACGGAGUAAGCCGAAAAUCCAGCAAAGAGUAGGCA,15,3,10,7,35
6584,0,URS0000D65CA6_12908/1-35,AUGGAGAAAGCCGAAAAUCCACAAGAGAGUAGGCA,16,3,10,6,35
6585,0,URS0000D6B54D_12908/1-35,AAGGAACAAGCCGAAAAUCCUCAAUAGAGUAGGCA,16,4,8,7,35
6586,0,URS0000D6C6B0_12908/1-35,AAGGAGAAUGCCGAAAAUCCGAAGAAGAGUAGGCA,16,3,11,5,35
6587,0,URS0000D6D2B9_12908/1-35,CAGGAGAAGGCCGAAAAUCCUAAGAAGAGUAGGCA,15,3,11,6,35
6588,0,URS0000D69D4C_12908/1-35,UAGGAGAAAGCUGAAAAUCCUUAAAAGAGUAGGCA,16,6,9,4,35
6589,0,URS0000D6CC57_12908/1-36,AAGGAGCAAGCCGAAAAUCCUAAACAAGAGUAGGCA,17,3,9,7,36
6590,0,URS0000D66D00_12908/1-35,AUGGAGUAAGCCGAAAAUCCGAAGAAGAGUAGGCA,15,4,11,5,35
6591,0,URS0000D6C19D_12908/1-35,AUGGAGAAAGCCGAAAAUCCAAAGAAGAGUAGGCA,17,3,10,5,35
6592,0,URS0000D6D324_12908/1-35,AAGGAGAAAGCCGAAAAUCCUAAGAAGAGUAGGCA,17,3,10,5,35
6593,0,URS0000D6CFAB_12908/1-39,AAGGAGUAAUGCCGAAAAUCCUAUUCAACAGAGUAAGCA,17,7,8,7,39
6594,0,URS0000D6A813_12908/1-36,AAGGAGUAAGCCGAAAAUCCUGCAACAGAGUAGGCA,15,4,10,7,36
6595,0,URS0000D67018_12908/1-36,UAGGAGAAAGCCGAAAAUCCUUAAAAAGAGUAGGCA,17,5,9,5,36
6596,0,URS0000D67F82_12908/1-34,CAGGAGUAACCGAAAAUCCAUAAAAGAGUAGGAA,17,4,8,5,34
6597,0,URS0000D66DE3_12908/1-35,AAGGAGUAAGCCGAAAAUCCUAAAAAGAGUAGGCA,17,4,9,5,35
6598,0,URS0000D6ACA8_12908/1-35,AAGGAGUAAUCCGAAAAUCCUUAAAAGAGUAGGAG,16,6,9,4,35
6599,0,URS0000D677CE_12908/1-37,AAGGAGGAAUCCGAAAAUCCUUUAAAAAGAGUAGGAA,18,6,9,4,37
6600,0,URS0000D670D1_1144313/1-31,AAGGAGUAACCGAAAAUCCAAAGAGUAGGAA,16,3,8,4,31
6601,0,URS0000D6A8AF_12908/1-36,AAGGAAGAAUCCGAAAAUCCUCAAAAAGAGUAGGAA,19,4,8,5,36
6602,0,URS0000D6D1BF_12908/1-35,AUGGAGGACGCCGAAAAUCCUUAAUAGAGUAGGCA,13,6,10,6,35
6603,0,URS0000D66697_12908/1-35,AUGGAGAAUGCCGAAAAUCCUUUAAAGAGUAGGCA,14,7,9,5,35
6604,0,URS0000D696A6_12908/1-35,GUGGAGAAUGCCGAAAAUCCAUUAAAGAGUAGGCA,14,6,10,5,35
6605,0,URS0000D65DA5_12908/1-38,CAGGAGCAAGCCGAAAAUCCUUAUUAAGAGAGUAGGCA,15,6,10,7,38
6606,0,URS0000D6655F_12908/1-35,AGGGAGGAAGCCGAAAAUCCUUCAAAGAGUAGGCA,14,4,11,6,35
6607,0,URS0000D67E9B_12908/1-35,AGGGAGGAAGCCGAAAAUCCAUCAAAGAGUAGGCA,15,3,11,6,35
6608,0,URS0000D6C443_12908/1-36,CAGGACGUAGCCGAAAAUCCUUUCAAAGAGUAGGCA,13,6,9,8,36
6609,0,URS0000D68C39_12908/1-36,AAGGAAGAAGCCGAAAAUCCUGAAAUAGAGUAGGCA,17,4,10,5,36
6610,0,URS0000D66778_12908/1-36,AAGGAGGAAGCCGGAAAUCCUUAAACAGAGUAGGCA,15,4,11,6,36
6611,0,URS0000D65A72_12908/1-35,CAGGAGAAUGCCGAAAAUCCUUUAAAGAGUAGGCA,14,6,9,6,35
6612,0,URS0000D664E5_12908/1-34,CAGGAGAAGCCGAAAAUCCUUUAAAGAGUAGGCA,14,5,9,6,34
6613,0,URS0000D68386_12908/1-35,CAGGAGGAAGCCGAAAAUCCUUAAAAGAGUAGGCA,15,4,10,6,35
6614,0,URS0000D68EE4_746697/1-40,AAGGAGGAAGCCGAAAAUCCUGUAUUAAAUAGAGUAGGCA,17,7,11,5,40
6615,0,URS0000D65C30_12908/1-35,AAGGAGGAAGCUGAAAAUCCUUAAUAGAGUAGGCA,15,6,10,4,35
6616,0,URS0000D676FA_12908/1-35,AAGGAGGAAGCCGAAAAUCCUUAAAAGAGUAGGCA,16,4,10,5,35
6617,0,URS0000D67F50_12908/1-35,AAGGAGGAAGCCGAAAAUCCUUAAUAGAGUAGGCA,15,5,10,5,35
6618,0,URS0000D66423_12908/1-35,AAGGAGCAAGCCGAAAAUCCUAUAAAGAGUAGGCA,16,4,9,6,35
6619,0,URS0000D69368_12908/1-35,AAGGAGCAAGCCGAAAAUCCUUUAAAGAGUAGGCA,15,5,9,6,35
6620,0,URS0000D6C44B_12908/1-35,CAGGACGAAGCCGAAAAUCCUUUAAAGAGUAGGCA,14,5,9,7,35
6621,0,URS0000D6C415_12908/1-33,AAGGAGGAAGCCGAAAAUCCAUAAGAGUAGGCA,15,3,10,5,33
6622,0,URS0000D6C615_12908/1-36,AAGGAGGAACCCGAAAAUCCUAAAACAGAGUAGGGA,17,3,10,6,36
6623,0,URS0000D6A9CB_1144313/1-33,AAGGAGAACCCGAAAAUCCUAAAAGAGUAGGGA,16,3,9,5,33
6624,0,URS0000D6B1D7_12908/1-37,GAGGAGGAACCCGAAAAUCCUUUAAAUAGAGUAGGGA,15,6,11,5,37
6625,0,URS0000D6BB28_12908/1-37,AAGGAGGAACCCGAAAAUCCUUUAAAUAGAGUAGGGA,16,6,10,5,37
6626,0,URS0000D66E80_12908/1-36,AAGGAGGAAGCCGAAAAUCCUGAAGUAGAGUAGGCA,15,4,12,5,36
6627,0,URS0000D68794_12908/1-35,AUGGAGCUAGCCGAAAAUCCUAUAAAGAGUAGGCA,14,6,9,6,35
6628,0,URS0000D6AF1A_12908/1-35,ACGGAGGAAGCCGAAAAUCCAUUAAAGAGUAGGCA,15,4,10,6,35
6629,0,URS0000D671DC_12908/1-37,AAGGAGGAUGCCGAAAAUCCAUGAAAAAGAGUAGGCA,17,4,11,5,37
6630,0,URS0000D6A4C1_12908/1-35,AUGGAGGAUGCCGAAAAUCCUUAAGAGAGUAGGUA,13,7,11,4,35
6631,0,URS0000D67877_12908/1-35,AUGGAGGAUGCCGAAAAUCCAUAAGAGAGUAGGUG,13,6,12,4,35
6632,0,URS0000D67EA2_12908/1-35,AAGGAGGAUGCCGAAAAUCCAGAACAGAGUAGGCA,15,3,11,6,35
6633,0,URS0000D66118_12908/1-35,AAGGACGAUGCCGAAAAUCCUUAAAAGAGUAGGCA,15,5,9,6,35
6634,0,URS0000D6980C_12908/1-37,AAGGAGGAUGCCGAAAAUCCUGAAAACAGAGUAGGCU,15,5,11,6,37
6635,0,URS0000D6B39C_12908/1-35,AAGGAGAACGCUGAAAAUCCUUAACAGAGUAGGCA,15,5,9,6,35
6636,0,URS0000D67B5F_12908/1-35,AAGGAGGAUGCCGAAAAUCCUUAACAGAGUAGGUA,14,6,10,5,35
6637,0,URS0000D67B99_12908/1-35,AAGGAGAAUGCCGAAAAUCCUUAACAGAGUAGGCA,15,5,9,6,35
6638,0,URS0000D6A6DC_12908/1-36,AAGGAGGAUGCCGAAAAUCCUUUAACAGAGUAGGCA,14,6,10,6,36
6639,0,URS0000D65E81_12908/1-35,AAGGAGGAUGCCGAAAAUCCUUAACAGAGUAGGCA,14,5,10,6,35
6640,0,URS0000D6927A_12908/1-35,AAGGAGGAUGCCGAAAAUCCUUAACAGAGUAGGCG,13,5,11,6,35
6641,0,URS0000D69327_12908/1-35,AAGGAGGACGCCGAAAAUCCUUAACAGAGUAGGCG,13,4,11,7,35
6642,0,URS0000D6CD6F_12908/1-35,ACGGAGCAUGCCGAAAAUCCUUAAAAGAGUAGGCG,13,5,10,7,35
6643,0,URS0000D6584A_12908/1-36,ACGGAGCAAGCCGAAAAUCCUGCAAAAGAGUAGGCG,14,3,11,8,36
6644,0,URS0000D69ED2_12908/1-36,UAGGAGGAAGCCGAAAAUCCUGAAAAAGAGUAGGCG,15,4,12,5,36
6645,0,URS0000D6AAD7_12908/1-34,AAGGAGAAAGCCGAAAAUCCUAAAAGAGUAGGCG,16,3,10,5,34
6646,0,URS0000D6C43F_12908/1-35,GAGGAGAAAGCCGAAAAUCCCGAAAAGAGUAGGCG,15,2,12,6,35
6647,0,URS0000D687C6_12908/1-33,CAAGCGAAACCCGAAAAGCUUAUAGAGUAGGGG,13,4,10,6,33
6648,0,URS0000D65F05_12908/1-33,CAAGCGAAACCCGAAAAGCUUAUAGAGUAGGGA,14,4,9,6,33
6649,0,URS0000D6A64D_525257/1-33,AAAGCGUAAUCCGAAAAGCAUAUAGAGUAGGAG,15,5,9,4,33
6650,0,URS0000D6718B_12908/1-33,AAAGCGUAAUCCGAAAAGCAUAUAGAGUAGGAA,16,5,8,4,33
6651,0,URS0000D6C376_12908/1-33,AAGGCGACUUCCGAAAAGCCCAAAGAGUAGGAA,14,3,9,7,33
6652,0,URS0000D6A2D3_12908/1-33,AGGGCGGUAUCCGAAAAGCCGAAAGAGUAGGAG,12,3,13,5,33
6653,0,URS0000D68958_12908/1-35,AUAGCGGAAGCCGAAAAGCUAAGAGAGAGUAGGCG,14,3,13,5,35
6654,0,URS0000D6CB1A_12908/1-35,AUAGCGAAAGCCGAAAAGCUAAGAGAGAGUAGGCG,15,3,12,5,35
6655,0,URS0000D66C6C_12908/1-36,ACAGCGUAAGCCGAAAAGCUGAACAAAGAGUAGGCA,16,3,10,7,36
6656,0,URS0000D6ACDB_12908/1-36,ACAGCGUAUGCCGAAAAGCUGAACAAAGAGUAGGCG,14,4,11,7,36
6657,0,URS0000D679BE_12908/1-33,ACAGCGGAAGCCGAAAAGCUUAAAGAGUAGGCG,13,3,11,6,33
6658,0,URS0000D66A7D_12908/1-33,ACAGCGGAUGCCGAAAAGCUAAAAGAGUAGGCG,13,3,11,6,33
6659,0,URS0000D67B1A_12908/1-33,AUAGCGGAACCCGAAAAGCUGAUAGAGUAGGGA,13,4,11,5,33
6660,0,URS0000D6718F_12908/1-33,AUUGCGAUCGCCGAAAAGCAAAUAGAGUAGGCA,13,5,9,6,33
6661,0,URS0000D6925D_12908/1-33,AUAGCGGUAGCCGAAAAGCUAAUAGAGUAGGCA,13,5,10,5,33
6662,0,URS0000D6770E_12908/1-33,AUUGCGGUAGCCGAAAAGCAAAUAGAGUAGGCA,13,5,10,5,33
6663,0,URS0000D676DC_12908/1-42,AUAGCGGAUGCCGAAAAGCUAAAAUUAUAAAUAGAGUAGGCA,19,8,10,5,42
6664,0,URS0000D6BAB6_12908/1-40,ACAGCGCAAGCCGAAAAGCUGUUAUUAAAAAGAGUAGGCA,17,6,10,7,40
6665,0,URS0000D657B5_12908/1-35,AUAGCGGAAGCCGAAAAGCUAUAAUAGAGUAGGCG,14,5,11,5,35
6666,0,URS0000D6586C_12908/1-35,AUAGCGGAUGCCGAAAAGCUAUAAACGAGUAGGCU,13,6,10,6,35
6667,0,URS0000D6B646_12908/1-35,AUAGCGGAUGCCGAAAAGCUAUAAAAGAGUAGGCU,14,6,10,5,35
6668,0,URS0000D68410_12908/1-35,AUAGCGGAAGCCGAAAAGCUGUUAUAGAGUAGGCA,13,6,11,5,35
6669,0,URS0000D6B6B1_12908/1-35,AUAGCGGAAGCCGAAAAGCUAUAAAAGAGUAGGCA,16,4,10,5,35
6670,0,URS0000D65BB7_12908/1-31,AUAGCGGAAGCCGAAAAGCUAAGAGUAGGCA,13,3,10,5,31
6671,0,URS0000D691B1_12908/1-33,AGAGCGGAAGCCGAAAAGCUAAAAGAGUAGGCA,15,2,11,5,33
6672,0,URS0000D67953_12908/1-33,AUAGCGGAAGCCGAAAAGCUAAGAGAGUAGGCA,14,3,11,5,33
6673,0,URS0000D6667D_12908/1-33,ACUGCGGAAGCCGAAAAGCAAACAGAGUAGGCA,14,2,10,7,33
6674,0,URS0000D6A627_485918/1-37,ACAGCGGAAGCCGAAAAGCUGUAGAACAGAGUAGGCA,15,3,12,7,37
6675,0,URS0000D6CED1_12908/1-35,UCAGCGGAAGCCGAAAAGCUUGAACAGAGUAGGCA,13,4,11,7,35
6676,0,URS0000D6B25A_12908/1-33,AAAGCGGAACCCGAAAAGCAUAAAGAGUAGGGA,16,2,10,5,33
6677,0,URS0000D6BFA1_12908/1-33,ACAGCGGAACCCGAAAAGCUAACAGAGUAGGGA,14,2,10,7,33
6678,0,URS0000D6B6FB_12908/1-33,AAAGCGGAACCCGAAAAGCUUACAGAGUAGGGA,14,3,10,6,33
6679,0,URS0000D66219_12908/1-35,AAAGCGGAACCCGAAAAGCUAUAACAGAGUAGGGA,16,3,10,6,35
6680,0,URS0000D6A297_12908/1-32,AAAGCGGAACCCGAAAAGCUAACGAGUAGGGA,14,2,10,6,32
6681,0,URS0000D658BD_12908/1-33,ACAGCGGAACCCGAAAAGCUGAUAGAGUAGGGA,13,3,11,6,33
6682,0,URS0000D690FA_12908/1-33,ACAGCGGAAUCCGAAAAGCUGAUAGAGUAGGGA,13,4,11,5,33
6683,0,URS0000D6A51A_12908/1-33,AAAGCGGAAGCCGAAAAGCUUACAGAGUAGGCA,14,3,10,6,33
6684,0,URS0000D6789C_12908/1-35,AACGCAGAAGCCGAAAAGCGAAAAUAGAGUAGGCA,17,2,10,6,35
6685,0,URS0000D6C4F4_12908/1-33,AACGCGGAAGCCGAAAAGCGCAUAGAGUAGGCA,13,2,11,7,33
6686,0,URS0000D6AF53_12908/1-36,AAAGCGGAAGCCGAAAAGCGUUUAAUAGAGUAGGCA,15,5,11,5,36
6687,0,URS0000D691FA_12908/1-33,AUUGCGGAAGCCGAAAAGCGUAUAGAGUAGGCA,12,5,11,5,33
6688,0,URS0000D6723A_12908/1-37,GCGGCGGAAUCCGAAAAGCCAUACAAUAGAGUAGGAG,14,4,12,7,37
6689,0,URS0000D6D0C5_12908/1-37,GCGGCGGAAUCCGAAAAGCCACACAAGAGAGUAGGAG,14,2,13,8,37
6690,0,URS0000D689A6_12908/1-37,AAGGAAGCAUCCGAAAAUCCUUUUAAAAGAGUUGGAA,16,8,8,5,37
6691,0,URS0000D6BEBD_12908/1-36,AAGGAAGAAUCCGAAAAUCCUUUAACAGAGUAGGAA,17,6,8,5,36
6692,0,URS0000D6B581_12908/1-41,AAGGAAGAAUCCGAAAAUCCUGAUAGUAAAUAGAGUAGGAG,19,7,11,4,41
6693,0,URS0000D6B581_457424/1-41,AAGGAAGAAUCCGAAAAUCCUGAUAGUAAAUAGAGUAGGAG,19,7,11,4,41
6694,0,URS0000D65A1E_12908/1-41,AAGGAAGAAUCCGAAAAUCCUGAUAGUGAAUAGAGUAGGAG,18,7,12,4,41
6695,0,URS0000D6D3DE_12908/1-35,AAGGCGGCAUCCGAAAAGCCAUAAUAGAGUAGGAU,14,5,10,6,35
6696,0,URS0000D67685_12908/1-35,AAGGCGGUGUCCGAAAAGCCCUAAUAGAGUAGGAU,12,6,11,6,35
6697,0,URS0000D67E12_12908/1-35,AAGGCGGAUUCCGAAAAGCCAUUAUAGAGUAGGAU,13,7,10,5,35
6698,0,URS0000D6B340_12908/1-33,GCCGCGUAAGCCGAAAAGCGAACAGAGUAGGCA,12,2,11,8,33
6699,0,URS0000D667DA_12908/1-40,ACGGAGGAACCCGAAAAUCCGUAAAUAAUUAGAGUAGGGA,17,6,11,6,40
6700,0,URS0000D69598_12908/1-36,CGGGCGGAAUCCGAAAAGCCUUGUACAGAGUAGGAG,11,5,13,7,36
6701,0,URS0000D69D39_12908/1-35,AACGAAGUAGCCGAAAAUCGUUAAAAGAGUAGGCA,16,5,9,5,35
6702,0,URS0000D673AE_12908/1-33,AACGACGAAGCCGAAAAUCGUUAAGAGUAGGCA,14,4,9,6,33
6703,0,BX571865.1/44187-44214,GUGCACUGCCGUACAGGCAGCUUAGAAA,8,5,8,7,28
6704,0,CR543861.1/2372998-2373025,CUUCACUACCGCACAGGUAGCUUAGAAA,9,6,5,8,28
6705,0,CP000753.1/3865826-3865799,GUUCACCGCCGCACAGGCGGCUUAGAAA,7,4,8,9,28
6706,0,CP000127.1/3128418-3128445,GUUCACCGCCGCACAGGCGGUUUAGAAA,7,5,8,8,28
6707,0,AF530480.1/2088-2115,GUUCACUGCCGCAUAGGCAGCUUAGAAA,8,6,7,7,28
6708,0,AANE01000001.1/559890-559863,GUUCACUGCCGAACAGGCAGCUUAGAAA,9,5,7,7,28
6709,0,AAKV01000024.1/25336-25309,GUUCACUGCCGUAUAGGCAGCUAAGAAA,9,6,7,6,28
6710,0,AE005174.2/1058490-1058517,RUUCACUGCCGUACAGGCAGCUUAGAAA,8,6,6,7,28
6711,0,BX950851.1/4136202-4136229,GUUCACUGCCGUAUAGGCAGUUUAGAAA,8,8,7,5,28
6712,0,CP000653.1/1535727-1535754,GUUCACUGCCGCACAGGCAGUUUAGAAA,8,6,7,7,28
6713,0,BX936398.1/2964997-2964970,AUUCACUGCCGCACAGGCAGCUUAGAAA,9,5,6,8,28
6714,0,AATN01000170.1/14109-14082,GUUCACUGCCAUAUAGGCAGCUUAGAAA,9,7,6,6,28
6715,0,AACK01000014.1/16402-16429,CUUCACUGCCGUAUAGGCAGCUUAGAAA,8,7,6,7,28
6716,0,AAOH01000006.1/219609-219636,GUUCACUGCCACACAGGCAGCUUAGAAA,9,5,6,8,28
6717,0,CP000503.1/3947718-3947745,GUUCUCUGCCGCACAGGCAGCUUAGAAA,7,6,7,8,28
6718,0,CP000542.1/1609263-1609236,GUUCACUGCCGGAUAGGCAGCUCAGAAA,8,5,8,7,28
6719,0,CR628339.1/43303-43276,GUUCACUGCCGUACAGGCAGCUUAGAAG,7,6,8,7,28
6720,0,CR378681.1/97619-97592,GUUCACUGCCGCACAGGCAGCUUAGAGA,7,5,8,8,28
6721,0,CP000744.1/1205223-1205250,GUUAACUGCCGUGUAGGCAGCUAAGAAA,9,6,8,5,28
6722,0,AASE01000005.1/56884-56911,GUUCACUGCCGGACAGGCAGCUUAGAAU,7,6,8,7,28
6723,0,CP000308.1/2201251-2201224,GUUCACUGCUGCACAGGCAGCUUAGAAA,8,6,7,7,28
6724,0,CP000720.1/3351663-3351636,GUUCACUGCCGCACAGGCAGCUUAUAUA,7,7,6,8,28
6725,0,AAQW01000001.1/3290233-3290206,GUUCACUGCCGUAUAGGCAGCAAAAAAU,10,6,6,6,28
6726,0,AAZW01000025.1/63827-63854,GUGUCCUGCCGCAUAGGCAGCUAAGAAA,8,5,8,7,28
6727,0,CP000468.1/897888-897915,GUUCACUGCCGUACAGGCAGUCUUCAAA,7,7,6,8,28
6728,0,AAQF01000183.1/1633-1660,GUUCACUGCCGGACAGGCAGCACAGAAA,9,3,8,8,28
6729,0,AF316504.1/2339-2366,AUUCACUGCUGAACAAGCAGCUUAGAAA,11,6,5,6,28
6730,0,CP000510.1/2545108-2545081,GUUUACUGCCGCACAGGCAGCUUAGGAA,7,6,8,7,28
6731,0,CP000749.1/3991340-3991313,GUUCACCGCCGAACAGGCGGCUUAGGUU,5,6,9,8,28
6732,0,AE004439.1/2082067-2082094,GUUAACUGCCGUAUAGGCAGCUUAGAAA,9,7,7,5,28
6733,0,CP001157.1/550062-550089,CUUCACUGCCGUGUAGGCAGCUCAGAAA,7,6,7,8,28
6734,0,CP000884.1/1357751-1357778,GUUCGCUGCCGCGUAGGCAGCUCAGAAA,6,5,9,8,28
6735,0,CP000308.1/1471576-1471603,GUUCACUGUUGUACAGGCAGCUUAGAAG,7,8,8,5,28
6736,0,EU086094.1/497-529,UGGUCCAUCGGGACCUCGGAUACCUGCGUUUAG,5,9,10,9,33
6737,0,M97168.1/608-642,UGGCCCAUCGGGGCUUCGGAUACCUGCUUUUUUUU,3,14,9,9,35
6738,0,AF104906.5/650-686,UUGCCCAUCGGGGCCUCGGAUACCUGCUUUAAUUUUU,5,14,8,10,37
6739,0,ABDC01412462.1/1593-1561,UGGCCCAUCGGGGCUUCGGAUACCUGCUUUUAU,4,11,9,9,33
6740,0,AAPY01379542.1/1953-1917,UGGCCCAUCGGGGCUUCGGAUACCUGCUUUAAUUUUU,5,14,9,9,37
6741,0,ABRN01131313.1/617-581,UGGCCCAUCGGGGCCUUGGAUACCUGCUUUGAUUUUU,4,14,10,9,37
6742,0,AADA01036560.1/1221-1185,UGGCCCAUCGGGGCCGCGGAUACCUGCUUUGAUUUUU,4,12,11,10,37
6743,0,AJ310129.1/9034-9068,UGGUCCAUCGGGACCUCGGAUACCUGCUAGUUUAG,6,10,10,9,35
6744,0,ABRR01407567.1/1407-1373,UGGCCCAUCGGGGCAACGGAUACCUGCUUUUUUUA,6,11,9,9,35
6745,0,AANG01523518.1/1387-1422,UUGCCCAUCGGGGCCUUGGAUACCUGCUUUAUUUAU,5,14,8,9,36
6746,0,ABRP01195257.1/1801-1762,UUGCCCAUCGGGGCCUCGGAUACCUGCUUUCACUAUUUUU,5,15,8,12,40
6747,0,U50910.1/1530-1566,UGGCCCAUCGGGGCCCCGGAUACCUGCUCUGAUUUUU,4,11,10,12,37
6748,0,AJ310130.1/12382-12417,UUGCCCAUCGGGGCCUUGGAUACCUGCUUAAUUUUU,5,14,8,9,36
6749,0,AANN01200569.1/1569-1605,UUGCCCAUCGGGGCCACGGAUACCUGCUUAGAUUUUU,6,12,9,10,37
6750,0,AALT01486907.1/919-954,UUGCCCAUCGGGGCCUCGGAUACCUGCUCGCUUUUU,3,12,9,12,36
6751,0,AAKN02029935.1/42514-42550,UUGCCCAUCGGGGCCUCGGAUACCUGCCCUAAUUUUU,5,12,8,12,37
6752,0,AANU01175104.1/38293-38330,UCGCCCAUCGGGGCCGCGGAUACCUGCUUUUUAUUUUU,4,14,9,11,38
6753,0,AAHX01111727.1/40962-40998,AUGCCCAACGGGGCCUCGGAUACCUGCUUUAAUUUUU,7,12,8,10,37
6754,0,AJ421479.1/106796-106828,UAGCCCAUCGGGGCCAUGGAUACCUGCUUUUUG,5,10,9,9,33
6755,0,AAIY01358820.1/951-987,UUGCCCAUCGGGGCCUCGGAUACCGGCUCUGAUUUUU,4,12,10,11,37
6756,0,AAGV020511993.1/1505-1469,UUGCCCAACGAGGCCUCAGAUACCUGCUUUAAUUUUU,8,13,6,10,37
6757,0,ABRT010581361.1/119-87,UCACCCAUCGGGGUCACGGAUACCUGCUUUUAU,6,10,7,10,33
6758,0,ABGA01241178.1/1628-1596,UUGCCCAUCGGGGCUGCGGAUACCUGGUUUUAU,4,11,10,8,33
6759,0,L10734.1/371-408,UUGCCCAUCGGGGCUGUGGAUACCUGCUUUAAAUUUUU,6,15,9,8,38
6760,0,AF138745.1/1968-1936,AUGCCCAACGGGGCCUCGGAUACCUGCUGUUAU,6,8,9,10,33
6761,0,L10730.1/44-76,UUGCCCAUCGGGGCCACGGAUACCUGUGUGUCC,4,8,10,11,33
6762,0,FJ361197.1/331-367,UGCCCAUCGGGGCUGUGGAUACCUGCUUUAAAUUUUU,6,14,9,8,37
6763,0,AJ310127.1/13329-13364,UUGCCCACCGGGGCCGUGGAUACCUGCUUCAUUUUU,4,12,9,11,36
6764,0,AAVX01126796.1/700-665,AUGCCCAUCGGGGCCUCGGAAUCUGUACUUCUUUUA,6,12,8,10,36
6765,0,AAPE02004049.1/4919-4953,UGGCCCACCGGGGCCUAGGAUACCUGCUUUUUUUU,4,12,9,10,35
6766,0,AGCE01104057.1/2893-2927,UUGCCCAUCGGGGCCGCGGAUACCUGCUUUUUAUU,4,12,9,10,35
6767,0,CU855548.6/128407-128372,UUGCCCAUCGGGGCCUCGGAUACCUGCUUUAUUAUU,5,13,8,10,36
6768,0,AF104906.5/487-523,UUGCCCAUCGGGGCCACGGAUACCUGCUUUUAAUUUU,6,13,8,10,37
6769,0,M97168.1/456-493,UCGCCCAUCGGGGCCGCGGAUACCUGCUUUUUAUUUUU,4,14,9,11,38
6770,0,M97168.1/368-404,UUGCCCAUCGGGGCUGCGGAUACCUGGUUUUAUUAUU,5,14,10,8,37
6771,0,AL353804.22/35456-35420,UGGCCCAUCGGGGCCGCGGAUACCUGCUUUGAUUUUU,4,12,11,10,37
6772,0,AF104906.5/693-729,UUGCCCAUCGGGGCCUCGGAUACCUACUUUAAUUUUU,6,14,7,10,37
6773,0,FJ156095.1/1619-1583,UGGCCCAUCGGGGCUGCGGAUACCUGGUUUCAUUAUU,5,12,11,9,37
6774,0,FJ156095.1/1573-1535,UUGCCCAACGGGGCUGUGGAUAGCUGCUUUUUAAUUCUU,6,15,10,8,39
6775,0,M97168.1/560-591,UGGCCCAUCGGGGUGACGGAUAUCUGCUUUUU,4,11,10,7,32
6776,0,U29341.1/1642-1673,UAGCCCAUCGGGGCCAUGGAUACCUGCUUUUU,5,10,8,9,32
6777,0,FJ156095.1/1519-1484,UUGCCUAUCGGGGCCGUGGAUACCUGCUUUUUUUUU,3,16,9,8,36
6778,0,M97168.1/698-734,CUGCCCAUCGGGGCCGCGGAUACCUGCUUUGAUUUUU,4,12,10,11,37
6779,0,FJ156095.1/1324-1288,UUGCCCAUCGGGGCCUCGGAUACCUGCUUUUAUUAUU,5,14,8,10,37
6780,0,AF104906.5/437-474,UUACCCAACGGGGUCAUGGAUACCUGCCUUUUAUUUUA,8,14,7,9,38
6781,0,AF104906.5/587-622,UGGCCCAUCGGGGCAAUGGAUACCUGCCUCUUUUUU,5,12,9,10,36
6782,0,L04961.1/549-585,CGGUCCAUCGGGACCUCGGAUACCUGCGUUUAGUCUU,5,11,10,11,37
6783,0,AF104906.5/735-771,UUGCCCAUCGGGACCGCGGACACCUGCUUAGAUUUUU,6,11,9,11,37
6784,0,AF104906.5/536-567,UAGCCCAUCGGGGCCUCGGAUACCUGCUGUGU,4,8,10,10,32
6785,0,FJ156095.1/1280-1244,UUGCCCAUCGGGGCCUCGGAUACCUGCUCUAAUUUUU,5,13,8,11,37
6786,0,AF104906.5/358-389,UUGCCCAUCGCGGCUGUGGAUACCUGGUUUUA,4,11,9,8,32
6787,0,L04961.1/435-471,UUGCCCAUCUGGGCUGUGGAUACCUGCUUUUAUUCUU,4,16,8,9,37
6788,0,CU855548.6/128656-128618,UUGCCCAACGGGGCCGUGGAUACCUGCCUUUUAAUUCUU,6,13,9,11,39
6789,0,FJ156095.1/1368-1332,UGGCCCAUCGGGGCCUCGGAUACCUGCUUUUAUUAUU,5,13,9,10,37
6790,0,AC132342.3/142353-142478,UGGGGUCUCUGAGAAUUGGGGUAGGCCAUAAAUCCCGGACGAGCCCCCACAUGUAAGAUCCCCGAAGCUUAGUCUCUGCUCAAGUCCCGGGAUGAGCUGGCUAGCACCCCAAUGACUCAAGAGAAA,33,24,34,35,126
6791,0,CT030242.6/134502-134619,UUCUUGGGGUUCUGGGUGCUCCCAAAUCCCGGACGAGCCCCCAAAUGUAGGACCCCCCCAAUAUGGCGACUCCCACUCUAAUCCAGGGAUAGGGUGCACCCACGAACACGCAAGAAUC,29,21,28,40,118
6792,0,AC116463.9/53797-53917,GUCUCGGUCUCUUGGGUGGUCGCGUCAAUCCCGGACGAGCCCCCAAAUGAAAGAUCCCCAAAGGGAGAUCCUCACUCAAGCCUCGGGAUGUGGCGCGGACCCAAGAGAGACGCGGAGACCG,28,18,38,37,121
6793,0,AC005743.5/112916-112798,GUCUAGGGUCUCUGGGUGGUCGCACUGAUCCCGGACGAGCCCCCAAAUGAAAGACCCCCGAAGGGAGACCCUCACUCAAGCCUCGGGACAGCCGCGGACCCAAGAAGACACUGAGACCG,30,14,35,40,119
6794,0,AAHY01194834.1/482-602,GUCUAGGACCUCUGGGGUGGUCGCGCUGAUCCCGGGACGAGUCCCCAAAUGAAAGACCCCCGAAGGGAGACCCUCACUCAAGCCUCGGGACAGCCGCGGACCCAAGAAGACACUGAGACCG,30,14,37,40,121
6795,0,AC127415.3/61247-61364,CUUCAGGGUUCCUGGGUGUCACGCAGACCUCGGUGGGACCUCCAAAUGAAAGAACCUAGUGGGGAAACCCCCACUCAACUCCCGAUUCGGCGUGCACCCAAGAAUCACGAAUAGAACA,33,20,29,36,118
6796,0,AAHX01083112.1/28935-28815,CAUUCGAGUCUCCGGGGGUCACGCUCCUAUCCCGGACGAGCCCCCAAUGAAAGACCCCCAAAUUUGGGGAGACUUUCGCUCCAGUCAUGGGUUGGGGUACCCCCAGGAAACACGAGAAGCC,28,21,33,39,121
6797,0,AC166358.5/82417-82534,UUCAUGGGGUUCUGGGCGCUCCCAAAUCCCGGAAGAGCCCCCAAAUGUAAGACCCCCCGAUAUGGGGACUGCCAUUGUAGUCCAGGGAUAGGGCACACCCACGAACACGAAAGAAUCC,32,19,31,36,118
6798,0,CAAA01060265.1/1635-1751,CUUUGGGGUUCCUGGGUGUCACGCAAAUCUCAGUGGAACUUCCAAAUGAAAGACCCUAGUGGGGAGACCCCCACUCAAGUCCUGAGAUGGCGCACGCACCCAAAGAAUCAUGAGAGA,33,22,31,31,117
6799,0,AAHY01024841.1/8802-8684,UUCUCGGGUUUCUGGGUGCCCCCAAAUCCCGGAAGAGCCCCCAAGAUGUAAAACCCCCCUUCAGGGGACCCCACUCUAAUCUCAGGAGAGAGAGCACACCCAAAGAAACACGAGAAUCC,35,18,26,40,119
6800,0,AC111084.12/32595-32477,UUUCGGGGUUCCUGGGUGUCACGCAGAUCUCGGUGGGACCUCCAAGUGAAAGAACCUAGUGGGGAAACCCCCACUCAAUUCCCCGAUUCGGCAUGCACCCAAGAAUCACGAACAGACGA,31,22,31,35,119
6801,0,CAAA01114016.1/7729-7846,CUUCGGGGUUCCUGGGUGUCACGCAGAUCUCGGUGGAACCUCCAAAUGAAAGAACUCAGUGGGGAAACCCCCACUCAGCUCCCGAUUCGGCGUGCACCCAAGAAUCGCGAAUAGAACA,31,21,31,35,118
6802,0,CAAA01090871.1/528-409,GUCUAGGGUCUCUGGGUGGUCGCGCUGAUCCCAGACCGAGCCCCCAAAUAAAAGACCCCCUCAGGGAGACCCUCACUCAAGCCUCGGGACAGCCGCGGACCCAAGAAGACACCAAGACCA,32,14,31,43,120
6803,0,AAHY01163937.1/688-808,GUCUCGGUCUCUUGGGUGGUUGCAUCAAUCCCGGACGAGCCCCCAAAUGAAAGAUCCCCAAAGGGAGACCCUCACUCAAGCCUCGGGAUGUGGCGCGGACCCAAGAGAGACUGAAAUGGCG,30,20,36,35,121
6804,0,AAHY01003221.1/26787-26669,GUCUAGGACCCCUGGGUGGUCGCGCAAAUCCCAGACGAGCCCCCAAAUGAAAGACCACCGAAGGGAGACCCUCACUCAAGUCUCGGGAACAUCGCGCACCCAGUGGGACACUGAGACUG,32,15,33,39,119
6805,0,AAHY01141809.1/36942-37059,UUUCGGGGUUCCUGGGUGUCACACAGAUCUCGGUGGGACCUCCAAAUGAAAUAACCUAGUGGGGAAACCCCCACUCAAUUCUCGAUUCGGCGCGCACCCAGGAAUCACGAACAGACGA,31,23,30,34,118
6806,0,AC125326.4/24916-24801,GUCUAGGACCUCUGGGUUGUCGCGCUGAUCCCGGACGAGCCCCCAAAUGAAAGACCCCCGAAGGGAGACCCUCACUCAAGCCUCGGGACAGCCGCGGAACCAAGACACUGAGACCG,29,14,33,40,116
6807,0,AAHY01061290.1/14988-15108,GUCUCGGUCUCUUGGGUGGUCGCGUCGAUCCCGGACGAGCCCCCAAAUGUAAGACCCCCGAAGGGAGACCCUCACUCAAGCCUCGGGAUGUGGCGCGGACCCAAGAGAGACGAGGAGACUG,26,18,40,37,121
6808,0,BX544874.5/11626-11743,UUUCGGGGUUCCUGGGUGUCAUGCAGAUCUCGCUGGGGCCUCCAAAUGAAAGAACCUAGUGGGGAAACUCCCACUCAAUUCCCGAUUCGACGUGUACCCAAGAAUCACGAACAGAACA,32,25,29,32,118
6809,0,AC139673.9/254227-254109,AUUUCGAGUCCUUGGGGACCCCUCAAAUCCCGGACGAGCCCCCAAAUGUAGGACCCCCAAGAAGGAGCCCCCCACUCAAGUCUUGGGACUCGGGGUUACCCAAAGAAACAUGAGAGACC,33,18,29,39,119
6810,0,AAHY01057606.1/14377-14267,AUCUAGGACCCCUGGGUGGUCACGCAGAUCCCGGAUGAGCCCCCACCUGAAAAACCCCCGAAGGGAGUCAAGUCUCGGGAAUAGUGCGCACCUAGCAAGACACUGAGACCG,30,15,31,35,111
6811,0,CAAA01139322.1/31228-31110,UUCUCAGGUUUCUGGGUGUCCCCAAAUCCCGGGUGAGCACCCAAGAUGUAAGGCCCCCUUACGGGGACUCCCACUCUAGUCUCAGGAGAGAGAGAGCACCCAAAGAAACACAAGAAUCC,33,21,29,36,119
6812,0,AC116580.4/69268-69376,GUCUAGGACCUCUGGGUGGUCGCGCUGAUCCCGGACGAGCCCCCAAAUGAAAGACCCCCGAAGGGUCAAGCCUCAGGACAGCCGCGGACCCAAGAAGACACUGAGACCG,28,12,33,36,109
6813,0,AAHY01060131.1/27181-27298,CUUCGGGGUUCCUGGGUGUCACGCAGAUCUCGGUGGAACCUCCAAAUGAAAGAACCUAGUGGGGAAACCCCCACUCAACUCCUGAUUCGGCAUGCACCCAAGAACCACGAACAGAACA,34,20,28,36,118
6814,0,AAHY01067049.1/19265-19148,UUUCGGGGUUCCUGGGUGUCACACAGAUCUCGGUGGGACCUCCAAAUGAAAGAACCCAGUGGGGAAACCCCCACUCAAUUCCCGAUUUGGCGUGCACCCAAGAAUCACGCUCCGGGUC,27,24,31,36,118
6815,0,AAHY01111907.1/30494-30377,CUUCGGGGUUCCUGGGUGUCACGCAGAUCUCAGUGGGACCUCCAAAUGAAAGAACCUAGUGGGGAAACCCCCACUCAACCCCCGAUUCGGCGUGCACCCAAGAAUCACAAACAGAACA,34,19,28,37,118
6816,0,AAHY01166748.1/3680-3798,GUCUAGGGUCUCUGGGUGGUCGCGCAAAUCCCGGACGAGCCCCCAAUUGAAAGACCCCCGAAGGAAGACCCUCACUCAAGCCUCGGGACAGCCGCAGACCCAAGAAGACACUGAGACCG,32,14,33,40,119
6817,0,AC165416.12/54705-54588,UGUUAUGACUCCUGGGUGGUCAUCAAAUCCCGGACGAGCCCCCACAUGUUGGACCCCCCCGAAGGGAGACCCUCACUCAAGUCUCAGGGAUCACGAGCCCAGAAAGCCACAACAGUCA,31,19,28,40,118
6818,0,AAHY01060355.1/348-230,GUCUCGGUCUCUUGGGUGGUCGCGUCAAUCCCGGACGAGCCCACAAAUGAAAGACCCCCGAAGGGAGAAGCUCACUCAAGCCUCGGGAUGUGGUGUACACAAAAAGCUAUUUAAUAAAG,34,23,32,30,119
6819,0,CAAA01151772.1/7740-7857,UUUCAGGGUUCCUAGGUGUCAUGCAAAUCUCGUUGGGGCCUCCAAAUGAAAGAACCUAGUGGGGAAACCCCCACUCAAUUCCCGAUUUGGCGUGCACCCAAGAAUCACGAACAGACAA,34,25,27,32,118
6820,0,AAHY01210554.1/8351-8465,CUUUGGGGCUCCUGGGGGUCACGCAAAUCCUGAACAAGCCCUCACAUGAAAGACCCCCAUGGGGAGACCCUCACUCAAGUCUCUGUAUGGUGCGCACCCAAGGAAACAGGAAAGA,32,19,30,34,115
6821,0,CAAA01186857.1/12974-13091,CUUUGGGGUUCCUGGGUGUCACGCAGAUCUCGGUGGAACCUCCAAAUGAAAGAACCUAGUGGGGAAACCCCCACUCAGCUCCUGAUUCGGCGUGCACCCAAGAAUCACGAAUAGAACA,32,23,30,33,118
6822,0,AC140365.4/66008-66126,GUCUAGGACCUCUGGGUGGUCGCGCUGAUCCCGGACGAGCCCCCAAAUGAAAGAUCCCCGAAGGGAGACCCUCACUCAAGCCUCGGGACAGCCGUGGACCCAAGAAGACACUGAGACCA,31,15,34,39,119
6823,0,CAAA01015466.1/1994-1878,UCUCAGGUUUCUGGGUGCCCCCAAAUCCCGGACAAGCACCCAAGAUGUAAGGCCCCCUUUCAGAGACCCCCCACUCUAGUCUCGGGAGAGAGACCACACCCAAAGAAACAUGAGAAU,34,19,25,39,117
6824,0,CAAA01115897.1/3019-2905,CUUUGGGGUUCCUGGGUGUCAUGCAGAUCUCGGUGGGACCUCCAAAUGAAAGACCUCCGUGGGGAUAACCCCACUCAAGUCAUGAGAUAGCGUGCACCCAAAGAAUCAAGAUAGA,32,24,31,28,115
6825,0,AAHX01102209.1/31592-31710,UCUUCGGGGUCUGGGGUGGUCACAAAGAUCCCGGAUGAGCCCCCAAAUUUAAGAUCCCCGAAGGGAGACCCUUACUCAAGUCUUGGGAAGUUGCAGAACCCAGACACACGAGAGACCAG,33,21,33,32,119
6826,0,AAHY01145123.1/805-923,UCUACGGUCUCUGGGUGGUCACGCUGAUCCCGGACCGAGCCCCCAAAUGAAAGACCCCCGAAGGGAGACCCUCACUCAAGCCUCGGGACAGCCGCGGACCCAAGAAGACACUGAGACCG,30,14,33,42,119
6827,0,AC102365.32/109247-109365,UUCUCGUGUUUCUGGGUGCUCCCAAAUCCCGGAUGAGCCCCCAAGAUGUAAGACCCCCUUUCGGGAACCCGCACUCCAGUCUCAGGAGAGAGAGCGCACCCAAAGAAACACGAGAAUCC,31,21,28,39,119
6828,0,AAHY01009611.1/16122-16003,UUCUCGGGUUUCUGGGUGUCCCCAAAUCCUGGACGAGCCCCCAAGAUGUGAUACCCCCUUUUCAGGAGCCCCCACUCUAGUCUUGGGAGAGAGAGCACACCUAAAGAAACACAAGAAUCC,31,25,27,37,120
6829,0,CAAA01024954.1/64045-63927,UUUCGGAGUUCCUGGGUGUCACGCAGAUCUCGGUGGAACCUCCAAAUGAAAGAACCUAGUGGGGAAACCCCCUCUCAAUUCUUGAUUUGGUGUGCACCCAAAGAAUCACGAAAAGAACG,34,27,29,29,119
6830,0,AAHX01093414.1/4263-4386,CAUUUGAGUCUCCGGGUGGGUCACGCUCCCAUCCCGGACGAGCCCCCAAAUGAAAGACCCCCAAACUUGGGGAGACUCUCGCUCCAGUCACAGGUUGAGGUACCCCCAAGAAACGCGAGUAGCU,30,21,32,41,124
6831,0,AAHY01032146.1/2920-2803,UUUCCGGAUUCCUGGGUGUCACGCAGAUCUCGGUGGGACCUCCAAAUGAAAGAGCCUAGUGAGGAAACCUCCACUCAAUUCUCGAUUUGGAGUGCACCCAAGAAUCAAGAACAGAACG,34,25,29,30,118
6832,0,CAAA01119468.1/3239-3121,UUCUUGGGUUGCCGGGUGCCCCCAAAUCUUGGACAAGCCCCCAAGAUGUAAGGCCCCCUUUCAGGUACCCCCAUUCUAGUCUGGGGAGAGAGAGCUCACCCAAAGAAACACGAGAAUCC,30,23,29,37,119
6833,0,AC131776.5/137585-137702,CUUCUGGGUUCCUGGGUGUCACACAGAUCUCGGUGGGACCUCCAAAUGAAAGAACCUAGUGGGGAAACCCCCACUCAGCUCCCGAUUCAGCUUGCACCCAAGAAUCACGAAUAGAACA,33,23,27,35,118
6834,0,AAHY01231071.1/593-713,GUCUAGGGUCUCUGGGUGGUCGCGCUGAUCCCGGACCGAGCCCCCAAAUGAAAGACCCCCAAAGGGAGACCCUCACUCAAGUCUCGGGGACAGCCGCGGACCCAAGAAGACACUGAGACCG,30,15,36,40,121
6835,0,AAHY01469398.1/618-498,CUUCGGGGUUCCUGGGUGUCACACAGAUCCCAGUGGGGCCUCCAAAUGAAAGAACCUAGUGGGGAAACCCCCACUCAACUCCCACCAAUUCGGCGUGCACCCAAGAAUCACGAACAGACGA,34,19,29,39,121
6836,0,AC131720.2/148401-148520,CUUCGGGGUUCCUGGGUGUCACACAAAUCUCGUUGGGAUCUCCAAAUGAAAGACCAUAGUGGGAGACCCCCACUCAAGUCCUGAGAUGGUGUGUGCACCCAAGGAAUCACGGGAGACUGG,30,25,35,30,120
6837,0,AC117254.3/118580-118463,AUUUUGAGUCCUUGGGGACCCCUCAAAUCCUGGACGAGCCCCCAAAUGUAGGACCCCAAGAAGGAGCCCCCCACUCAAGUCUCAGAAUGUGGGGUUACCAAAAGAAACACGAGAGACC,36,19,28,35,118
6838,0,AC107676.10/65385-65500,CGUUAUGACUCCUGGGUGGUCGUCAAAUCCCAGAUGAGCCUCGAUAUGUAGGACCCCCGAAGGGAGACCAUCACUGAAGUCUCAGGGAUCGCGAGCUCAGAAAGCCACAACAGUCA,32,21,31,32,116
6839,0,AAHY01003035.1/12657-12541,UGUUAUGACUUCUGGGUGGUCGUGGAAUCUCAGAUGAGCCCCCACAUGAAGGAACUCCCGAAGGGAGACCCUCACUCCAGUCUCAGGAAUCGCGAGCCCAGAUAGUCACAACAGUCA,31,23,30,33,117
6840,0,AAHY01655117.1/342-461,GUCUAGGACCUCUGGGUGGUCGCGCUGAUCCCGGACGAGCCCCCAAAUGAAAGACCCCCAAAGGGAGACCCUCACUCAAGCCUCGGGACAGCCACGGGACCCAAGAAGACACUGAGACCG,32,13,34,41,120
6841,0,AAHX01271855.1/282-398,UCUUCGGACUCUGGGGUGGUCGCGAAGAUCCCGGACGAGCCCCCAAAUGAAAGAUCCCCGAAGAGAGACCCUUUCUAAAGUCGCAGGAAAUCGCGGACCCCAGACACAGAGAGACCA,34,16,32,35,117
6842,0,AC147514.12/159277-159159,UUCUUGGGUUUCAGGGUGCCCCCAAAUCCCGGACGAGCCCCCAAGAUGUAAGACCCCCUUUCGGGGACCCCCACUCUAGUCUCAGGAGAGAGCACACACUCAAAGAAACUUGAGAAUCC,31,22,27,39,119
6843,0,AC079644.9/146038-145918,GUCUCGGUCUCUUGGGUGGUCGCGCCUAUCCCGGACGAGCCCCCAAAUGAAAGACCCCCGAAGGGAGACCCUCACUCAAGCCUCGGGAUAUGGCGCGGACCCAAAUGAGACACAGAGACCG,29,17,35,40,121
6844,0,AAHY01341790.1/461-346,UUCUUGGGGUUCGGGGUGCCCCCAAAAUCCCGGACGAGCCCCCACGAUGUAGGACCCCAAAUUUAGGGACCCCGCUCUAAUCCAGGAACAGGGAACACCCACGAACACAAGAAUCC,32,17,28,39,116
6845,0,AAHY01106166.1/9701-9582,ACCUUGAGUCCUUGGGGACCCCUCAAAUCCCGGACGAGCCCCCAAGUGUAGGACCCCCCAAGAAGGAGCCCCCCACUCAAGUCUCGGGACGCAGGGUUACCCAAAGAAACACGAGAGACC,33,14,30,43,120
6846,0,AAHY01083312.1/7766-7883,UUUUGGGGUUCCUGGGUGUCACGCAGAUCUCGGUGGGACCUCCAAAUGAAAGAACCUAGUGGGGAAACCCCCACUCUGUUCCCGAUUCAGUGUGCACCCAAAAAUCACAAACAGACCG,31,25,29,33,118
6847,0,AC151974.3/30294-30176,UUCUCAGUUUUCUGGGCGCUCCCAAAUCCCGGACGAGCCUCCAAAUGUAAGACGCCCCUUCCGGGGACCCCCACUCUAGUCUCGGGAGUGUGAGAGCACCCAAAGAAACACGAGGACCC,28,21,29,41,119
6848,0,AAHY01038393.1/929-1048,UUCUCGGGUUUCUGGGCGCUCCCAAAUCCAGGACAAGCCCCCAAAAAUGUAAGACCCCCUUUCGGGGACCCCUACUCUAGUCUCAGGAGUGAGAGAGCACCCAAAGAAACACGAGAAUCC,34,21,27,38,120
6849,0,AC116804.22/2929-3047,CUUCAUGGUUCCUGGGUGUCACACAGAUCUCAGUGGGACCUCCAAAUGAAAGACCGCAGUGGGGAGACCCCCACUCAAGUCCUGAGAUGGCACGCACACCCGAGGAAUCACAAGAGACC,33,19,31,36,119
6850,0,AC133933.4/140984-141100,UUCUUGGGGUUCUGGGUGCCCCCAAAAUCCCGGAUGAGCCUCCAAGAUGUAGGACCCCAGAUAUGGGGACCCCCACUCUAGUCCAGGGACAGGAUGCACCCACGAACACAAGAAUCC,30,20,30,37,117
6851,0,AAHY01131474.1/5845-5728,UUCUUGGGGUUCUGGGUGACCCCAAAAUCCAAGACAAGCCCCCAAGAUGUAGGGCUCCAAAUAUGGGGACCCCCCACUCUAGUCCAGGGACAGGAUGCACCCAUGAACACAAGAAUCC,34,20,28,36,118
6852,0,CAAA01188228.1/26065-26181,UUCUUGGGGUUCUGGGUGCCCCCAAAAUCCAGGACGAGCCCCCAAAAUGUAGGAUCCCAAAUUUAGAGACCCCCACUCUAGUCCAGGAACAGGAAGCACCCACGAACACAAGAAUCC,36,19,25,37,117
6853,0,AC192333.1/35394-35515,GUCUCGGUCUCUUGGGUGGUGGCGUCAAUCCCGGGACGAGCCCCCAAAUGUAAGACCUCCGAAGGGAGACCCUCACUCAAGCCUCGGGAUGUGGUGCGGACCCAAGAGAGAUGCGGAGACCA,27,20,40,35,122
6854,0,CAAA01055771.1/680-796,UUUAGGGGUUCCUGGGUGUCACGCAGAUCUUGGUGGGACCUCCAAAUGAAAGAACCCAGUGGGGAAACCCCCACUCAAUUCCUGUUAGGUGAGCACCCAAGAAUCACGAACAGACGA,33,23,31,30,117
6855,0,CAAA01042493.1/871-989,CUUCGGGGUUCCUGGGUGUCACGCAAAUCUCGGUGGGACCUCCAAAUGAAAGAACUCAGUGGGGAAACCCCCACUCAGGCUCCCGAUUCGGCGUGCACCCAAGAAUCACGAAUAGAACA,32,21,31,35,119
6856,0,CAAA01004934.1/1859-1976,UUCUUGGGUUUCUGGGUGCCCCCAAAUCCCGGAAGAGCCCCCAUGAUGUAAGAUCCCCUUUCAGAGACCCCACUCUAGUCUCAGGAGAGAGAGCAAACCCAAAGAAACACAAGAAUCC,35,22,25,36,118
6857,0,AAHX01263640.1/419-294,AAGUAGGUCUCUCAGGACGAGGGUGGUCGUUCAUCCUGGACGAGCCCCCAAAUGAAAGACCCCCAGAACGGGGAGACCCUCACUCAAGUCUCGGGAUGAUACGACCCCCCAAGAACUCACGUGAGA,35,19,34,38,126
6858,0,CAAA01223862.1/2741-2622,UCUAGGACCUCCUGGGUGGUCGCGCUGAUCCCAGACGAGCCCCCAAAUGAAAGAAUCCCCGAAGGGAGACCCUCACUCAAGCCUCGGGACAGCUGCGGACCCAAGAAGACACUGAGACCG,32,15,33,40,120
6859,0,CAAA01163681.1/682-563,UUUCGGGGUUCUUGGGUGUCACGCAGAUCUCGGUGGGACCUCCAAAUGAAAGAACCUAGUGGGGGAAACCUCCACUCCAAUUCUCGAUUUGGCGCGCACCCAAGAAUCACGAACAGAGGA,31,25,33,31,120
6860,0,AC090563.17/76580-76465,GUCUAGGACCCCUGGGUGGUCACGCAGAUCCCGGAUGAGCCCCCACCUGAAAGACCCCUGAAGGGAGUCAAGUCAAGUCUCAGGAAUAGUGCGCACCUAGCGAGACACUGAGACCG,30,17,34,35,116
6861,0,AAHY01149789.1/3616-3749,UGGUAAGGAUAUUGAAAAAGAGGAACUCUCCUCCAUUGUUGUUCGGACUACUACUGCAAGUGAAAGAUCCCCAAAGGGAGACCCUCACUCAAGCCUCGGGAUGUGGCGCGGACCCAAGAGAGACGCGGAGACCG,39,24,38,33,134
6862,0,AAHY01131380.1/6673-6556,UUUUGGGGUUCCUGGGUGUCACACAGAUCUCGGUGGGACCUCCAAAUGAAAGAACCUAGUGGGGAAACUUCCACUCAAUUCUUGAUUUGGCGUGCACCCAGGAAUCACGAACAGACGA,31,28,31,28,118
6863,0,AC158594.12/70552-70428,GUCUAGGACCUCUGGGUGGUCGCGCUGAUCCCGGACGAGCCCCCAAAUGAAAGACCCCCCCCCCCGAAGGGAGACCCUCACUCAAGCCUCGGGACAGCCGCGGACCCAAGAAGACACUGAGACCA,31,13,34,47,125
6864,0,AC151298.3/113188-113072,UUUCGGGGUUCCUGGGUGUCACGCAGAUCUCGGUGGGACCUCCAAAUGAAAGAACCUAGUGGGGAAACCCCCACUCAAUUCCCGUUUGGUGUGCACCCAAGAAUCACGAACAGACCA,30,24,30,33,117
6865,0,AC159288.4/11124-11244,GUCUCGGUCUCUAGGGUGGUCGUGUCGAUCCCGGACGAGCCCCCAAAUGAAAGACCCCAGAAGGGAGACCCUCACUCAAGCCUCGGGAUAUGGCACGGACCCAAAUGAGACGCGGAGACCG,30,17,37,37,121
6866,0,CAAA01189590.1/327-442,UUCUUGGGGUUCGGGGUGCCCCCAAAAUCCCGGACGAGCCCCCACGAUGUAGAACCCCAAAUUUAGGGAUCCCGCUCUAAUCCAGGAACAGGGAACACCCACGAACACAAGAAUCC,33,18,27,38,116
6867,0,AAHX01110932.1/68457-68578,CCUCUGGGUCCCCGGGGGCUACGCCAGAUCCCGGACGAGCCCCCAGAUGAAAGAACCCCAAAUCAGGGAGACUCUUGUUCCAGUCUUGGGAUGGUGGUGUGCCCCAGGAAACGCGAAUAGCC,27,20,37,38,122
6868,0,AAXL01019324.1/166-283,CUUAGGGUCUCCGGGGGCUACACCAGAUCCUGGACGAGCCCCCAGAUGAAAGAACCCCAAAUAGGGGAGUCUCUCGCUCCAGUCUCGGGAUGGCGUGCCCCAGGAAACACGAGUAGCC,28,18,35,37,118
6869,0,AC116718.21/199065-198947,CUUCAGGGUUCCUGGGUGUCACACAAAUCUUGGUGGAACCUCCAAAUGAAAGACCCUAGUGGGGAGACUCCCACUCAAGUCCCGAGAUGGUGCACACCCAAGGAAUCAAUCACAAGAAA,37,22,28,32,119
6870,0,AAHX01076303.1/480-353,AGCUCGAGUCUCAGGAUGGCACGCCCCAGGAAACACCGAUCCUGGACGAGCCCCCAAAUGAAAGAUCCUCGAAGAGAGACCCUUACUCAAGUCUCGGGAAAUUGUGGACCCCAGACACAGAGAGACCG,39,17,33,39,128
6871,0,AAHX01097670.1/1318-1198,CAUUCGAGUCUCCGGGGGUCAUGCUCAUAUCCCGGACGAGCCCCCAAUGAAAGACCCCCAAACUUGGGGAGACUCUCGCUCCAGUCACAGGUUGGGGUACCCCCAGGAAACACGAGUAGCC,29,20,32,40,121
6872,0,AAHX01018730.1/1907-2026,AUUCGGGUCUCCGGGGGUCACGCUCCUAUCCCGGACGAGCCCCCAAUGAAAGACCCCCAGACUUGGGGAGACUCUCGCUCCAGUCACGGGUUGGGGUACCCCCAGGAAACACGAGAAGCC,26,18,35,41,120
6873,0,AAHX01108728.1/8511-8635,CAUUCGAGUUUCCGGGGGUCACGCUCCAAUCCCGGACGAGCCCCCACCUGAAAGAACCCCAAAAUUUGGGGAGAAUCCCGCUCCAAUCUCGGGAUGGCGGCGUGCCCCAAGAAACUCGAGAAGCC,31,19,33,42,125
6874,0,AAHX01263841.1/575-456,AUUCGGGGUUCCAGGGGGUCACGCUCCGAUCCCGGACGAGCCUCCAAAUGAAAGACCCCCGAAGGGAGCCCCCCACUCAAGUCUCGGGAAAGACGCGCACCCAGUAGGACACAGACACCG,31,13,34,42,120
6875,0,AC122990.5/131789-131669,CAUUCGGAUCUCCGGGAGUUACGCUCCUAUCCCGGACGAGCCCCCAAUGAAAGACCCCCAGACUUGGGGAGACUCUCGCUCCAGUCACGGGUUGAGGUACCCCCAGGAAACACGAGAAGCC,29,19,32,41,121
6876,0,AC156501.3/116415-116529,AUUAUGACUCCUGGGUGGUCGUCAAAUCCCGGGACGAGCCCCCACAUGUAAGACCCCCAAGGGAGACCCUCACUCAAGUCUCAGGGAUCACGAGCCCAGAAAUCCACAACAGUCA,33,18,26,38,115
6877,0,CAAA01109268.1/18617-18497,UCUCAGAGUUCCUGGGCGCUGCCAAAUCCAGGACGAGCCCUCAAAAAUGUAAGACCCCCCUUUUGGGGAACCCCACUCUAGUCUCAGGAGUGAGAGAGCACCCAAAGAAACACGAGAAUCC,36,20,28,37,121
6878,0,AAHY01464610.1/947-828,GUCUAGGACCUCUGGGUGGUCGCCCUGAUCCCCGGACGAGCCCCCAAAUGAAAGACCCCCGAAGGGAGACCCUCACUCAAGCCUCGGGACAGCCGCGGACCCAAGAAGACACUGAGACCG,30,13,34,43,120
6879,0,CAAA01152982.1/213-96,UUCUUGGGGUUCUGGGCGCUCCCAAAUCCCGGACGAGGCCCCAAAUGUAGGAACCCCCAAUAUGGCAAAUCCCACUCUAAUCCAGGGAUAGGGUGCACCCACGAACACGCAAGAAUCC,32,20,28,38,118
6880,0,AC115843.10/167464-167346,UCUCAGGGUUUCUGGGUGCUCCCAAAUCCCGGACAAGCCCCCAAAAAGUAAGUCCCCCUUUCGGGGACCCCCACUCUAGUCUCAGGAGUGAGAGAGCACUCAAAGAAACACAAGAAUUC,34,22,26,37,119
6881,0,AAHY01177414.1/3499-3381,CUUCGGGGUUCCUGGGUGUCACGCAGAUCUCGGUGGAACCCCCAAAUGAAGGAACCUAGUGGGGAAACCCCCCACUCAGCUCCCGAUUCGGCGUGCACCCAAGAAUCACAAAUAGAACA,32,20,30,37,119
6882,0,AAHY01076045.1/15252-15135,GUCUAGGACCUCUGGGUGGUCGCGCGAUCCCGGACGAGCCCCCAAAUGAAAGACCCCCGAAGGGAGACCCUCACUCAAGCCUUGGGACAGCCGCGGACCCAAGAAGACACUGAGACCG,30,13,35,40,118
6883,0,AAHX01026968.1/10814-10930,UCUUCGGGGUCUGGGGUGGGUGCGAAGAUCCCGGACGAGCCCCCAAAUGAAAGAUCCCCGAAGGGAGACCCUUACUCAAGUCUCGGGAAAUCGUGGACCCCAGACAUAGAGAGACCA,31,18,36,32,117
6884,0,AL671520.6/199841-199720,UUCUCGGGUUUCUGGGCACUCCCAAAUCCCGGACAAGCCCCCCAAAAUGUAAGACCCCCCCUUUUGGGGACCCCCACUCUAGUCUUGGGAGUGAUGGAGCACCCAAAAAAACACGAGAAUUG,32,24,27,39,122
6885,0,AAHX01051724.1/626-506,AUUCGGGUCUCCGGGGGUCACGCUCCUAUCCCGGACGAGCCCCCAAUGAAAGACCCCCAAAACUUGGGGAGACUCUCACUCCAGUCACGGGUUGGGGUACCCCCAGGAAACACGAGUAGCC,28,19,33,41,121
6886,0,AAHY01068639.1/8104-7987,CUUCAGGGUUCCUGGGUGUCACAUAGAUCUCGGUAGGACCUCGAAAUGAAAGAACCUAGUGGGGAAAUCCCCACUCAACUCCCGAUUCGGCAUGCACCCAAGAAUCACGAAUAGAACA,36,23,27,32,118
6887,0,AAHY01015524.1/37433-37315,UCUAGGGUCUCUGGGGUGGUCGCGCUGAUCCCGGACGAGCCCCCAAAUGAAAGACCCCCGAAGGGAGACCCUCACUCAAGCCUCGGGACAGCCGCGGACCCAAGAAGACACUGAGACCG,29,14,36,40,119
6888,0,CAAA01014428.1/1449-1567,GUCUAGGGUCUCUGGGUGGUCGUGCUGAUCCCGGACGAGCCCCCAAAUGAAAGACUCCCGCAGGGAGACCCUCACUCAAGCCUCGGGACAGCCGCGGACCCAAGAAGACACCGAGACCA,29,15,35,40,119
6889,0,AAHY01484176.1/16-137,GUCUCGGUCUCUUGGGUGGUCGCGUCAAUCCCGGACGAGCCCCCAAAUGAAAGAUUCCCCAAAAAGAGACCCUCACUCAAGCCUCGGGAUGUGGCGUGGACCCAAGAGAGACGAGGAGACUG,31,20,36,35,122
6890,0,CAAA01187388.1/1687-1570,UUUCAGGGUUCCUGGGUGUCACGCAGAUCUCGGUGGGACCUCCAAAUGAAAGAACCUAGUGGGGAAACCCCCACUCAAAUUUCCAUUUGGCGCGCACCCAAGAAUCACGAGCAGAUGA,32,24,30,32,118
6891,0,AAHX01224099.1/834-712,CAUUCGAGUAUCCGGGGGUCAUGCUCCUAUCCCGGACGAGCCCCCAAUGAAAGACCCCCAAACUUGGGGAGACUCUCGCUCCAGUCAUGGGUUGGGGUACACCCAGGAAACACGAGUAGCCAG,30,21,34,38,123
6892,0,AAHY01344674.1/112-232,UUCUCAGUUUUCUGGGCGCUCCCAAAUCCCGGACGAGCCUCCAAAUGUAAGACGCCCCUUCCGGGGACCCCCCCACUCUAGUCUCGGGAGUGUGAGAGCACCCAAAGAAACACGAGGACCC,28,21,29,43,121
6893,0,CAAA01097503.1/116-1,GUCUAGGACCUCUGGGUGGUCGCGCUGAUCCCGGACGAGCCCCCAAAUGAAAGACCCCCCGAAGGGAGACCCUCACUCAAGCCUCGGGACAGCCGCGGACCCAAGAAGACACUGAG,29,13,34,40,116
6894,0,AC158779.4/29562-29680,CUUAGGGGUUCCUGGGUGUCACGCAGAUCUCGGUGGAACCUCCAAAUGAAAGACCACAGUGGGGAGAUCCCCACUUAAGUCCUGAGAUGGUGCACACACCCAAGGAAUCACGAGAGACC,33,21,33,32,119
6895,0,AAHY01064767.1/10212-10094,UUUUCAGGUUUCUGGGCGCUCCCAAAUCCAGGACGAGCCCCCAAAAUGUAAGACUCCCUUUCGGGGACCCCCACUCUAGUCUCGGGAGUGUGAGAGCACCCAAAGAAACACGAGGACCC,30,22,29,38,119
6896,0,AAHY01212042.1/4791-4673,UUCUCGGGUUUCUGGGUGCCACCAAACCCCAGACGAGCCCCCAAAAUGUAAGACCCCCUUUCAAGGACCCCCGCUCUAGUCUCAGGAGAGAGAGUGUACCCAAAGAAACACGAGAAUCC,34,20,26,39,119
6897,0,AAHY01148354.1/3520-3637,UUCUCGGGAUUCUGGGUGCCCCCAAAUCCCGGACAAGCCCACAAGGUGUAGACCCCCUUUCAGGGACCCCCACUCUAGUCUCGGGAGAGAGAGAACAUGCAAAGAAACACAAGAAUCC,34,19,28,37,118
6898,0,CAAA01188314.1/1787-1906,GUCUAGGUCCCUCUGGGUGGUCGCGCUGAUCCUGGACGAGCCUCCAAAUGAAAGACCCCCGAAGGGAGACCCUCACUCAAGCCUCGGGACAGCCGCGGACCCAAGAAGACACUGAGACCG,29,16,35,40,120
6899,0,CAAA01202014.1/3365-3482,UUUCGGGGUUCCUGGGUGUCACGCAGAUCUCGGUGGGACCUCCAAAUGAAAGAACCUAGUAGGGAAACCCCCACUCAAUUCUCGAUUUGGCUCGCACGCAGGAAUCACGAACAGACAA,32,24,30,32,118
6900,0,AC120159.9/163645-163767,GUCUAGGGUCUCUGAGUGGUCGCGCUGAUCCCGGACGAGCCCCCAAAUGAAAGACCCCCCCCCGAAGGGAGAUCCUCACUCAAGCCUCGGGACAGCCGCGGACCCAAGAAGACACUGAGACCG,30,15,35,43,123
6901,0,AAHY01075790.1/3561-3675,CUUCGGGGUUCCUGGGUGUCACGCAGAUCUUGGUGGAACCUCCAAAUGAAAGACCUCCAUGGGGAUACCCCCACUCAAGUCACGAGAUAGCGCGCACCCAAAGAAUCAUGAGAGA,32,21,30,32,115
6902,0,AAHY01006359.1/30885-31005,CUUCAAGGUUCCUGGGUGUCACGCAGAUCUCGGUGGAACCUCCAAAUGAAAGACCUCAGUGGGGAGACCUCCACUCAAGUCCUGAGAUGGCGCACACACCCAAGGAAUCACGAGAGACCAU,34,21,31,35,121
6903,0,CAAA01008416.1/9797-9680,CUUCGGGGUUCCUGGGUGUCACGCAGAUCUCACUGGGGCCUCCAAAUGAAAGAACCUAGUAGGGAAAACCCCACUCAAUUCCCGAUUCGGUGUGCACCCAAGAAUCACAAACAGACAA,35,22,27,34,118
6904,0,CAAA01153220.1/2512-2629,UUUCGGGGUUCCUGGGUGCCACGCAGAUCUCGGUAGAACCUCCAAAUGAAAGAACCUAGUGGGGAAACCCCCACUCAAUUCCCGAUUCAGCGUUCACCCAAGAAUCACGAACAGACGA,34,22,27,35,118
6905,0,AAHY01003540.1/1155-1273,GUCUCGGUCUCUUGGGUGGUCGCGUCAAUCCCGGACGAGCCCCCAAAUGAAAGACCCCUGAAGGGAGACCCUCACUCAAGCCUCGGGAUGUGGCACGGACCCAAGAGACCGAAAUGGCG,28,18,36,37,119
6906,0,CAAA01076148.1/23843-23722,UUCUCGGGUUUCUGGGAGCUCCCAAAUCCAGGACGAGCCCCCCAAAAUGUAAGACCCCCUUUUGGUGGCCCCCCCAUUAUAGUCUUGGGAGUAAGAGAGCACCCAAAGAAACAUGAGAAUCC,33,25,28,36,122
6907,0,AL606921.6/48390-48508,UUUCCGGGUUCCUGGGUGUCACGCAGAUCUCAGUGGGACCUCCAAAUGAUAGAACCUAGCAGGGAAACCCCCACUCAAUUCCCGAUUUGGCAGGCACCUAAAGAAUCACGAAAAGGCCU,33,24,28,34,119
6908,0,AAHY01046142.1/2419-2539,GUUUAGGACCCCUGGGUGGUAGCGCAAAUCCCGGACGAGCCCCCACAUGAAAGACCCCCCACGAAGGGAGACCCUCACUCAAAUCUUGGGAAGGCGCACACCCAGUGAGACGCUGAGACCG,32,15,34,40,121
6909,0,AC122767.16/82484-82601,UUUUGGGGUUCCUGGGUGUCACACAGAUCUCGGUGGGACCUCCAAAUGAAAGAACCUAAUGGGGAAACCCCCACUCAACUCCCGAUUUGGCGUGCACCCAAGAAUCACAAACAAACAG,35,23,27,33,118
6910,0,AAHY01149173.1/413-288,UUCAUGGGGUUCUGGGCGCUCCCAAAUCCCGGACGAGCCCCCAAAUGUAAGAUCCCCCCACCCCCCGAUAUGGGGACUGCCAUUGUAGUCCAGGGAUAGGGCGCACCCACGAACACGCAAGAAUCC,30,20,32,44,126
6911,0,AC116385.5/38962-39079,UUUUGGGGUUCCUGGGUGUCACACAGAUCUCGCUGGGGCCUCCAAAUGAAAGAACCUAGUGGGGAAACCCCCACUCAACUCCCGAUUUGGCGUGUACCCAAGAAUCACGAACAGACGA,31,24,30,33,118
6912,0,CAAA01197673.1/527-410,UUCGGGGGUUCCUGGGUAUCACGCAGAUCUCGGUGGAACCUCCAAAUGAAAGAACCUAGUGGGGAAACCCCCACUCAGCUCCCGAUUCGGUGUGCACCCAAGAAUCAUGAAUAGAACA,33,23,30,32,118
6913,0,AC134471.3/31150-31269,UUCUCGGGUUUCUGGGUGCCUCCAAAUCCCGGAUAAGCCCACAAGGUGUAAGACCCCCUUUCGGGGACCCCCCACUCUAGUCUUCGGAGAGAGAGAACAUGCAAAGAAACACAAGAAUCC,33,23,28,36,120
6914,0,AAHX01118863.1/631-746,GUCUAGGACCCCUGGGUGGUCGCGCAGAUCCCGGACGAGCCCCCAAAUGAAAGACCCCCGAAGGGAGCCCCCCACUCAAGUCUCGGGAAAGACGCGCACCCAGUAGGACGCAGACA,30,11,34,41,116
6915,0,AC132423.4/124117-123996,AUUUCAAGUUCUUGGGGACCCCUCAAAUCCCGGACGAGCCCGCAAAUGUAAGAUGCCCCCCCAAGAAGGAGCCCCCACUCAAGUCUCAGGAUGCAGCGUCACCCAAAAAAACAUGAGAGACC,38,18,26,40,122
6916,0,CAAA01201832.1/551-674,CUUCGGGGUUCCUGGGUGUCACGCAAAUCCCGGAUGAGCCCCCACAUGAAAGAACCCCCAUAGGGAGACCCCCCCCGCACUCAAGUCUUGGGAUGGCGCACACCCAAGGACAACACGAAAGACC,33,16,31,44,124
6917,0,AC183955.2/142724-142606,UCUUCGGAGUCCUGGGUGGUCACGCUGAUCCCAGACGAGCCCCCAAAUGAAAGAUUCCAAGUGGAGCCCCUUCUCAGAUCUCAGGACAAUAGCGGACACCCAAGAAUUCACAAUAGACC,34,22,27,36,119
6918,0,AC124175.2/39190-39071,CUUCGGGGUUCCUGGGUGUCAUGCAAAUCUUGGUGGAACCUCCAAAUGAAAGACCUCAGUGGGGAGACCCCCCACUCAAGUCCCAAGACAGUGCGCACACCCAAGGAAUCACGAGAGACU,33,21,31,35,120
6919,0,AAHY01069871.1/10805-10924,UUCUCGGGUUUCUGGGAGCUCCCAAAUCCAGGACGAGCCCCCCAAAAUGUAAGACCCCUUUUUGGUGGCCCCCCAUUAUAGUCUCGGGAGUAAGAGAGCACCCUAAGAACAUGAGAAUCC,31,26,28,35,120
6920,0,AAHY01676060.1/199-317,UUCUCAGGUUUCUGGGUGCCCCUAAAUGCCGGACAAGCCCACAAGGUGUAAGACCCCCUUUCAGGGACCCCCACUCUAGUCUCGGGAGAGAGAGAACAUGCAAAGAAACACAAGAAUCC,35,21,28,35,119
6921,0,AC121795.3/97551-97434,UUUCGGGGUUCCUGGGUGUCACGCAGAUCUCGGUGGGACCUCCAAAUGAAAGAACCUAGUGGGGAAACCUCCACUCAAUUCUCGAUUUGGCGCGCACCCAGGAAUCACGAACAGAGGA,30,24,33,31,118
6922,0,AAHY01725139.1/423-543,GUCUAGGACCUCUGGGUGGUCGCGCUGAUCCCGGACGAGCCCCCAAAUGAAAGACCCCCCGAAGGGGAGACCCUCACUCAAGCCUCGGGACAGCCGCGGACCCAAGAAGACACUGAGACCG,30,13,36,42,121
6923,0,AL592224.17/98704-98583,GUCUAGGACCUCUGGGUGGUCGCGCUGAUUCCCGGCCAACGCACCAAAAAUGAAAGACCCCCGAAGGGAGACCCUCACUCAGGCCUCGGGACAGCCGCGUACCCAAGAAGACACUGAGACCA,33,15,33,41,122
6924,0,AAHX01033915.1/10671-10788,UCUUUGGGGUCUGGGGUGGUCGAGAAAUCCCGGACGAACCCCCAAAUGAAACAUCCUGGAAAGGAUACACCCACUCAAGUCUCCGGAAGUCGCAGAACCCAGACACAUGAGAGACCAA,37,18,30,33,118
6925,0,AAXN01037173.1/205-323,CAUUCGAGUCUCCGGGGGUCACGCUCCUAUCCCGGACGAGCCCCCAAUGAAAGACCCCCAAACUUGGGGAGACUCUCGCUCCAGUCACGGGUUGGGGUACCCCCAGGAAACAUGAGUAG,27,20,33,39,119
6926,0,AC113014.9/72984-73102,GUCUAGGACCCCUGGGUGGUUGCGCAGAUCCUGGACGAGCCCCCAACUGAAAGACCCCCAAAGGCAGACACUCACUCCAGUCUCGGGAAUAGCGCGCACCCAGCAAGACACUUAGACUG,31,17,31,40,119
6927,0,AL845533.9/24098-23980,UUUCGGGGUUUCUGGGUGUCACGCAAAUCUCGGUGGGACCUCCAAAUGAAAGAACCUAGUGGGGAACCCCCCCACUCAAUUCCCAAUUCAGUGAGCACCCAAGAAUCACGAACAGAACA,35,23,27,34,119
6928,0,AC154562.2/155881-155760,UUCUCGGGUUUCUGGCCACUCCCAAACCCCAGACGAGCCCCCCAAAAUGUAAGACCCCCCCUUUCAGGGACCCCCACUCUAGUCUCAGGAGUGAGAGAGCACCCAAAGAAACACAAGAAUCC,35,19,23,45,122
6929,0,AAHX01069859.1/126189-126088,GUCUAGGACCCCUGGGUGGUCGCGCAGAUCCCGGACGAGCCCCCAAUGAAAAGACCCCCGAAGGGAGCCCCCACUCAAGUCUCGGGAAAGACGCUACUGCUG,24,13,30,35,102
6930,0,AC166710.7/40167-40291,CUUCGGGGUUCCUGGGUGUCACGCAAAUCCCGGAUGAGCCCCCACAUGAAAGAACCCCCAUAGGGAGACCCCCCCCGCACUCAAGUCUUGGGAUGGCGCACACCCAAGGAAACACGAAAGACCAU,34,17,31,43,125
6931,0,AL672233.18/6867-6984,CUUUGGGGUUCCUGGGUGUCACGCAGAUCUCGGUGGGACCUCCAAAUGAAAGAACCUAGUGGGGAAACCCCCACUCAGCUCCCGAUUCAGCAUGUACCCAAGAAUCACGAAUAGAACA,33,23,29,33,118
6932,0,AAHY01135874.1/2074-2190,CUUCGGGGUUCCUGGGUGUCACGUAGAUCUCGGUGGAACCUCCAAAUAAAAGAACCUAGUAGGGAAACCCCACUCAGCUCCCGAUUCGGCGUGCACCCAAGAAUCACGAAUAGAACA,34,22,28,33,117
6933,0,CAAA01205506.1/15525-15407,CUUCGGGGUUCCUGGGUGUCACGCAGAUCUCGGUGGGACCUCCAAAUGAAAGAACUCAGUGGGGGAAACCCCCACUCUGCUCCCGAUUCGGCGUGCACCCAAGAAUCACGAAUAGAACA,30,22,32,35,119
6934,0,AAHY01201128.1/1670-1552,UUCUUGGGUUUCUGGGUGCCCCCAAAUCCAGGAAGAGCCCCCAAAUUGAAAGACCCAAUUUUGGGGACCCCCACUCUAAUCUCAGGAGAGAGAGCGCACCCAAAGAAACAUGAGAAUCC,36,22,27,34,119
6935,0,CAAA01131629.1/239-359,UGUUAUGACUCCUGGGUGGUCAUCUAAAUCCCGGACGAGCCCCCACAUGUUGGACCCCCCCGAAGGGAGACCCUCACUCAAGUCUCAGGGCAUCACGCAGCCCAGAAAGCCACAACAGUCA,31,20,28,42,121
6936,0,CAAA01082003.1/38576-38462,CUUCGGGGUUCCUGGGUGUCACGCAAAUCCCGAACGAGCCCCCACAUGAAAGACCCCUGUGGGGAGACCCCCACUCAAGACUCGGGAUGGCGCUCACUCAAGGAAACAUGAAAAA,32,17,30,36,115
6937,0,AAHY01148252.1/1107-990,CUUUGGGGUUCCUGGGUGCCACACAGAUCUCAGUGGGACCUCCAAAUGAAAGAACCUAGUGGGGAAACCCCCACUCAGCUCCCGAUUCGGCGUGCACCCAAGAAUCACGAAUAGAACA,33,21,29,35,118
6938,0,AAHY01128924.1/715-831,GUCUAGGGUCUCUGGGUGGUCGCGCUGAUCCCGGACGAGACCCCAAAUGAAAGACCCCCGAAGGGAGACCCUCACUCAAGCCUCGGGACAGCCGCGACCAAGAAGACACCGAGACCA,31,13,34,39,117
6939,0,AAHY01252441.1/611-732,GUCUAGGACCUCUGGGUGGUCGUGCUGAUCCCGGACGAGCCCCCAAAUGAAAGACCCCCCGAAGGGAGACCCUCACUCAAGCCUCGGGGACAGCCGCGGAUCCCAAGAAGACACUGAGACCG,30,15,36,41,122
6940,0,AAHY01742378.1/556-675,GUCUAGGACCCCUGGGUGGUCACGCAAAUCUCGGUCGAGCCCCCAAAUGAAAGACCCCCCGAAGGGAGACCCUCACUCAAGUCUCGGGAACGUCGCGCACCCAGUGGGACACUGAGACCG,29,16,34,41,120
6941,0,CAAA01013731.1/7499-7620,GUCUAGGGUCUCUGGGUGGUCGCGCUGAAUCCCGGACCGAGCCCCCAAAUGAAAAGACCCCCAAAGGGAGACCCUCACUCAAGCCUAGGGACAACCGCGGACCCAAGAAGACACUGAGACCG,34,14,34,40,122
6942,0,CAAA01022709.1/16832-16715,UUCGGGGGUUCCUGGGUGUCACGCAGAAUCUCGGUGGGACCUCCAAAUGAAAGAACCUAGUGGGGAAACCCCCACUCAAUUCCCGUUUGGUGUGCACCCAAGAAUCACGAACAGACCA,31,23,31,33,118
6943,0,AAHY01116113.1/6953-7075,UUCUCGGGUUUCUGGCCGCUCCCAAACCCCAGACGAGCCCCCAAAAAUGUAAGACCCCCCCCUUUCGGGGACCCCCAUUCUAGUCUCAGGAGUGAGAGAGCACCCAAAGAAACACAAAAAUCC,35,20,24,44,123
6944,0,AAHY01097998.1/1606-1730,UUCUUGGGGUUCUUGGCGCUCCCAAAUCCCAGACGAGCCCCCAGAUGUAGGAACCCCCCCCCCCCGAUAUGGGGACCUCCACUCUAAUCCAGGGAUAGUGUGCACCCACGAACACGCAAGAAUCC,29,22,28,46,125
6945,0,AAHY01034088.1/11089-11205,UUUCGGGGUUCCUGGGUGUCACACAGAUCUUGGUGGGACCUCCAAAUGAAAGAACCUAGUGGGGAAACCCCCACUCAAUUCACGUUCGGCGCGCACCCAAGAAUCACGAACAGACGA,32,22,30,33,117
6946,0,AAHY01082961.1/5613-5731,GUCUAGGACCUCUGGGUGGUCGCGCUGUUCCCGGACGAGCCCCCAAAUGAAAGACCCCCGAAGGGAGACCCUCACUCAAGCCUCGGGACAGCAGCUGACCCAAGAAGACACUGAGACCG,30,15,34,40,119
6947,0,AAHY01039250.1/11706-11582,AUCUAGGACCCCUGGGUGGUCGCGCAAAUCCCGGACGAGCCCCCAAAUGAAAGACCCCCCCCCCUGAAGGGAGACCCUCACUCAAGUCUCGGGAUUAGCACACACCCAGCAAGACACUGAGACCA,35,15,29,46,125
6948,0,AAHX01454084.1/181-299,CCUUUGGGUCUCCGGGGGCUACACCAGAUCCUGGACGAGCCCCCAGAUGAAAGAACCCCAAAUAGGGGAGUCUCUCACUCCAGUCUCGGGAUGGCGUGCCCCAGGAAACACGAGUAGCC,28,19,34,38,119
6949,0,AAHY01279545.1/747-631,UAGGGUCUCUGGGUGGUCGCGCUGAUCCUGGACCGAGCCCCCAAAUGAAAGACCCCCGAAGGGAGACCCUCACUCAAGCUUCGGGACAGCCGCGGACCCAAGAAGACACUGAGACCG,29,15,35,38,117
6950,0,AAHX01027785.1/37708-37593,CUUCCGGGUUCUUGGGGGUCGUACAGAUCCCGAACGAGACCCCACAAUGUAGGACCCCUGUCGGGAGACCCCACUCCAGUCUCGGGAUUGUACUACGCCAAGAAACGCAAGAGACA,29,20,31,36,116
6951,0,AABR05148239.1/3960-3835,AAGUUGGUCUUCGGAGAUGAAGGCAGUCACUGAUCCCUGACGAGCCUCCAAAUGAAAGACCCCCAGAGCAGGGAGACCCUCACUCAAGUCUCAGGAUGACAAGACCCCCCAAUAACUCACAAGAGA,41,19,29,37,126
6952,0,AABR05007169.1/7189-7307,UCUUCGGAGUCUGGGGUGGUCACGCAGAUCCCGGAUGAGCCGCCAUUAUGAAAGAUCCCACGCAGAGAGACCCUUACUCAAGUCUUGGGAAAUCGCGGACCCCAGACACAGAGAGACCA,32,20,33,34,119
6953,0,AABR05129581.1/10374-10492,GCUCAGGGCCUGGGGCAGUGAUCUCUGGACGAGCCCCCAAAUGAAAGACCCCUGGUAGCAGGGAGACCCUCACUCAAGUCUCGGGAUGAUGCGACGCCCUAAGUAACUCACAUGAGACC,30,19,34,36,119
6954,0,AABR05077256.1/37449-37332,GUCUAGGACCCCUGGGUGGUCGCGCAGAUCCCGGACGAGCCCCCAAAUGAAAGACCCCGAAGGGAGCCCCCCACUCAAGUCUCGGGAAAGACGCGCACCCAGUAGGACACAGACACCG,31,11,34,42,118
6955,0,AAHX01070763.1/12132-12015,CGUUUGGGGUCCUGGGUAGUCACACAGAUCCCGGACUAGCCCCCCAAAUGAAAGAGCCCCAAAGGGAGGCCCCCCCUCAAGUCUUGAGUCAGCUGCACACCGAAAGACACACAGAUGA,33,17,30,38,118
6956,0,AABR05150414.1/3430-3545,UCUUUGGGGUCUGGGGUGGUCGAGAAGAUCCCGGAUGAGCCCCAAAUGAAAGAUCCCCGAAGGGAGACCCUUACUCAAGUCUCGGGAAAUCACGGACCCCAGACACAGAGAGACCA,33,18,34,31,116
6957,0,AAHX01073404.1/2456-2341,CUUCAGGGUCUGGGGUGGUUGUGAAGAUCCCACACAAGCCCCCAAAUGAAGGAUCCUGGAAGGGAGACCCUUACUCAAGUCUCGGGAAAUCGCAGUCCCAAGACACAGAGAGACCA,34,19,32,31,116
6958,0,AABR05132596.1/16416-16297,UCUUCGGAGUUGUGGGUGGUUGGUAGAUCCCGGACGAGUCCCCAAAUGAAAGACCACCGGGGUGGGGAAGACCCCCACUCAAAUCUCGAGAUGACGCAACCACCAAGAACUCACGAGAAA,35,19,34,32,120
6959,0,AABR05178446.1/7833-7949,UCUUCGGGGUUCUUGGGGGUCAUACAGAUCCAAGACGAGCCCCCACAAUGUAGGACCGCUCUCAGGAGACCCCACUCCAGUCCCGGGAUUGUACUCCCCAAAGAAACGCAAGAGACC,30,20,29,38,117
6960,0,AAHX01441859.1/1958-2072,UCUUCGGGGUCUGGGGUGGUCACGAAGAUCCUGGCCGAGCCCCCAAAUGAAAGAUCCCUGAAGAGAGACCCUUACUCAAGUCCCGGGAAAUCCUGGACCCCAGACACAGGGAGAC,30,18,33,34,115
6961,0,AAPY01491858.1/243-27,AAGACUAUACUUUCAGGGAUCAUUUCUAUAGUUCGUUACUAGAGAAGUUUCUCUGAUCGUGUAGAGCACCGAAAACCACGAGGAGGAGGCGCAGUGUUCUCUCCUGAGCGUGAAGCCGGCUCUUGGUGUCGCUUUGCUGCGACUGCCUUUUGCCAUUGAUGAUCGUUCUUCCUUCCCGCAAGGGUGGGUAAGAGGGAGAGGACGCAGUCUGAGUGGU,45,61,64,47,217
6962,0,ABDC01538673.1/966-749,AAGACUAUACUUUCAGGGAUCAUUUCUAUAGUCCGUUACUAGAGAAGUUUCUCUGAACGUGUAGAGUACCGAAAACCACGAGGAGGAGGCGCAGUGUUCUCUCCUGAGCGUGAAGCCGGCUCUUGGUGUUGCUUCGCUGCAACUGCCACUUGCCAUUGAUGAUCGUUCUUCUCUCUCUUUAUGGGGGAGUGAGAGGGAGAGGACGCAGUCUGAGUGGU,47,62,63,46,218
6963,0,AANN01155091.1/2770-2558,AAGACUAUACUUUCAGGGAUCAUUUCUAUAGUACGUUACUAGAGAAGUUCCUCUGAUCGUGUAGGGCACCCGAAACCACGAGGAGGAGGCACAGCGUUCUCUCCUGAGCGUGAAGCCAGCUCUAGGUGUUGCUUUUGCAACUGCCUUUUGCUAUUGAUGAUCGUUCUUCUCUUCCUUUGGGGGAGAAGAGGGAGAGAACGCAAUCUGAGUGGU,49,61,58,45,213
6964,0,AALT01658977.1/9347-9135,AAGACUAUACUUUCAGGGAUCAUUUCUAUAGUAUGUUACUAGAGAAGUUUCUCUGAUCGUGUAGAGCACCCGAAACCACGAGGAGGAGCCAGAGCAUCCUCUCCUGAGCGUGAAGCCGGCUCUAGGUGUUGCUUCUGCAACUGCCUUUUGCCAUUGAUGAUCGUUCUUCUCUUCCUUUGGAAGGGUGAGAGGGAGAGGAUGCAGUCUGAGUGG,48,61,59,45,213
6965,0,AAWR02012944.1/32312-32098,AAGACUAUACUUUCAGGGAUCAUUUCUAUAGUUCGUUACUAGAGAAGUUUCUCUGAACGUGUAGAGCACCCGAAACCACGAGGAGGAGGCGCAGCGUUCUCUCCUGAGCGUGAAGCCGGCUCUUGGUGUUGCUUCCGCAACUGCCUUUUGCCAUUGAUGAUCGUUCUUCUCUUCUUUUUAGGAGAGUAAGAGGGAGAGGACGCAGUCUGAGUGGU,47,63,59,46,215
6966,0,AC198150.2/173553-173452,AAGACUCUACUUUCAGCGAUCAUUUCUAUAGUUCAUUACCAGAGAAGUUUCUCUGAAUGUGUAGAGCACAAAAAGUAAAUAAGGCCAUGCCUAGACAUGUUA,35,30,18,19,102
6967,0,AY123429.1/65518-65421,AAGACUAUACUUUCAGGGAUCAUUUCUAUAGUUGGUUACUAGAGAAGUUUCUCUGAACGUGUAGAGCACCAAAUAGAAAGCUGAAACUGGAUCCUUUC,31,30,20,17,98
6968,0,ABRT010843960.1/380-596,AAGACUAUACUUUCAGGGAUCAUUUCUAUAGUUUGUUACUAGAGAAGUUUCUUUGAUCGUGUAGAGCACCGAAAACCACGAGGAGGAGCCACAGUGUUUUCUUCUGAGCGUGAAGCCGGCGUUUGGUGUGGUAGUCAUUACAUCUGCCAUUUGCCAUUGAUGAUCGUUCUUACUCUUCUGUGGAAGAGUUAGAGGGGGAAAACGCAUUCUGAGUGGU,52,69,58,38,217
6969,0,AF176810.1/1-214,AAGACUAUACUUUCAGGGAUCAUUUCUAUAGUUCGUUACUAGAGAAGUUUCUCUGAACGUGUAGAGCACCCGAAACCACGAGGAGGAGAUAAAGCGUUCUCUUCUGAGCGUGAAGUCGGCUUUGGGUGUUGCUUCUGCAGCUGCCGUUAGCCAUUGAUGAUCGUUCUUCUUUUCCUUUUAGGAGAUGAAGAGGGAGAGAACGUAAUCUGAGUGG,52,65,58,39,214
6970,0,AAFC03030311.1/44174-43960,AAGACUAUACUUUCAGGGAUCAUUUCUAUAGUUCGUUACUAGAGAAGUUUCUCUGAACGUGUAGAGCACCCGAAACCACGAGGAGGAGAUAAAGCGUUCUCUUCUGAGCGUGAAGUCGGCUUUUGGUGUUGCUUCUGCAGCUGCCGUUAGCCAUUGAUGAUCGUUCUUCUUUUCCUUUUAGGAGAUGAAGAGGGAGAGAACGUAAUCUGAGUGGU,52,67,57,39,215
6971,0,X63743.1/815-1027,AAGACUAUACUUUCAGGGAUCAUUUCUAUAGUUUGUUACUAGAGAAGUUUCUCUGACUGUGUAGAGCACCCGAAACCACGAGGAGGAGACAGAGUGUCCUUUCCUGAGCGUGAAGCCGGCUUUUAGUGCUGCAUUUUGCAACUGCUAUCUGCCAUUGAUGAUCGUUCUCAACUCUCUUGAGGGUUGAGAGGGAGAGGACACAGUCUGAGUGGU,51,63,57,42,213
6972,0,J01884.1/1-215,AAGACUAUACUUUCAGGGAUCAUUUCUAUAGUUCGUUACUAGAGAAGUUUCUCUGACUGUGUAGAGCACCCGAAACCACGAGGAGGAGACGUAGCGUUCUCUCCUGAGCGUGAAGCCGGCUCUUAGUGUUGCUUCCGUGCAACUGCUAUUGGCCAUUGAUGAUCGUUCUCGGUCCUCUCUGAGGGGCGAGAGGGAGAGAACGCAGUCUGAGUGGU,47,59,62,47,215
6973,0,X02722.1/550-763,AAGACUAUACUUUCAGGGAUCAUUUCUAUAGUUCGUUACUAGAGAAGUUUCUCUGACUGUGUAGAGCACCCGAAACCACGAGGAGGAGACGUAGCGUUCUCUCCUGAGCGUGAAGCCGGCUCUUAGUGUUGCUUCCUGCAACUGCUAUUGGCCAUUGAUGAUCGUUCUCGAGCCUCUCUGAGGUUCGAGAGGGAGAGAACGCAGUCUGAGUGGU,48,60,59,47,214
6974,0,AAIY01001061.1/928-1144,AAGACUAUACUUUCAGGGAUCAUUUCUAUAGUUCGUGACUAGAGAAGUUUCUCUGACCGUGUAGAGCACCGAAAACCACGAGGAGGAGGCGCAGCAUUCUCUCCUGAGCGUGAAGCCGGCUCCCGGCGCUGCCUCGCUGCAGCUGCCGCUUGUCAUUGAUGAUCGUUCUUCUCUGCCCUCGGGCGGAGCGAGAGGGAGAGAGUGCAGUCUGAGUGGC,44,51,66,56,217
6975,0,AAKN02033252.1/474-691,AAGGCUAUACUUUCAGGGAUCAUUUCUAUAGUAUGUUACUAGAGAAGCUUCUCUGACUGUGUAGAGCACCAGAAACCACGAGGAGGAGGCGUAGUGUUCCUUCCUGAGCGUGAAGCCGGCUCUCGGCGCUGCUUCAGUGCAGCUGCCGCUUGCCAUUGAUGAUCGUUCCUGCUAUUUCCUCGGAGAUAGCAGGAGGGGAGGAACACAGUCUGAGUGGC,48,56,64,50,218
6976,0,X02717.1/550-764,AAGACUAUACUUUCAGGGAUCAUUUCUAUAGUUCGUUACUAGAGAAGUUUCUCUGACUGUGUAGAGCACCCGAAACCACGAGGACGAGACAUAGCGUCCCCUCCUGAGCGUGAAGCCGGCUCUAGGUGCUGCUUCUGUGCAGCUGCCUCUUGCCAUUGAUGAUCGUUCUUCUCUCCUUCGGGAGGGUAAGAGGGAGGGAACGCAGUCUGAGUGGA,47,57,60,51,215
6977,0,M23705.1/702-916,AAGACUAUACUUUCAGGGAUCAUUUCUAUAGUUCGUUACUAGAGAAGUUUCUCUGACUGUGUAGAGCACCCGAAACCACGAGGACGAGACGUAGCGUUCCCUCCUGAGCGUGAAGCCGGCUCUAGGUGCUGCUUGACUGCAGCUGCCUCCUGCCAUUGAUGAUCGUUCUUCCCUCCUUUGGGAGGGUGAGAGGGAGGGAACGCAGUCUGAGUGGA,46,56,62,51,215
6978,0,M23707.1/503-717,AAGACUAUACUUUCAGGGAUCAUUUCUAUAGUUCGUUACUAGAGAAGUUUCUCUGACUGUGUAGAGCACCCGAAACCACGAGGACGAGACGUAGCGUUCCCUCCUGAGCGUGAAGCCGGCUCUAGGUGCUGCUUGACUGCAGCUGCCUCCUGCCAUUGAUGAUCGUUCUUCCCUCCUUUGGGAGGGUGAGAGGGAGGGAACGCAGUCUGAGUGGA,46,56,62,51,215
6979,0,AC139728.3/90984-91194,AAGACUGUACUUUCGGGGAUCAUUUCUAUAGUUCGUCACUAGAGAAGUUUCUCUGAAUGUGUAGAAUACCCUAAACCAUGAGGAGGAGGUGCAGUGUUCUCUCCUGAGCAAUACCUCUUCUGGUAUUGCUUUUAGAACUGCCAAUAGCCAUUGAUGAUUGUUCUUCUCUUCCUUCAGAAGAGUAAGAGGGGGAGAACACAGUCUGAGUGGU,54,66,51,40,211
6980,0,ACBE01421767.1/283-497,AGGACUAUACUUUCAGGGAUCAUUUCUAUAGUUCGUUACUAGAGAAGUUUCUCUGAAUGUGUAGAGUACCCGAAACCACGAGGAGGAGGCGAAGUGUUCUCUCCUGAGCGUGAAGCUGGCUUUUGGUGCUGUCGUUACAGUUGCCGAUUGCCAUUGAUGAUCGUUCUUUCUCUCUCUUUGGGAGAGUAAGAGGGAGAGAGCACAGUCUGAGUGGU,48,66,62,39,215
6981,0,AF020531.1/104-320,AAGACUAUACUUUCAGGGAUCAUUUCUAUAGUGUGUUACUAGAGAAGUUUCUCUGAACGUGUAGAGCACCGAAAACCACGAGGAAGAGAAGUAGCGUUUUCUCCUGAGCGUGAAGCCGGCUUUCUGGCGUUGCUUGGCUGUAACUGCCGUCAGCCAUUGAUGAUCGUUCUUCUCCCCGUAUUGGGGAGUGAGAGGGAGAGAACGCGGUCUGAGUGGU,50,60,64,43,217
6982,0,M14061.1/277-493,AAGACUAUACUUUCAGGGAUCAUUUCUAUAGUGUGUUACUAGAGAAGUUUCUCUGAACGUGUAGAGCACCGAAAACCACGAGGAAGAGAGGUAGCGUUUUCUCCUGAGCGUGAAGCCGGCUUUCUGGCGUUGCUUGGCUGCAACUGCCGUCAGCCAUUGAUGAUCGUUCUUCUCUCCGUAUUGGGGAGUGAGAGGGAGAGAACGCGGUCUGAGUGGU,49,60,65,43,217
6983,0,X14945.1/538-754,AAGACUAUACUUUCAGGGAUCAUUUCUAUAGUGUGUUACUAGAGAAGUUUCUCUGAACGUGUAGAGCACCGAAAACCACGAGGAAGAGAGGUAGCGUUUUCUCCUGAGCGUGAAGCCGGCUUUCUGGCGUUGCUUGGCUGCAACUGCCGUCAGCCAUUGAUGAUCGUUCUUCUCUCCGUAUUGGGGAGUGAGAGGGAGAGAACGCGGUCUGAGUGGU,49,60,65,43,217
6984,0,ABGA01262676.1/1340-1125,AAGACUAUACUUUCAGGGAUCAUUUCUAUAGUUCGUUACUAGAGAAGUUUCUCUGAACGUGUAGAGCACCGAAAACCACGAGGAAGAGACGUAGCGUUUUCUCCUGAGCGUGAAGCCGGCUUUUGGUGUCGCUUCGUUGCGACUGCCGUCAGCCAUUGAUGAUCGUUCUUCUCUUCUUAUUGGAGAGUAAGAGGGAGAGAACGCGGUCUGAGUGGU,50,63,60,43,216
6985,0,AANU01105435.1/2236-2452,AAGACUAUACUUUCAGGGAUCAUUUCUAUAGUUUGUUACUAGAGAAGUUUCUCUGAAUGUGUAGAGCACCGAAAACCACGAGGAAGAGACGUAGUGUUCUUUCCUGAGCGUGAAGUCCGCAUUUGGUGUUGCUUCACUGCAACCGCCAUUUGCCAUUGAUGAUCGUUCUUCUCUCCAUUUUUGGGGAGUAAGAGGGAAAGAACACGGUCUGAGUGGU,54,67,55,41,217
6986,0,AAGV020566442.1/1857-1640,AAGACUAUACUUUCAGGGAUCAUUUCUAUAGUUGUUGACUAGAGAAGGUUCUCUGAACGUGUAGGGCACCGAAAGCCACGAGGAGGAGGCGCAGCGUUCUCUCCUGAGCGUGAAGCCGGCUCUAGGUGUUGCUUUUCUGCAACUGCCUUUUGCCAUUGAUGAUCGUUUUUCUCUUCCUUUUUGGAUGAGUAAGAGGGAGAGGACGCAGUCUGAGUGGU,46,66,63,43,218
6987,0,ABVD01644074.1/1753-1970,AAGACUAUACUUUCAGGGAUCAUUUCUAUAGUUUGUUACUAGAGAAGAUUCUCUGACUGUGUAGGGUACCGAAAACCAUGAGGAAGAGGUGUAGCGUUCUCUCCUGAGCGUGAAGGCGGCUUUCGGUGUUGCUUUUCUGCAACUGCUUAUUGCCAUUGAUGAUCGUUCUGCUUUUCCAUUUUGGGAGAGUUAGAGGGAGAGAACGCAGUCUGAGUGGU,49,71,61,37,218
6988,0,CABF01044723.1/2170-2355,GAGAUCGUACUUCUAGGGAUCAGUCCUAUAGUACGUAUCACCAGGACGUCAAACAAACUAGACCCUGGCUAACCCACCGCGAUGAUGAUCAGUGCGGCCUAGUCCUGAGCGUGAAGCAGGUGUGUGGCUGUCCGUCUAGCUGACUCCCUAUGGAGUUUGUCCGUGCGGACUUGGCCGCCUCCUUGU,38,46,51,51,186
6989,0,AAGD02005452.1/2742-2555,GAGACCAUACUAUACAGAAUCAUUUCUGCAGUAUGUAUCUCGUAAUUCCCAUCAAAUUGGUAGAGAUGCCAUCCGCGAUGAGUGGGAGACGGGCGGGCCGCGAGCGUGAAACAGUCCUUUCGAGGACUUGAUGACCGCACGGAGCCGAUGAAUUUUUGGAGCCGUAGUGGCCAGCUCUUCUGAGCGGA,46,44,55,43,188
6990,0,AY948622.1/2-186,GAGACCAUACUAUACAGAAUCAUUUCUGCAGUAUGUAUUUCGUAAUUCCCAUCAAAUUGGUAGAGAUUCCAUCCGCAAUGAGUGGGAGACGGGCGAGCCGCGAGCGUGAAACAGUUCUUCGGAACUUGAUGACCGCACGGAGCCGAUGAAUUUUGGAGCCGUAGUGGCUUGCUCUUCUGAGCGGA,47,47,51,40,185
6991,0,CAAC02000606.1/1368922-1368738,GAGACCAUACUAUACAGAAUCAUUUCUGCAGUAUGUAUCUCGUAAUUCCCAUCAAAUUGGUAGAGAUGCCAUCCGCGAUGAAUGGGAGACGGGCUUGCCGCGAGCGUGAAACAGUUCUUCGGAACUUGAUGACCGCACGGAGCCGAUUCAUUUUGGAGCCGUAGUGGCUAGCUCUUCUGAGCGGA,46,47,50,42,185
6992,0,ABKE01003568.1/5923-6108,GAAAUCAUACUUCACAGGAUCAUUUCUGUAGUAUGUAUUUCACAUGAUCCCUCACUCUGCUUUGAACAGGCAACCGCGGUGAUUGGGAAAAGAGCGAAGCGCGAGCGUGAAAAUGCCUUCGGGCUUGAGGACCGCGGACGCUGAAAGCUCACUUUUGGUGGCCUGCGCCUCGCUCAUCUGAGCGGU,43,46,51,46,186
6993,0,AAQA01000362.1/29408-29193,GAGAUCAUACUUCACAGAAUCAUUUCUGUAGUAUGUAUUUCUUCGCUGUUAGCGAAAAUGCGACGGAGCGCAGCCGCGAUGAUGUGGCAGGGCGUCAUCUCCAGAGCGGGAAGAAGUGUGUCAUCCUCACUCCUACAGUGUGGGUGUCAUACUUGAUGACUGCGUGGAGAACCUUGAAUUAGGUUUUCCGGAAGGAGUUGACGCGUGCUGAGCGGU,49,58,65,44,216
6994,0,ABLA01005111.1/2914-3134,GAGACUGUACUUCUCAGGAUCAUUUCUGUAGUACGGUUUCCCGGUGGGAGUUCCACCUUGCUCGCCAAAGCACCCGCGAUGACGAGACUCGGCGUCGUCCCCUGAGCGUGAAGCUCGCCGGGGUCGUCGCUGGAAAGCAUUUUUGGUGAUCGCCCGGCGUUGAGGAACGUCGGCUGGCCCCCCUUGGGGGUCGGCCGCGGGGGCGACGCUCUCUGAGCGGG,31,48,77,65,221
6995,0,ABLG01002636.1/7043-6835,GGGACUGUACUUCUCAGGAUCAUUUCUGUAGUAUGUAUUCCCUUGCGGAGACGCAAACUGCUUCACCAAGCACCCUCGAUGAUGAGUUUAGGCGUUGUUCCCUGAGCGUGAAGCUUGUUGGGACGAUGCCAAAAUUUUGGAUGUCCUGACGUUGAUGAUCGUCAGCUGGCCCUUCGGGUCGGCGAUGGGGACAACGCUCUCUGAGCGGG,40,58,62,49,209
6996,0,CABB01004407.1/4482-4691,GGGACUGUACUUCUCAGGAUCAUUUCUGUAGUACGUAUUCCUUUGCGGAGACGCAAACUGCUUCACAAAGCACCCUCGAUGACGAGUUUAGGCGUUGUCCCCUGAGCGUGAAGCUUGUUGGGACGUUGCCAAAUUUUUGGAUGCCCUGACGUUGAAGACCGUCAGCUGGCCCUUUUGGGUCGGCUAUGGGGGCAACGCUCUCUGAGCGGG,39,58,62,51,210
6997,0,ABWE01000761.1/1590-1369,AUGAUCCUGUACUUUUACAGGAUCAUUUCUAUAGUACCUUCUUUUCUACUUGACUUUCCUAGUAGACAACCUCCUUAACUUUGAUGAUCGCAUUCGACUUCAUGCAUUGACUCGGGAUGUCGGUGGUAGUGCUGUGCUCUCUUUGGGACUGGCCUCCUCCGUUGAUGAACGUCCGCUGUCGUUAUUCCAAGACGGCGUGAGUGUGUGAAGUGAUAUGAGAAG,44,77,52,49,222
6998,0,AAQX01000976.1/70933-71158,AAGACCGUACUUUUACAGGAUCAUUUCUAUAGUACUCUCUAUUCUACUUUCUUUCCAAAAGUAGACAAUUUCAAUAACUUUGAUGAUCGUAUUCGACUUCAUUCAUUGACUCGGGAUGUCGGUGGUUGCAGCGCUGGGUUCUCUUUUGGACUCGGCCCACCCCAUUGAUGAACGUCCGCUGUCGCUAUUCCAAGGCAGCGUGAGUGAGUGGAGUGAUAUGAGAAGU,52,74,51,49,226
6999,0,AATU01001845.1/132925-132701,AAGACCGUACUUACACAGGAUCAUUUCUAUAGUACCUUCUUUUCUACUUGACUUUCCUCGUAGACAAUCUCAAUAACUUUGAUGAUCGUAUUGGACUUCAUUCAUUGACUCGGGAUGUCGGUGGUUGCAGUGCUGAGUUCUCUUUUGAACUUGGUCUCCCCCAUUGAUGAACGUCCGCUGUCGCUAUUCCAAGGCAGCGUGAGUGAGUGGAGUGAUAUGAGAAGU,50,76,51,48,225
7000,0,AAZO01005228.1/11835-12050,AAGAUCAUACUUUUCAGGAUCAUUUCUGUAGUAUGAAUAAUCUUUUGAAGUCGUAGACUUCUGCGCACCAAAACCAUGAUGACGAUUCAUGACAUCUGCGCCUGAGCGUGAGGCAGGCUAUCGUUGAUCUUGUUUAAGGAUCGACUUUAGUCAUCGAUGACCGUUCACCACGGGAGCUCGUCUCUUGUGGGAGGGUGUGGAUGUGAUCUGAGUGGG,50,66,58,42,216
7001,0,AAQB01007950.1/85194-85386,AAGACUAUACUUCACAGGAUCAUUUCUGUAGUCAGUCUUCACUUACUUUCACAUUGAAAGAAAGCCACAUACACCCGCGUUGAUGAGUUGGAUCGUUCUAUUCGGCAGCGUGAGGUAUUUCGCAGUGCCCUCUUUGGGGGCGCAGCGUUUCGAUGAUCGCUCGGUAAAACGAGUAGAACGAAUUCUGAGUGGU,47,56,48,42,193
7002,0,AADE01001755.1/10518-10738,AAGACUAUACUUCACAGGAUCAUUUCUGUAGUCAGUCUUCACUUACUUUCGCACAAAUUGAAAGCCAAACACACCCGCGUUGAUGAGUUAAAUCGUCCUAUUCGGCAGCGUGAGGUUUUGCCCAGCGCCCUUUCUGGUGCGGCACUUCGGUGUCCGUGUCGUUCGGGGCGCAGAGCUUCGAUGAUCGCUCGGUAAAACGGAUAGAACGAAUUCUGAGUGGU,50,61,56,54,221
7003,0,AAFS01000539.1/44651-44431,AAGACUAUACUUCACAGGAUCAUUUCUGUAGUCAGUCUUCACUUACUUUCGCACAAAUUGAAAGCCAAACACACCCGCGUUGAUGAGUUAAAUCGUCCUAUUCGGCAGCGUGAGGUUUUGCCCAGCGCCCUUUCUGGUGCGGCACUUCGGUGUCCGUGUCGUUCGGGGCGCAGAGCUUCGAUGAUCGCUCGGUAAAACGGAUAGAACGAAUUCUGAGUGGU,50,61,56,54,221
7004,0,AC023683.4/143519-143307,AAGACUAUACUUCACAGGAUCAUUUCUGUAGUCAGUCUUCACAUACUUUCACACUAGCUGAAAGCCAAGUGCACCCGCGUUGAUGAGUUGAAUCGUUCUGUCCGGCAGCGUGAGGAUUUGCCCAGCACCCUUGUGGGAUGCACUGCAUCCUUAGCGGGGAGCGGGGCUUCGAUGAUCGCUCGGUUUGAACGGAUAGAGCGAAUUCUGAGUGGU,47,57,59,50,213
7005,0,AAPP01018784.1/368929-369149,AAGACUAUACUUCACAGGAUCAUUUCUGUAGUCAGUCUUCACAUACUUUCACAUUAGAUGAAAGCUAAGCACACCCGCGUUGAUGAGGUGAAUCGUUCUAUUCGGCAGCGUGAGGAUUUGUCCAGCGGCCUUUGUGGUGUGGCGCUUCGGUGUCCGCAUCCUCCGGGUCGUCGGGCUUCGAUGAUCGCUCGGUAACACGAAUAGAGCGAAUUCUGAGUGGU,47,63,60,51,221
7006,0,AAKO01000685.1/22923-22714,AAGACUAUACUUCACAGGAUCAUUUCUGUAGUCAGUCUUCACAUACUUUCACACUAGCUGAAAGCCAAGUGCACCCGCGUUGAUGAGUUGAAUCGUUCUAUUCGGCAGCGUGAGGAUUUGCCCAGUGUCCUUGUUGGUGCCUCGCAUCGUUCGGGACGCAGGGCUUCGAUGAUCGCUCGGUAGAAACGGAUAGAGCGAAUUCUGAGUGGU,47,59,56,48,210
7007,0,AASR01018747.1/1648-1857,AAGACUAUACUUCACAGGAUCAUUUCUGUAGUCAGUCUUCACAUACUUUCACACUAGCUGAAAGCCAAGUGCACCCGCGUUGAUGAGUUGAAUCGUUCUAUUCGGCAGCGUGAGGAUUUGCCCAGUGUCCUUUUUGGUGCCUCGCAUCGUUCGGGACGCAGGGCUUCGAUGAUCGCUCGGUAGAAACGGAUAGAGCGAAUUCUGAGUGGU,47,60,55,48,210
7008,0,AAPQ01007051.1/481137-480929,AAGACUAUACUUCACAGGAUCAUUUCUGUAGUCAGUCUUCACAUACUUUCACACUAGAUGAAAGCUGAGUGCACCCGCGUUGAUGAGUUGAAUCGUUCUAUUCGGCAGCGUGAGGAUUUGUCCAGUGUCCUUUUGGUGCUUCGCAUCUUUCGGGACGCAGGGCUUCGAUGAUCGCUCGGUAGAAACGGAUAGAGCGAAUUCUGAGUGGU,47,63,55,44,209
7009,0,AAEU02000386.1/7816-7607,AAGACUAUACUUCACAGGAUCAUUUCUGUAGUCAGUCUUCACAUACUUUCACACUAGCUGAAAGCCAAGCGCACCCGCGUUGAUGAGUUGAAUCGUUCUAUUCGGCAGCGUGAGGAUUUGUCCAGUGUCCUUUGUGGUGCUUCGCACUGUUCGGGAUGCAGGGCUUCGAUGAUCGCUCGGUAACCACGGAUAGAGCGAAUUCUGAGUGGU,46,61,55,48,210
7010,0,AAPT01021465.1/320367-320151,AAGACUAUACUUCACAGGAUCAUUUCUGUAGUCAGUCUUCACUUACUUUCACACUAUCUGAAAGCACUUCACACCCGCGUUGAUGAGGUGAAUCGUUUUAUUCGGCAGCGUGAGGUUUUGCGUGAUGCCCUUUGCGGUAUGACUUCGGUUAUCCGUGUUGUGGGCGUGGCGCUUCGAUGAUCGCUCGGUAACACGAAUAGAACGAAUUCUGAGUGGU,46,69,55,47,217
7011,0,AANI01014831.1/252349-252134,AAGACUAUACUUCACAGGAUCAUUUCUGUAGUCAGUCUUCACUUACUUUCACACUUUCUGAAAGCAAGUCACACCCGCGUUGAUGAGAUGAAUCGUUUUAUUCGGCAGCGUGAGGAUUUGCGUGAUGCUCUUUGCGAUGUGAUUUUAUCACUCGUUUUGUGGGCGUGGCGCUUCGAUGAUCGCUCGGUAACACGAAUAGAACGAAUUCUGAGUGGU,49,71,52,44,216
7012,0,AAPU01010213.1/13262-13048,AAGACUAUACUUCACAGGAUCAUUUCUGUAGUCAGUCUUCACUUACUUUCACACAAAAUGAAAGCACACCAUACCCACGCUGAUGAGAUGAAUCGGUUUAUUCGGUAGCGUGAGGAUUUGCGUUAUGCCCUUUACGUUGUGACUUGUUGCACGUAUGAUGGGUGUAGCGCUUCGAUGAUCGCUCGGUCACACGAAUAAAACGAAUUCUGAGUGGU,56,65,49,45,215
7013,0,AAAB01008984.1/7337520-7337722,AAGACUGUGCUUCAUAGGAUCAUUUCUAUAGGCAAGUUUUCAACUCACUUUCACUCGAAAGUCGAGCUAUUCCAACCCACGAUGAUGAGGUGUAGUGGCUGUCCUGGAGCGUGAAACUGUCGGAUCUUGGCUGCGUCUCUGACGCGUCGAUCUGUGCUUGAUGAUCGUAUCCAUUUGCAAAGGGCAGACACAUUCUGAGUGGU,46,60,52,45,203
7014,0,AAGE02018994.1/27034-27245,AAGACUGUGCUUCACAGGAUCAUUUCUGUAGGCAAGUUUUCACCACAAGUUUUUACCGAAAGGAAAAGCUUUCCCACCCACGAUGAUGAGACAAUGGUGGCCAGUUUGGAGCGUGAAACUUGGUUCAGUGAGACCAUUCGAUUCUUUCGGAAGGACUUCGGGCUUUUGAUGAUCGGCUUCCUUGCAAUAAAACUGGCCGCGGUCUGAGUGGU,52,60,55,45,212
7015,0,AADK01016831.1/3475-3676,AAGACCUUACUUCAUAGGAUCAUUUCUAUAGUAAGCUCUUACCGAGAACUUCACACUACGUGAAUGAUCGACAACCACGAUGAUGAGGCGUGGCGCGGCAUCCUGAGCGUGAGGCAGGCAAUGGUUAGCUAACCAUUAGCCAUCAAUGAUCGUUCGCUUCCUUUCACAGGGAAGAGUGGGAUGUUGUCGCUAUCUGAGUGGU,52,53,52,45,202
7016,0,AAJJ01000071.1/125775-125565,AAGAUCAUACUUCACAGGAUCAUUUCUGUAGUAUAUCUUCACAUACUCUACACUCAAACGUAGAGUUGACGCAACCACGAUGAUGAGGGACAGUCCUGUAUCCUGAGCGUGAGGCAGAUUUGUUUCAGGUUGCAAAACCUGGCUCAAGUCAUCGAUGAUCGUUCGCAUGAGCUUUUUGCUCAUGUCAUGGAUGCAGGACAGUCUGAGUGGU,55,61,50,45,211
7017,0,AAZX01014918.1/8779-8564,AAGAUCAUACUUCACAGGAUCAUUUCUGUAGUAUAUCUUCACAGACUCUCUACCCAAAGUAGGAGUCGAUGCAACCACGAUGAGGAGACGUAGCUCUCCUUCCUGAGCGUGAGGACGACUCGGAAUUCCGACUUUGGUCGGAAUACCAGUCAUCGAUGAUCGUUCACCUUUUGCACUUUGUGCAGAAGGCAUGGGAGGAUGGGCUUUCUGAGUGGC,53,58,55,50,216
7018,0,AASC02012716.1/1783-2004,AAGAUCAUACUUUUAGGGAUCAUUUCUAAAGUAUGUCUUGCCGAGACGUCGAGUAAAAUCGAUCGGCACGUAAACCACGAUGACGAGAUUGCGUCAGUUCCUCUGAGCGUGAAGUUGAGGCUGGCAUGACUACUGCUCUCGUAGUCAGGCCGUGUCUCGUUGAGGAUCGUUCCUUUCCUCCCUCAGUGGGGACAAGGAGGGGGAACUGGCAAUCAGAGUGGU,52,58,64,48,222
7019,0,ABRM01002704.1/36840-37049,AAGACCGUACUAACUAGGAUCAUUUCUAUAGUAUGCGUCCUGUCAUUGUAAUUCUACAAAGACAACCCACCGAACCAUGAUGAUGAGCUGUUGUGACAGCGCCUGAGCGUGAUGCUAAUCAACUAGAGGCUUGCAGUCUUUAGUUGAUUUAGAUGAUCGUUCUGUCCGCCUAUAAUGGUGGAUAGAGGGCGCUCUCACCAGCUGAAUGGU,55,60,50,45,210
7020,0,ABAV01026709.1/16104-16324,AAGACCGUACUUACUAGGAUCAUUUCUAUAGUACGCGUCCCGUCUUUGUAACCUUACAGAGACAACCACGAUACCCACGGUGACGAUGCAUAGCGUGAUCCUCUGGGCGCGAAGCACGUCGAGGGCAUUGCCUUGAUUGGCGAGUCGCCACCGACGAUUGAUGACCGUUCCUCCCUGCCUAUUAGUGGCUGGGAGGGGGAGGAUCACGCAUUCAGAGUGGG,49,51,63,58,221
7021,0,CU210853.5/178869-178983,AAGCCUAUACUUCCGGGGAUCAUUUCUAUAGUUUGUGACCUAGAAUAAAGGUAGAAAACUGCCUGAUCCAAGGAAUAAAUACCUUCAUACCCAUUUCUUACUCAAGCUCUCCUGG,35,34,19,27,115
7022,0,AAWT01056012.1/14056-14278,AUGACCAGGCUUCAAAGGAUCUUGUCCGUUUAGUUUGUGUCGCCAGAAUGUUAUAAAAUUAUGACCCUGGGCAAAAGUUCGAUGACGUAUUGAUCAUAUUACCAUUUCGAGCGUGAACAAGGCAAAAGCUGUUGAGUCUUACUCAACUUGGCAUUUGUUUAUAAUGAUCGCUUAUUGAUUCUCAUUUGGUCAAUGAAGGAAUGGUAAUAUUUAUCAGAGGACU,64,75,48,36,223
7023,0,AACT01045944.1/3617-3408,AAGAUCAUACUUUUAGGGAUCAUUUCUAUAGUGUGCAUCUUGAAAACGUCAUCAAAUUAUGACGAAACCUCAACUACGAUGAUGAGUUGUAGGGAUUCCUUCUGAGCAUGAAGCUUGGUUCGUUGUAUCUUCGGAUGUUGCGAACUAUUAAGGAUUGUUCUUGGAUUUCCGUUCCGAGAUCUGGGAGGAAGGAAUCUCCGGCUGAGUAGU,54,69,52,35,210
7024,0,AABS01000023.1/32234-32026,AAGAUCAUACUUUUAGGGAUCAUUUCUAUAGUGUGUAUCUUGAAAACGUCGUCAUAUUGUGACGAUACGACAACUGCGAUGAUGAGUCGCAGGAUUCCCCUCUGGAGCAUGAAGCUUUACUGUUUGUAGGUUCAUUUACAAACAGUGAUUGAGGAUUGUUUUCAUUGCUGAUGUAGUUAAUGAAAGGAGGAGAAUCCUUGCUGAGCGGU,56,69,52,32,209
7025,0,ABJB010182825.1/511-296,AAGAUCAUGCUUCAUAGGAUCAUUUCUAUAGGCUGAUCGCCGAGUUUCAACCGUAAACUCGGAACACCCUCAACCACGAUGAGGAGUCGUAGGGUCUCCACCUGAGCGCGAAGCCGGUCAGGUGACUUGGGUUUCCUGCCUGGGUUCCUGCCAUUGAUGACCGUUCCCACCGGGCUUGGACGCCCGCUGGGAGGGUGGAGACUCAUUCUGAGUGGC,43,51,63,59,216
7026,0,ABEP02020740.1/7770-7551,AAGAUCAUACUUUUAGGGAUCAUUUCUAUAGUAUGUGACCCGUGCAUUCUCACGGAAACGUGAACGCACGCAGAAGCCACGAUGACGAGCGGUAGCGUUCCCUUCUGAGCGCGAAGCGGGUCGGGAGUGGAGUCCCUGGGGCUCCGGGCUCCCGGCCAUUGAUGACCGUUCCUUCCCCUCUUACGGAGGGCUUGGAGGAAGGGAACGCAUUCCGAGUGGU,45,49,69,57,220
7027,0,AANH01009063.1/57627-57412,AAGACUAUACUUUCAGGGAUCAUUUCUAUAGUUUCUGACUUGAGAAAUGCGUUUCUAAUUUGUUUGGUCUCGCUAACCACGAUGAAGAGAUGGUGAUACUCUUCCCUGAGCGCGAAGCGGGCGGACAGACUUGAUUCAUUUCAUACGCUGUCCGCUUUUGAUGACCGUUCUUUGUCUCCUCGGGGACAUAGAGGGGAAGAGUAUGUGCGGAGUGGU,48,68,58,42,216
7028,0,CAAE01007620.1/23928-23713,AAGACUAUACUUUCAGGGAUCAUUUCUAUAGUUCCUGACUUGAGAAAUGUGUUUCUAAAGUGUUGGUCUCGCUAACCACGAUGAAGAGGUGGUGAUGCUCCUCUCUGAGCGCGAAGCGGGCAGAGAAACUUGAUUCACUUCAUGUGUUCUCUGCUUUUGAUGACCGUUCAGCGCCUCCAUCCGGGGCUUUGAGGGGAGGAGCAUGAUCAGAGUGGU,48,64,60,44,216
7029,0,BAAF04057796.1/1492-1276,AAGACUAUACUUUCAGGGAUCAUUUCUAUAGUGCAUAACUUGAGAAAUGUGUUUCUAAAGUGAUUGGUCUCGCUAACCACGAUGAAGAGUUAGUGAUGCUUCACCCUGAGCGCGAAGCGUACUUCAGUCAGUGAGUUUCUCACAAGACUGUCGUUAUUGAUGACCGUUCACUGCUUACCUAGGUUAGCAGCGAUGGGUGAAGUAUGUGCCGAGUGGU,55,66,55,41,217
7030,0,BX539315.5/55089-54874,AAGACUAUACUUUCAGGGAUCAUUUCUAUAGUUGUUAACUAGGACAUGUGUUUCUAAAGUGUGGAGUCUUCCAAACCACGAUGAUGAUUCUUGAUACUCUUUUCUGAGCCUGAAUCAGAUGCAGAGAAAUGAUUUAAUUCAUAUUCUCUGUAUCUUUGAUGAAUGUUCCUUGUUGUCUCUUACAACAUAGGAGGAAAAUAGUAUGAUCUGAGUGGU,61,79,43,33,216
7031,0,AAVX01295013.1/566-347,AAGACUAUACUUUUAGGGAUCAUUUCUAUAGUCUCUGAACUGAGAAAUGUUUUUCUGAACUUGGUCGGUUUCGCCAGCCACGAGGAGGAGACAGAGCGGUUCCUUCUGAGCGUGAAGCGGGCUGUGGGUGUUGCCAUCUGUGCAAGAGCUCACAGCCAUUGAUGAUCGUUCUUCCUCUCCUUUAUGGGGAGGUGGAGGGAGGAACCGCAUUCUGAGUGGU,46,64,66,44,220
7032,0,ABGP01000303.1/727-514,AAGACUGUACUUUCUAGGAUCAUUUCUAUAGUACACGUCCCGUCUUUCUUCUCCAAAGAAGACAACCGCAUCAACCAUGAGGAGGAUUAAUAACGUUCUUUCCUGAGCGGGAAGCGGGCGAUAUUGUUCCAGUCUGGAAUGAUAUUGUCAUUGAUGACCGUUCUCGUUGUACUAUUGCAGUAUUUCGGGAGGGAAGGAACGUAUUCUGAGUGGU,54,66,52,42,214
7033,0,X07318.1/1-219,AAGACUAUACUUUCAGGGAUCAUUUCUAUAGGUUGUACCUGGUGAAAUGUGCUCGAAAGUGUCUGAACUCACAAACCACGAGGAAGAGCGUCAGUGUUUUCUCCUGAGCGUGAAGUGAGCUCACAGUGCUGCUUCAUUGUGGCUGCUGUUUGCUAUUGAUGAACGUUCUGCUCCCCUUUAUUAUUGGGGAGAUAGAGGGAGAGAACACAAGCUGAGUGG,54,64,60,41,219
7034,0,Z12613.1/694-913,AAGACUAUACUUUCAGGGAUCAUUUCUAUAGGUUGUACCUGGUGAAAUGUGCUCGAAAGUGUCUGAACUCACAAACCACGAGGAAGAGCGUCAGUGUUCUCUCCUGAGCGUGAAGUGAGCUCACAGUGCUGCUUCAUUGUGGCUGCUGUUUGCUAUUGAUGAACGUUCUGCUCCCCUUUAUUAUUGGGGAGAUGGAGGGAGAGAACACAGGCUGAGUGGU,52,64,62,42,220
7035,0,ABQF01071364.1/398-185,AAGACUAUACUUUCAGGGAUCAUUUCUGUAGUUGGUCACUAGAGGAGAGUGAUCUUCCCUGAUCGGCGUCACAAGCCACGAGGAGGAGCGAGGUGUUCUCUCCUGAGCGCGAAGCGGGCGGGCGGUGCUGCCUGCGCAGGGGCCGCCCGCCAUUGAUGACCGUUCCCGGCCCUCGCAGUGGGGCUCGGGAGGGAGAGAGCACGGGCUGAGUGGU,38,42,79,55,214
7036,0,AAPN01410201.1/1404-1189,AAGACUAUACUUUCAGGGAUCAUUUCUAUAGUAUGUCACUAGAGAAGUGAGAAUGAAAGUGUGAAGAGACGAAAGCCACGAGGAGGAGUUUGAGUGUUCUCUCCUGAGCGCGAAGCGGGCUCGCGGUGCUGCUUUGAGCAGCUGCCGUUUGCCAUUGAUGACCGUUCCUCCUUCUCUUCGGGGAAGGUUGGAGGGAGAGAACACAAGCUGAGUGGU,53,54,68,41,216
7037,0,AAFR03045428.1/4614-4830,AAGACUAUACUUUCAGGGAUCAUUUCUAUAGUAUGUUACUAGAGAAUUGUGGCUGAAAGUGUAGCACGGAGGUAACCACGAGGAGGAGCUGUAGUGUUCUCUUCUGAGCGUGAAGCUGGCUUGUGGUGCUGCUUUCCAGCAGCUGCUACCUGCCAUUGAUGAUCGUUCUUCUCUGCUUUUGGGCAGGGUGAGAGGAAGAGAACGCAAGCUGAGUGGC,49,62,66,40,217
7038,0,ABRN01297802.1/8586-8380,CAGACUGUACUUCAGGGAUCAUUCUAUAGUCGUUUCUAGAGAAGUUCUCUGAAUGUGUAGAGCACUGAAACCACGAGGAGGAGGUGUGGUGUCUGUCUGAGCAUGAAGCUGGUUAUUGGUGUUGCUUCUGCAGCUGCCAUUAGCCAUUGAUGAUCGCUCUUCUCUUCUUUCGGGAGAGUGAGAGGGAGAGAAUGCCAUCUGAGUAAA,48,62,60,37,207
7039,0,ABRP01111646.1/6212-5998,AAGACUAGACUUUUAGGAACCAUUUCUACAUAGUUUCUUACUGGAGAAAUUUCUCUGAACGUACGGAACACCGGAAACCAGGAGGAGGAGGCGUGGCGUUCCCUCCUAAGUGCGAAGCGGGCUCUUGGUGUUGCUUCUGCAACUAUCAUUUGCCAUUGGUGACUGUUCUUCUCUUCCCUUGGGAGAGUAAGAGGGAGGGAUGCUGUCUGAGUGGU,48,62,61,44,215
7040,0,AAQQ01377710.1/265-50,AAGACUAUACUUUCAGGGAUCAUUUCUAUAGUUCGUUACUAGAGAAGUUUCUCUGAUCGUGUAGAGUACCGAAAACCACGAGGAGGAGUUGUAGCGUUCCCUUCUGAGCGUGAAGCAGGCACUUGGUGUUGCUUUACUGCAACUGCCUCUUGCCAUUGAUGAUCGUUCUUCUCUCCUUUUAGGAGAGUAAGAGGGAGGGAACGCAGUCUGAGUGGU,50,66,58,42,216
7041,0,AAYZ01671298.1/83-298,AAGACUAUACUUUCAGGGAUCAUUUCUAUAGUCUGUGACUAGAGAAGUUUCUCUGAUCGUGUAGAGCACCGAAAACCACGAGGAGGAGUUUUAGCAUCCUCUCCUGAGCGUGAAGCUGGCUUUUGGUGUUGCUUUUGUGCAACUGCCACUUGCCAUUGAUGAUCGUUCUUCUCUCCUUGUAGGAGAGUGAGAGGGGGAGGAUGCAGUCUGAGUGGU,47,67,61,41,216
7042,0,AADA01318152.1/802-588,AAGACUAUACUUUCAGGGAUCAUUUCUAUAGCUUGCCACUAGAGAAGCUUUUCUGGACGUGUAGAGCACCGGCAACUGCGAGGAGACGCAGUGUUCUCUCCUGAGCCUGAAACCAGCAAGUUGGUGUUGCUUUGCUGCAGCUGCUGUUUUCCAUUGAUGGAUGAUUCUUCCCUUCCUCUGGGAGAGCAAGCGGGAGAGGACGCAAUCUGAGUGCU,47,60,59,49,215
7043,0,AL627390.7/149172-148958,AAGACUAUACUUUCAGGGAUCAUUUCUAUAGUUUGUUACUAGAGAAGUUUCUCUGAACGUGUAUAGCACUGAAAACCACAAAGAAGAGGUGCAGCAUUAUCUCCUAAGUGUAAAGCCGGCUCUUGAUGUUGCUUUGCUGCAACUGCCAUUUGCCAUUGAUGAUCGUUCUUUUCUUCCUUUGGGAGACUGGGAAGGAAAGGAUGCAAUCUGAGUGG,57,68,51,39,215
7044,0,AADA01192714.1/17868-18084,AAGACUAUACUUUCAGGGAUCAUUUCUAUAGUUCGUUACUAGAGAAGUUUCUCUGAACGUGUAGAGCACCGAAAGCCACGAGGAAGAGACAUAGCGUUUUCUUCUGAGCGUGAAGCCGGCUUUAUGGUGUUGCUUAGCUGCAACUGCCGUCAGCCAUUGAUGAUCGUUCUUCUCUCCACUUGGGGGAGUAAGAGGGAGAGAACGCGGUCUGAGUGGU,52,61,61,43,217
7045,0,Z75549.1/30014-29830,GAGACCAUACUAUACAGAAUCAUUUCUGCAGUAUGUAUCUCGUAAUUCCCAUCAAAUUGGUAGAGAUGCCAUCCGCGAUGAGUGGGAGACGGGCGAGCCGCGAGCGUGAAACAGUUCUUCGGAACUUGAUGACCGCACGGAGCCGAUGAAUUUUGGAGCCGUAGUGGCUUGCUCUUCUGAGCGGA,46,45,53,41,185
7046,0,EU240276.1/1-214,AGGACUAUACUUUCAGGGAUCAUUUCUGUAGUUGGUAACUAGAGGAGUGUGAUCGAAAGUGUCCGGCGUCACAAACCACGAGGAGGAGCAGCGUGUUCUCUCCUGAGCGCGAAGCGGGCGGGCGGUGCUGCUUGUGCAGGAGCCGCCCGUCAUUGAUGACCGUUCCCGUCCCACUUGGUUGGGUCUGGGAGGGAGAGAACACAGGCUGAGUGGU,43,48,75,48,214
7047,0,M38249.1/859-675,GAGACCAUACUAUACAGAAUCAUUUCUGCAGUAUGUAUCUCGUAAUUCCCAUCAAAUUGGUAGAGAUGCCAUCCGCGAUGAGUGGGAGACGGGCGAGCCGCGAGCGUGAAACAGUUCUUCGGAACUUGAUGACCGCACGGAGCCGAUGAAUUUUGGAGCCGUAGUGGCUUGCUCUUCUGAGCGGA,46,45,53,41,185
7048,0,AALT01209640.1/567-377,AUCGCUUCUCGGCCUUUUGGCUAAGAUCAUGUGUAGUAUCUGUUCUUAUCAGUUUAAUAUCUGAUACGUCCUCUAUCAGAGGACAAUAUAUUAAAUGGAUUUUUGGAAUUAGGAGUUGGAAUAGGAGCUUGCUCCGUCCACUCCACGCAUCGACCUGGUAUUGCAGUACUUCCAGGAACGGUGCACCCCCU,45,62,41,43,191
7049,0,AAFR03033875.1/20528-20718,AUCGCUUCUCGGCCUUUUGGCUAAGAUCAAGUGUAGUAUCUGUUCUUAUCAGUUUAAUAUCUGAUACGUCCUCUAUCCGAGGACAAUAUAUUAAAUGGAUUUUUGAAACAGGGAGUCGGAAUAGGAGCUUGCUCCGUCCACUCCACGCAUCGACCUGGUAUUGCAGUACUUCCAGGAACGGUGCACUUCCC,46,59,41,45,191
7050,0,AAIY01044029.1/787-597,AUCGCUUCUCGGCCUUUUGGCUAAGAUCAAGUGUAGUAUCUGUUCUUAUCAGUUUAAGAUCUGAUAUGUCCUCUAUCUGAGGACAACAUAUUAAACGUAUUUUUGGAAAUAGGAGUUGGACCAGGAGCUUGCUCCAUCCACUCCACGCAUCAGCCUGGUAUUGCAGUAUUUCCAGGAAUGGUGCAGCCCCU,46,61,41,43,191
7051,0,AAZO01007389.1/15370-15178,AUCGCUUCUCGGCCUUAUGGCUAAGAUCAAAGUGUAGUAUCUGUUCUUAUCAGCUUAAUAUCUGAUACGACCCUCAUUGAGGGUCCAGAAUAUUAAACUGAUUUUUGGAAACGGAUGGAGUGUUAGGGGCUUGCUCCACCUCCGUCACGGGUUGGCUCGGCAUUGCAGUACAGCCGAGAUCGGCCCACCCUUA,44,56,47,46,193
7052,0,AAYZ01695118.1/310-500,AUCGCUUCUCGGCCUUUUGGCUAAGAUCAAGUGUAGUAUCUGUUCUUAUCAGUUUAAUAUCUGAUACGUCCUCUAUCCGAGGACAAUAUAUUAAAUGGAUUUUUGGACGCUGGAGUUGGACUAGGAGCUUGCUCCAUCCACUCCGCGCAUCGACCUGGUAUUGCAGUACUUCCAGGACCGGUGCACCCCGU,41,60,43,47,191
7053,0,AAHX01044404.1/26102-26292,AUCGCUUCUCGGCCUUUUGGCUAAGAUCAAGUGUAGUAUCUGUUAUUAUCAGUUUAAUAUCUGAUAUGUCCUCUAUCUGAGGACAAUAUAUUAAAUGAAUUUUUGGUACUAGGAGUUGGAAUAGGAGCUUGCUCCAUCCACUCCACGCAUCGACCUGGUAUUGCAGUAUUUCCAGGAAUGGUGCACUCCUC,47,66,39,39,191
7054,0,AACN010750078.1/657-848,AUCGCUUCUCGGCCUUUUGGCUAAGAUCAAGUGUAGUAUCUGUUCUUAUCAGUUUAAUAUCUGAUACGUCCUCUAUCCGAGGACAAUAUAUUAAAUGGAUUUUUGGAGCAGGGAGAUGGAAUAGGGAGCUUGCUCCGUCCACUCCGCGCAUCGACCUGGUAUUGCAGUACCUCCAGGAACGGUGCACCCCCU,44,57,45,46,192
7055,0,ABAV01019481.1/5988-6180,AUCGCUUCUCGGCCUUUUGGCUAAGAUCAAGUGUAGUAUCUGUUCUUAUCAGCUUAAUAUCUGAUACGCUGCUCAUUGAGUAGCUCAUAUAUUAAACUGAUUUUUGGAAACUGGCUGUGGAAUAAGCGGCUUGCUGCGUCCCAGCCACGGGUUGUCUCGGUAUUGCACUACCUCCGAGUACGGCCCCCUUCCC,39,62,43,49,193
7056,0,AAZX01018356.1/721-913,AUCGCUUCUCGGCCUAUUGGCUAAGAUCAAAGUGUAGUAUCUGUUCUUAUCAGCUUGAUAUCUGAUACGCUCCUCAUUGAGGAGCCAGAAUAUCGAACUGAUUUUUGGAAUAUGGCGGAGUGUCUGGGGCUUGCUCCGACUCCGCCACGGGUCGACCUUGCAUUGCAGUACCGCAAGGAACGGCCCACACAAU,44,53,48,48,193
7057,0,AY765362.1/650-458,AUCGCUUCUCGGCCUUUUGGCUAAGAUCAAAGUGUAGUAUCUGUUCUUAUCAGCUUAAUAUCUGAUACGUUCCCUACAUGGGAACUACGAUAUUAAACUGAUUUUUGGUCAGAGGUGAGAUGUCAGGGGCUUGCUCCGCUCUCGCCACGGGUUGGCCUGGUAUUGCAGUACCUCCAGGAACGGCCCACCUUAU,41,60,46,46,193
7058,0,BX927129.10/97355-97165,AUCGCUUCUCGGCCUUUUGGCUAAGAUCAAGUGUAGUAUCUGUUCUUAUCAGUUUAAUAUCUGAUACGUGCCCUACCCGGGCACCAUAUAUUAAAUUGAUUUUUGGAACAGGGAGAUGGAAUAGGGGCUUGCUCCGUCCACUCCACGCAUCGACCCGGUAUUGCAGUACCUCCGGGAACGGUGCACCCCCU,42,55,44,50,191
7059,0,AAFC03011281.1/26348-26158,AUCGCUUCUCGGCCUUUUGGCUAAGAUCAAGUGUAGUAUCUGUUCUUAUCAGUUUAAUAUCUGAUACGUCCUCUGUCCGAGGACAGUAUAUUAAAUGGAUUUUUGGAGCAGGGAGUUGGAAUGGGAGCUUGCUCCGUCCACUCCACGCAUCGACCUGGUAUUGCAGUACUUCCAGGAACGGUGCACCAAAA,45,58,46,42,191
7060,0,AAVX01416582.1/429-619,AUCGCUUCUCGGCCUUUUGGCUAAGAUCAAGUGUAGUAUCUGUUCUUAUCAGUUUAAUAUCUGAUACGUCCCCUAUCUGGGGACCAUAUAUUAAAUUGAUUUUUGGAGCAGGGAGAUGGAAUAGGGGCUUGCUCCGUCCACUCCACGCAUCGACCUGGUAUUGCAGUAUCUCCAGGCACGGUGCACCUCCC,41,59,44,47,191
7061,0,X00093.1/360-550,AUCGCUUCUCGGCCUUUUGGCUAAGAUCAAGUGUAGUAUCUGUUCUUAUCAGUUUAAUAUCUGAUACGUCCCCUAUCUGGGGACCAUAUAUUAAAUGGAUUUUUGGAACAGGGAGAUGGAAGAAGAGCUUGCUCUGUCCACUCCACGCAUCGACCUGGUAUUGCAGUACCUCCAGGACCGGUGCACUUCUC,44,59,43,45,191
7062,0,CAAE01009132.1/1078-888,AUCGCUUCUCGGCCUUUUGGCUAAGAUCAAGUGUAGUAUCUGUUCUUAUCAGUUUAAUAUCUGAUAUGUCCCCGAAAAGGGGACUUCAUAUUAAACCCAUUUUUGCACUCUGGAGUUGUAAUGGGAGCUUGCUCCAUUGACUCCACGCAUUAGCCCAGUAUUGCAGUGCCUCUGGGAGUAGUGCACCUCCU,42,63,41,45,191
7063,0,AF095839.1/1586-1389,AUACCUUCUCGGCCUUUUGGCUAAGAUCAAGUGUAGUAUCUGUUCUUAUCAGCUUAAUUUCUGAUAUAUCGGACACUGUCCGAUUGAGAAAUUAAACUAAUUUUUUGAUGGGGGCAAGGGGUUCCCCUCGUGCUUGCGCGAGUCCCUUGCCACGGGUUGCCCUGCUAUUGCACUACCGGCAGGCGCGGCCCAACCCAC,40,59,47,52,198
7064,0,AANH01015084.1/457-647,AUCGCUUCUCGGCCUUUUGGCUAAGAUCAAGUGUAGUAUCUGUUCUUAUCAGUUUAAUAUCUGAUAUGUCCUCUAUAAGAGGACUACAUAUUAAGCCGAUUUUUAGCUCUGGGAGAUGAAAAAGGGGCUUGCUCCGUUCACUCCAAGCAUCGACCCGGUAUUGCAGCACCUCCGGGAACGGUGCACCCUUC,45,58,42,46,191
7065,0,AC004138.3/33098-33293,AUACCUUUCUCGGCCUUUUGGCUAAGAUCAAGUGUAGUAUCUGUUCUUAUCAGUUUAAUAUCUGAUAUGUGGGCCAUCGGCCCACACGAUAUUAACUCUAUUUUUUAAGGGAGAAAGCCCGUUAAGAUAGCUUGCUAUCUGGGCUUUCACGAGUCGCCCAUGCGUUGCACUACUGCAUGGGCCUGGCUCAACCCGC,43,62,43,48,196
7066,0,AAJJ01003841.1/8097-7907,AUCGCUUCUCGGCCUUAUGGCUAAGAUCAAAGUGUAGUAUCUGUUCUUAUCAGCUUAAUAUCUGAUACGCUCCGCAUGCGGAGCCAGUAUAUUAAACUGAUUUUUGGAACAUGAUGAAGGCUAGGAGCUUGCUCCACCUUCGUCACGGGUUGGCCCGGCAUUGCAGUACAGUCGGGAUCGGCCCACCUAAU,44,55,46,46,191
7067,0,AACY020405974.1/944-1135,AUCGCUUCUCGGCCUAAUGGCUAAGAUCAAGUGUAGUAUCUGUUCUUAUCAGUUUAAUAUCUGGUACGCCGGGCAUAGCCUGGCUCAUAUAUUAAUCUGAUUUUUAGCAUUCGAUCAAGGGAGCGAGGUUUACCUCACCCUGAUCACGGGUUGCCUCGGCAUUGCACUACAGCCGAGUGCGGCCCACUUUUA,42,59,44,47,192
7068,0,AM465080.2/15550-15355,AUACCUUUCUCGGCCUUUUGGCUAAGAUCAAGUGUAGUAUCUGUUCUUAUCAGUUUAAUAUCUGAUACGUGGGACAUCGUCCCACAUGAUAUUAAAUUAAUUUUUUAAGGGGGAGGGUCCACCACAAUAGCUUGCUAUUGGGAUCCUCGAGCGUCGCCCUAGCGUUGCACUACUGCUUGGGCCUGGCGCACCCCUC,42,62,44,48,196
7069,0,M72891.1/1-196,AUACCUUUCUCGGCCUUUUGGCUAAGAUCAAGUGUAGUAUCUGUUCUUAUCAGUUUAAUAUCUGAUAUGUGAACCAUCGGUUCACACGAUAUUAACUCAAUUUUUUAAGGGGGAAGACCCAUCAAAGUAGCUUGCUACUUGGGUCUUCACGCGUCGCCUGGGCGUUGCACUACAGCCCAGGCCUGGCACACCCCAC,46,59,41,50,196
7070,0,BAAB01070452.1/1509-1701,AUCGCUUCUCGGCCUUUUGGCUAAGAUCAAAGUGUAGUAUCUGUUCUUUUCAGCUUAAUAUCUGAAAGUUCCCUCAUUGAGGGACCAGUAUAUUAAACUGAUUUUUGUAAAACGACGAGAUGUUCGGGGCUCGCUCCACUCUCGUCACGGGUCGGCCCGGCAUUGCAGUGCCGCCGGGAUCGGCCCUCAGAUU,40,58,47,48,193
7071,0,X04243.1/69-264,AUCGCUUCUCGGCCUUAUGGCUAAGAUCAAAGUGUAGUAUCUGUUCUUAUCAGCUUAACAUCUGAUAAGUCCUCCAUUGGAGGACAACAAAUGUUAAACUGAUUUUUGGAAUCAGACGGAGUGCUAGGAGCUUGCUCCGCCUCUGUCGCGGGUUGGCCCGGUAUUGCAGUACCCCCGGGAUUUCGGCCCAACUUAA,45,57,47,47,196
7072,0,AAPY01817437.1/27757-27567,AUCGCUUCUCGGCCUUUUGGCUAAGAUCAAGUGUAGUAUCUGUUCUUAUCAGUUUAAUAUCUGAUAUGUCCUCUAUCUGAGGAUAAUGUAUUAAAUGGAUUUUUGGAGUUUGGAGAUGGAGUAGGAGCUUGCUCUGUCCACUCCACGCAUUGACCUGGUAUUGCAGUAUUUCCAGGAACGGUGCACCCCUU,42,68,44,37,191
7073,0,AANG01476605.1/2311-2501,AUCGCUUCUCGGCCUUUUGGCUAAGAUCAAGUGUAGUAUCUGUUCUUAUCAGUUUAAUAUCUGAUACGUCUUCUAUCGGAGGACAAUAUAUUAAAUGGAUUUUUAGAGCUAGGAGAUGGAAUAGGAGCUUGCUCCGUCCACUCCACGCAUCGACCUGGUAUUGCAGUACUUCCGGGAACGGUGUCUUCCUC,44,63,43,41,191
7074,0,AANN01265286.1/964-773,AUCGCUUCUCGGCCUUUUGGCUAAGAUCAAGUGUAGUAUCUGUUCUUAUCAGUUUAAUAUCUGAUACGUCCUCUAUCCGAGGACAUUAUAUUAAAUGGAUUUUUGGAGCAGGGAGUCGGAAUAGGGGCUUGCUCCGUCCGCUCCACGCAUCGACCUGGUAUUGCACGGGGUUCCAGGAACGGUGCACCCCCA,41,57,48,46,192
7075,0,AASG02001826.1/33924-33729,AUACCUUUCUCGGCCUUUUGGCUAAGAUCAAGUGUAGUAUCUGUUCUUAUCAGUUUAAUAUCUGAUACGUGAGCUAUUAGCUCACAUGAUAUUAAAUUAAUUUUUUUUGGGAGAGAGCUCGUAACAGUAGCUUGCUACUGGAGUUCUCGAGCGUCGCCUGUGCGUUGCACUACUGCACUGGCUAGGCGCAUCCCAC,44,67,43,42,196
7076,0,AAEU02000279.1/6988-6794,AUCGCUUCUCGGCCUUUUGGCUAAGAUCAAGUGUAGUAUCUGUUCUUAUCAGCUUAACAUCUGAUAGUUCCUCCAUUGGAGGACAACAAAUGUUAAACUGAUUUUUGGGAUCAGACGGAGUGCUAGGGGCUUGCUCCACCUCUGUCGCGGGUUGCCCCGGUAUUGCAGUACCGCCGGGAUUUCGGCCCAACUGAA,41,58,49,47,195
7077,0,AC189506.1/7126-6931,AUACCUUUCUCGGCCUUUUGGCUAAGAUCAAGUGUAGUAUCUGUUCUUAUCAGUUUAAUAUCUGAUAUGUGGUCCAUCGGACCACACGAUAUUAACUCUAUUUUUCAAGGGUGAAAGCCCAAUAAGAUAGCUUGCUAUCUGGGCUUUCGCGAGUUGUCCAAGCGUUGCACUACUGCAUGGACCUGGCUCAACCCAC,47,63,40,46,196
7078,0,X69327.1/1-196,AUACCUUUCUCGGCCUUUUGGCUAAGAUCAAGUGUAGUAUCUGUUCUUAUCAGUUUAAUAUCUGAUAUGUGGGCCAUGUGCCCACAACGAUAUUAAAUUUAUUUUUUAUGGGGGAGGGCCCACCACAGUAGCUUGCUGCUGGGGCCCUUGCGUGUCGCCCAGGCGUUGCACUGCUGCCUGGGCCGGCGCACCCCAC,36,59,50,51,196
7079,0,AAAA02007579.1/14294-14490,AUACCUUUCUCGGCCUUUUGGCUAAGAUCAAGUGUAGUAUCUGUUCUUAUCAGUUUAAUAUCUGAUAUGUGGGCUAUGUGCCCACUUCGAUAUUAAAUUUAUUUUUUGUGGGGGAGGGUCCACCACAGUGGCUUGCCGCUGGGGCCCUCACGCGUCGCCCAGGCGUUGCACUGCUGCCCGGGCCUGGCGCACUCCAA,34,61,51,51,197
7080,0,AC149482.1/90998-90803,AUACCUUUCUCGGCCUUUUGGCUAAGAUCAAGUGUAGUAUCUGUUCUUAUCAGUUUAAUAUCUGAUACGUGGGCCAUAGGUCCACACGAUAUUAAAUUAAUUUUUUGAGGGGGAGAGUCCAUAACAGUAGCUUGCUACUGGGGCUCUCGGGCGUCGCUCAUGCGUUGCACUAUAGCAAGAGCCUGGCGCACCCCAC,45,59,47,45,196
7081,0,AAPU01010615.1/193731-193537,AUCGCUUCUCGGCCUUAUGGCUAAGAUCAAAGUGUAGUAUCUGUUCUUAUCAGCUUAACAUCUGAUAGUUUCUCCAUUGGAGAACAACAAAUGUUAAACUGAUUUUUGGAAAUAGACGGAGUGUUAGGGGCUUGCUCCACCUCUGUCGCGGGUUGGCCCGGUAUUGCAGUACCGCCGGGAUUCGGCCCAACUAAG,46,58,48,43,195
7082,0,AADA01287270.1/15999-15809,AUCACUUCUCGGCCUUUUGGCUAAGAUCAAGUGUAGUAUCUGUUCUCAUCAGUUUAGUAUCUGAUAUGUCCUCUAUCUGAGGACAAUAUAUUAAAUAGAUUUUUGGAGCAGGGAGAUGGAAUAGGAGCUUGCUCCGUCCACUCCAUGCAUCGACCUGGUAUUGCAGUACCUCCAGGAACGGUGCACUCGCU,46,60,43,42,191
7083,0,AAPT01020503.1/50330-50135,AUCGCUUCUCGGCCUUAUGGCUAAGAUCAAAGUGUAGUAUCUGUUCUUAUCAGCUUAACAUCUGAUAGAUCCUCCAUCGGAGGACAACAAAUGUUAAACUGAUUUUUGGAAAUAGACGGAGUGCUAGGAGCUUGCUCCACCUCUGUCGCGGGUUGGCCUGGCAUUGCAGUACCGCCAGGAUUUCGGCCCAACUAAU,48,56,46,46,196
7084,0,AAAB01008933.1/737524-737331,AUCGCUUCUCGGCCUAAAGGCUAAGAUCAAAGUGUAGUAUCUGUUCUUAUCAGCUUAACAUCUGAUAGCUCUCCCAUUGGGAGACGACAAAUGUUAAACUGAUUUUUGGAAAGAGGCGGAUCGUACGGGGCUUGCUCCACAUCCGCCACGGGUUGGCCCGGUAUUGCAGUACCGCCGGGAUCGGCCCAACUAAU,47,50,49,48,194
7085,0,ABDC01189504.1/6312-6122,AUUGCCUCUCGGCUGUUUGGCUAAGAUCAAGUGUAGUAUCUGUUCUUAUCAGUUUAAUAUCUGAUACGUCCUCUAUCCGAGGACAAUAUAUUAAAUGGAUUUUUGGAGCAGGGAGAUGGAAUAGGAGCUUGCUCCACCCACUCCAUGCAUCGACCUGGUAUUGCAGUACUUUCAGGGACGGUGCACCCCUC,45,59,44,43,191
7086,0,AAWU01010867.1/21259-21065,AUCGCUUCUCGGCCUAAAGGCUAAGAUCAAAGUGUAGUAUCUGUUCUUAUCAGCUUAACAUCUGAUAGUUCUCCCAUAGGGAGACAACAAAUGUUAAACUGAUUUUUGGAAAGCGGCGGAACGUUUAGGGGCUUGCUCCACUUCCGCCACGGGUUGGCCCGGUAUUGCAGUACCACCGGGAUCGGCCCACAUAAC,49,51,47,48,195
7087,0,AANI01016115.1/56636-56831,AUCGCUUCUCGGCCUUAUGGCUAAGAUCAAAGUGUAGUAUCUGUUCUUAUCAGCUUAACAUCUGAUAGUUUCUCCAUUGGAGAACAACAAAUGUUAAACUGAUUUUUGGAAUCAGACGGAGUGCUAGGGGCUUGCUCCACCUCUGUCACGGGUUGGCCCGGCAUUGCAGUAUCGCCGGGACUUCGGCCCAAUUCAA,46,58,46,46,196
7088,0,AC157776.1/115175-114979,AUACCUUUCUCGGCCUUUUGGCUAAGAUCAAGUGUAGUAUCUGUUCUUAUCAGUUUAAUAUCUGAUAUGUGGACCAUGUGUUCACUUUGAUAUUAAAUUUAUUUUUUGUGGGGGAGGGCUCACUACAGUAGCUUGCUACUGGGGUCCUCACGUGUCGCUUGGGCGUUGCACUAUAGUCCAAGCCUGGCGCACCCCAA,40,69,46,42,197
7089,0,AAPP01015704.1/576899-577092,AUCGCUUCUCGGCCUUAUGGCUAAGAUCAAAGUGUAGUAUCUGUUCUUAUCAGCUUAACAUCUGAUAGUUCCUCCAAUGGAGGACAAGCAAUGUUAAACAGAUUUUUGAUAUCAGACGGAGGGUAGGGGCUUGCUCCACCUCAGUCACGGGUCGUCCCGGUAUUGCACUACCGCCGGGAUUCGGCCCACAAAAU,48,53,46,47,194
7090,0,AC151964.12/72254-72449,AUACCUUUCUCGGCCUUUUGGCUAAGAUCAAGUGUAGUAUCUGUUCUUAUCAGUUUAAUAUCUGAUUAGUGGCCCAAUGGGUCACAACAGUAUUAAAUUACUUUUUUGAGUGGGAGAGACCAUUUCAAUAGCUUGCUAUUGGGUUUCUCAAGUGUCGCCUAUGCUUUGCACUAUUGCAUUGGCUGGCACACCCCUC,44,71,40,41,196
7091,0,BAAE01249332.1/245-435,AUCGCUUCUCGGCCUUUUGGCUAAGAUCAAGUGUAGUAUCUGUUCUUAUCAGUUUAAUAUCUGAUAUGUCCUCCAGUGGAGGACAACAUAUUAAGCUGAUUUUUGAAGAACGGAUGUGAAGGUGGAGCUUGCUCUAUUCACUCCAUGCAUUGACCCAGUAUUGCAGUGUUUCUGGGAACAGUGCCCACAUC,46,63,43,39,191
7092,0,AAGE02006086.1/44202-44008,AUCGCUUCUCGGCCUAAAGGCUAAGAUCAAAGUGUAGUAUCUGUUCUUAUCAGCUUAACAUCUGAUAGCUCUCCCAUAGGGAGACAACAAAUGUUAAACUGAUUUUUGGAAAAGGGCGGAACGGUCAGGGGCUUGCUCCACUUCCGCCACGGGUUGACCCGGUAUUGCAGUACCGCCGGGAUCGGCCCACGUUAA,49,49,49,48,195
7093,0,AP009284.1/2157-1962,AUACCUUUCUCGGCCUUUUGGCUAAGAUCAAGUGUAGUAUCUGUUCUUAUCAGUUUAAUAUCUGAUAUGUGGACCAUUGGUUCACAUGAUAUUAACUCAAUUUUUUAAGGGGAAGAGUCCAUCAAGGUAGCUUGCUGCCUGGGCUCUUGCGCGUCGCCCAUGCGUUGCACUACUGCACGGGCCUGGCGCACCCCAC,41,62,45,48,196
7094,0,AAQB01006449.1/663346-663151,AUCGCUUCUCGGCCUUAUGGCUAAGAUCAAAGUGUAGUAUCUGUUCUUAUCAGCUUAACAUCUGAUAGUUUCUCCAUUGGAGAACAACAAAUGUUAAACUGAUUUUUGGAAUCAGACGAAGUGCUAGGGGCUUGCUCCACCUUUGUCGCGGGUUGGCCCGGUUUUGCAGUACCUCCGGGAUUUCGGCCCACUUUAU,43,64,45,44,196
7095,0,AB202073.1/636-444,AUCGCUUCUCGGCCUUUUGGCUAAGAUCAAGUGUAGUAUCUGUUCUUAUCAGUUUAAUAUCUGAUAUGUCCUCUAUAUGGGGAUUAAAUAUUAAAUGCAUUUUUGAGCAGUGGGAGGUGAAAACUGGGGCUUGCUCUCUUCACUCCUUGCAUUGACCUGGUAUUGCAGUGCCACCAGGAACGGUGCACCAUUC,44,66,44,39,193
7096,0,AACT01003467.1/10053-10247,AUCGCUUCUCGGCUCUUUUGAGCUAAGAUCAAGUGUAGUAUCUGUUCUUCUCAGUUUAAUACCUGGGACGGAAACGAUUCGUUUCCUCUAUGUAUUAAUCGGAUUUUUGAACAUGGAGUAUGGUGCUGGAGCUUGCUCCACCCUGCUCACGGGUUGUCCUGGUAUUGCAGUACCUCCAGGCUCGGCCCACACCCC,37,63,45,50,195
7097,0,AF106845.1/1870-2065,AUACCUUUCUCGGCCUUUUGGCUAAGAUCAAGUGUAGUAUCUGUUCUUAUCAGUUUAAUAUCUGAUAUGUGGGCCAUGUGUCUACUUUGAUAUUAAAUUUAUUUUUCGUGGGGGAGAGUCCACCAUAGUGGCUUGCCACUAGGGCCCUCAUGUGUCGCCUAGGCGUUGCACUACAGCCUUGGCUGGUGCACCCCAU,38,68,46,44,196
7098,0,ABBA01028418.1/3128-3319,AUCUCUUCUCGUCCUUUUGGCUAAGAUCAAGUGUAGUAUCUGUUCUUAUCAGUUUAAUAUCUGAUACGUCCUCUAUCAGAGAACAAUUAUAUUAGAUAGAUUUUUGGAGCAGGGAGAUGAAAUAGGAGCUUGCUCUGUCCACUCCACGCGUCGACCUGGUAUUGCAGUACCUCCAGGAAUGGGGCUCCCUCU,46,63,41,42,192
7099,0,X15930.1/1-195,AUACCUUUCUCGGCCUUUUGGCUAAGAUCAAGUGUAGUAUCUGUUCUUAUCAGUUUAAUAUCUGAUAUGUGGGCCAUUGGUCCACACGAUAUUAAAUUUAUUUCUUGAGGGGAAGAGUCCACCACAAUAGCUUGCUAUUCGGUCUCUUGUGUGUCGCUUUUGCGUUGCACUAUAGCAAUUGCUGGCGCACCCCAC,42,69,41,43,195
7100,0,AASR01035668.1/1184-988,AUCGCUUCUCGGCCUUAUGGCUAUGAUCAAAGUGUAGUAUCUGUUCUUAUCAGCUUAACAUCUGAUAGUUCCUCCAUUGGAGGACAACAAAUGUUAAAACUGAUUUUUGGAAUCAGACGGAGUGCUAGGAGCUUGCUCCACCUCUGUCGCGGGUUGGCCCGGUAUUGCAGUACCGCCGGGAUUUCGGCCCAACUGAA,45,58,48,46,197
7101,0,D25323.1/7242-7047,AUACCUUUCUCGGCCUUUUGGCUAAGAUCAAGUGUAGUAUCUGUUCUUAUCAGUUUAAUAUCUGAUAUGUGGGCUAUGUGCCUACUUCGAUAUUAAAUUUAUUUUUUGUGGGGAAGGGUCCACCAUAGUGGCUAGCCACUGGGGCCCUUGAGCGUUGCUCAGCCGUUGCACUGCUGGCAGGGCUGGCGCACCCCAA,38,64,50,44,196
7102,0,AADE01000447.1/58660-58464,AUCGCUUCUCGGCCUUAUGGCUAAGAUCAAAGUGUAGUAUCUGUUCUUAUCAGCUUAACAUCUGAUAGUUUCUCCAUUGGGAGAACAACAAAUGUUAAACUGAUUUUUGGAAUCAGACGGAGUGCUAGGGGCUUGCUCCACCUCUGUCGCGGGUUGGCCCGGUAUUGCAGUACCGCCGGGAUUUCGGCCCAACUGAU,44,59,49,45,197
7103,0,X55772.1/223-413,AUUCUCUCUUUGCCUUUUGGCUUAGAUCAAGUGUAGUAUCUGUUCUUUUCAGUUUAAUCGCUGAAAUCACCUCACUGAGGUGUUUCCGAUUAAUCUUGUUUUUGGUUUGAGUUGGAAAGCCUCUGGCUUGCUAUGCUUUCCGACACUGGUGUUCUUGCUAUUGCACUACUGGCAAGCGACGCCGAAUCUUC,34,75,40,42,191
7104,0,AP007151.1/1974779-1974972,CCAGCUCUCUUUGCCUUUUGGCUUAGAUCAAGUGUAGUAUCUGUUCUUUUCAGUUUAAUCUCUGAAAGUGUUCCAUAGGAACACAACAUUGAUUAAUCUUAUUUUUGGUCUCCGUGGCAGGGCCCCUGUGCUUGCGCAUGCCUUGCCACACAGUGUCAUCGGGCUUACACUAUCCCCGAUAGACGCGAACUCCU,39,65,39,51,194
7105,0,X54113.1/230-419,AUCGCUUCUCGGCCUUUUGGCUAAGAUCAUGUGUAGUAUCUGUUCUUUUCAGAAUAAUAUCUGAAAUGCUGCUCAUCGAGCAGCAAGUAUAUUAAUCUGAUUUUUGGAUGAUCGGCCAUGGAAUAGGGGCUUGCCGUCCUGGCCACGGGUUGGCCCGGUUUGCACUACUGCCGGGAUCGGCCACACUCCC,38,58,48,46,190
7106,0,AATM01000136.1/58626-58436,AUUCUCUCUUUGCCUUUUGGCUUAGAUCAAGUGUAGUAUCUGUUCUUUUCAGUUUAAUCGCUGAAAUCACCCCAUCGGGGUGUUUCCGAUUAUUCUUGUUUUUGGGAAUCGCCGAGAGACCUAUGGCUUGCUAUGUCUCUUGGCACCGGUGUCCUUGCCGUUGCACUCCUGGCAUGCGACGCCGAAAACUC,32,68,43,48,191
7107,0,AAHF01000004.1/976953-976761,UCAGCUCUCUUUGCCUUUUGGCUUAGAUCAAGUGUAGUAUCUGUUCUUUUCAGUUUAAUCUCUGAAAGUGUUCUAAGGAACACAACAUUGAUUAAUCUCAUUUUUGGAUCUCGUGGCAAGGCCUCUGUGCUUGCGCAUGCCUUGCCACACAGUGUCAUUGGGCUUACACUACCCCCAAUUGACGCGACCCUUU,40,68,37,48,193
7108,0,CAAA01181619.1/3682-3492,AUUGCUCGUCGGCCUUUUGGCUAAGAUCAAGUGUAGUAUCUGUUCUUAUCAAUUUAAUAUCUGAUACUUCCUCUAUCUGAGGACAAUGUAUUAAAUGGAUUUUUGGAAGUAGGAGUUGGAAUAGGAGCUUGCUCCGUCCAUUCCACGCAUCGACCUGGUAUUGCAGUACCUCCAGGAACGGUGCACCCCCU,45,62,42,42,191
7109,0,X05084.1/1-193,AUACCUUCUCGGCCUUUUGGCUAAGAUCAAGUGUAGUAUCUGUUCUUAUUAGUUUAAUAUCUGAUAUGUGGGCCAAUGGCCCACACGAUAUUAAAUUUAUUUCUUGAGGGGAAGAGGCCACCACAGUAGCUUGCUAUUGGGUCUCUUACGUGUCGCUCUUGCGUUGCACUAUAGCAAUUGCUGGCGCACCCCA,43,64,43,43,193
7110,0,ABAR01000024.1/421358-421550,UUAGCUCUCUUUGCCUUUUGGCUUAGAUCAAGUGUAGUAUCUGUUCUUUUCAGUUUAAUCUCUGAAAGUGUUCUAAGGAACACAACAUUGAUUAUUCUCAUUUUUGGAUCGCGCACUGAAGUCUCUGUGCUUGCACAUGCUUCGGUGCACUGUGUCCUUGGUCUUACACUACCACCAAGUGACGCGAAUACUU,41,72,37,43,193
7111,0,AAQA01000616.1/21523-21715,AUCGCUUCUCGGCCUAUUGGCUAAGAUCAAAGUGUAGUAUCUGUUCUUAUCAGCUUAAUCUCUGAUAUGUGGUCAAUCGAUCACUUCGAGAUUAUCCUAUUUUUGAGACCAUGGUGGGUUUGAAGGGGCUUGCUCCUCACCUACCGCGGGUCGACCCGGUAUUGCACCUACCUCCGGGAACGGCCCAUUCACC,39,59,44,51,193
7112,0,AY661656.1/2159-2358,AUACCUUUCUCGGCCUUUUGGCUAAGAUCAAGUGUAGUAUCUGUUCUUAUCAGUUUAAUAUCUGAUAUGUGGAUCAUGUGUCCAUUUUGAUAUUAUAAAAUUAAUUUUUAAUGGGGGAAGGCUCAUAAUAGUAGCUUGCUACUAAGGUCUUCAAGUGUCGCUUGGGUAUUGCACUAUUGCCUUAGUCUGGCGCACCCCAA,49,75,41,35,200
7113,0,ABAS01000032.1/96356-96164,UCAGCUCUCUUUGCCUUUUGGCUUAGAUCAAGUGUAGUAUCUGUUCUUUUCAGUUUAAUCUCUGAAAGUGUUCUAAGGAACACAACAUUGAUUAUUCUCAUUUUUGGAUCUCGCAUUGAGGUCUCUGUGCUUGCACAUGCCUCGAUGCAUUGUGUCCUUGGUCUUACACUACCACCAAGUGACGCGAACUACU,41,72,36,44,193
7114,0,AAJN01000116.1/21716-21908,CCAGCUCUCUUUGCCUUUUGGCUUAGAUCAAGUGUAGUAUCUGUUCUUUUCAGUUUAAUCUCUGAAAGUGUUCUAAGGAACACAACAUUGAUUAAUCUCAUUUUUGGAUCUCGUGGCGGGUCCUCUGUGCUUGCGCAUGUCCUGCCACACAGUGUCAUCGGGCUUACACUACCCCCGAUCGACGCGAACUCUU,38,66,39,50,193
7115,0,ABDB01000030.1/249236-249428,CCAGCUCUCUUUGCCUUUUGGCUUAGAUCAAGUGUAGUAUCUGUUCUUUUCAGUUUAAUCUCUGAAAGUGUUCUAAGGAACACAACAUUGAUUAAUCUCAUUUUUGGAUCCCGUGGUGAGGCCUCUGUGCUUGCGCAUGCCUCGCCACACAGUGUCAUCGGGCUUACACUACCCCCGAUUGACGCGAACCACC,40,62,39,52,193
7116,0,CAAL01000198.1/59590-59777,AUACCUUCUCGGCCUUUUGGCUAAGAUCAAGUGUAGUAUCUGUUCUUAUCAGAGUGAUAUCUGAUAUCUCCUACGAGGAGAAUGAUAUCACUGCAAUUUUUAAAUGGGGCUGGGUUUACUUGGGGCUUGCCCCGGUCCCAGCAUAGUCGACCCUGACUUACACGACCUCGGGGAACGGCUAACCCGCU,42,55,45,46,188
7117,0,AACD01000084.1/492354-492546,CCAGCUCUCUUUGCCUUUUGGCUUAGAUCAAGUGUAGUAUCUGUUCUUUUCAGUUUAAUCUCUGAAAGUGUUCUAAGGAACACAACAUUGAUUAAUCUUAUUUUUGGUCUGAGCGGCAGGACCUCUGUGCUUGCGCAUGUCCUGCUGCACAGUGUCAUCGGGCUUACACUACCCCCGAUCGACGCGAACGCAA,41,63,41,48,193
7118,0,AACM02000140.1/27654-27846,UUAGCUCUCUUUGCCUUUUGGCUUAGAUCAAGUGUAGUAUCUGUUCUUUUCAGUUUAAUCUCUGAAAGGUCUCCAAGGAGACCAACAUUGAUUAUUCCUAUUUUUGGAUUCCGGGCAAUUUCCUCUGUGCUUGCACAUGAUUUUGCCCACUGUGUCCCUAGUAUUACACUGCCUCUAGGUGACGCGAACGCGC,38,71,38,46,193
7119,0,AAKD03000004.1/610702-610510,UCAGCUCUCUUUGCCUUUUGGCUUAGAUCAAGUGUAGUAUCUGUUCUUUUCAGUUUAAUCUCUGAAAGUGUUCUAAGGAACACAACAUUGAUUAAUCUCAUUUUUGGAUUCUGUGGAGAGGCCUCUGUGCUUGCGCAUGCCUCACCACACAGUGUCAUCGGGCUUACACUACUCCCGAUUGACGCGAACCACC,42,65,38,48,193
7120,0,AANU01167734.1/2229-2419,AUCACUUCUCGGCCUUUUGGCUAAUAUCAAGUGUAGUAUCUGUUCUUAUCAGUUUAAUAUCUGGUAUGUCCUCUAUCCGAGGACAAUAUAUUAAAUGGAUUUUUGGAAAUAAGAGAUGGAAUAGGGGCUUGCUCCGUCCACUCCACUCAUUGACCUGGUAUUGCAGUACUUCCAGAAACGGUGCACAAAAA,53,62,38,38,191
7121,0,AAEE01000010.1/89978-89784,AUACCUUCUCGGCCUUUUGGCUAUGAUCAAGUGUAGUAUCUGUUCUUAUCAGUGUGACAACUGAUAUGGGUCCUACGGGACCUAUUAAUAGUCACAGAAAUUUUUUUCUGGGUGAAUGCGAUCUCUGAGCUUGCUCAUGUCUCGUUCAAAUUGUUGCCUCGUCCUUACACUACCGACUUGUGCAGCAUACCCUCU,41,69,39,46,195
7122,0,AARE01006627.1/693-886,CCAGCUCUCUUUGCCGUAAGGCUAAGAUCAAGUGUAGUAUCUGUUCUUUUCAGUUUAAUCUCUGAAAGUAUUCCACUGGAAUACAACAUUGAUUAAUCUCAUUUUUGGUCCCCGUGGGAAUUCCUCUGUGCUUGCACAUGUAUUCCCGCACUGUGUCACUGGUCUUACACUGUCACCAGUAGACGCGAACUCAU,44,66,36,48,194
7123,0,AACW02000228.1/581455-581260,UUAUCCUCUCAGGCCUUUUGGCUAAGAUCAAGUGUAGUAUCUGUUCUUUAUAGUUUAACAACUAUAAUGAGGGACAUUGUCCCUCUCGUUGUUAAUCUAAUUUUUUCCACCAGGAAACUAAGGCUCUGGCUUGCUAUCUUUGGUUUCCACAGGUGUCCCUUGCCUUACACUAUCAGCGAGGUGACGCCGACCUUUU,42,71,37,46,196
7124,0,AM270020.1/5920-6112,CCAGCUCUCUUUGCCUUUUGGCUUAGAUCAAGUGUAGUAUCUGUUCUUUUCAGUUUAAUCUCUGAAAGUGUUCUAAGGAACACAACAUUGAUUAAUCUUAUUUUUGCAUCCCGUGGCGAGACCUCUGUGCUUGCGCAUGUCUUGCUGCACAGUGUCAUCGGGCUUACACUACCCCCGAUCGACGCGAACACCC,40,64,38,51,193
7125,0,AAIM02000113.1/450420-450612,UUAGCUCUCUUUGCCUUUUGGCUUAGAUCAAGUGUAGUAUCUGUUCUUUUCAGUUUAAUCUCUGAAAGAUGUCUAAGGACAUCAAUCGUGAUUAUUCCUAUUUUUGGCCAGGGGACGGCUUCCUCUAUGCUUGCAUAUGAUCCCGUCCACAGUGUCCCUAGUAUUACACUGCCUCUAGGUGACGCGAACGCGC,39,68,40,46,193
7126,0,ABBB01000093.1/1472-1279,CCAGCUCUCUUUGCCAUUAUGGCUUAGAUCAAGUGUAGUAUCUGUUCUUUUCAGUUUAAUCUCUGAAAGUAUUCUAAGGAAUACAACAUUGAUUAAUCUUAUUUUUGGACCUCGCGGAGAGACCUCUGUGCUUGCGCAUGUCUUUCCGCACCGUGUCAUCGGUCUUACACUACCACCGAUCGACGCGAAACCCA,45,64,36,49,194
7127,0,AAFU01000671.1/40760-40955,UUAGCUCUCUUUGCCUUUUGGCUUAGAUCAAGUGUAGUAUCUGUUCUUUUCAGUUUAAUCUCUGAAACUGCUCUACGGAGUAGAUUUAUUUGAUUAAAUUAAUUUUUGUCCCUCGGGACUCAGUCCACUCGGCUUGCCGAGCCUGAAUCCCACCGUGUCUCCAGUAUUACACUGCCUCUGGACGACGCAAACCUUU,40,71,36,49,196
7128,0,CR382129.1/446178-446370,ACAAAUCUCUUUGCCUUUUGGCUUAGAUCAAGUGUAGUAUCUGUUCUUUUCAGUGUAACAACUGAAACGGCCCAAUUUGGGUCUUUUAAUGUUACAACUAUUUUUGCAGCUAGUGGGUCUCUCUCUGGGCUUGCUCAUGGAGACCCGCACUGUGUCGUUGCCCUUACACUACCGGCUUCUGACGCUAUCUAUG,38,69,40,46,193
7129,0,AAPN01113121.1/7070-7251,AUUGCUUCUCGGCCUUUUGGCUAAGAUCAAGUGCAGUAUCUGUUCUUAUCAGUUUAAUAUCUGAUACGUCCUCUAUCCAUAUUAAAUGGAUUUUUGGAGCAAGGAGAUGGAAUAGGGGCUUGCUCCGCCCACUCCAUGCAUUGACCUGGUAUUGCACUACUUCCAGGAACGGUGCGCUCCCC,40,58,40,44,182
7130,0,AAQQ01759780.1/669-855,AUCACUUUUUGGCCUUUUGGCUAAAAUCAAGUGUAGUAUCUGUUCUUAUCAGUUUAAUAUCUGAUAUGUUCUCUGAGGACAAUAUAUUAAAUGGAUUUUUGGAGCAGGGAAAUGGAAUAGGAGCUUGCUCCAUCCACUCCACACAUUGACCUGGUAUCGCAGUACCUUUAGGAAGAGUGCACUCUCC,50,63,38,36,187
7131,0,AAQX01002532.1/7801-7990,AUACCUUCUCGGCCUUUUGGCUAAGAUCAAGUGUAGUAUCUGUUCUAAUCAGUGUGAAAACUGGUUUCCGACGUUUUUCGUUGGUCUUUUUCACAUUCAUUUUUGGAACUUCCGAGAAUGCUAGCUUGCUAGCUUUUCUUGGAACGGUCUCCGGGGGCUUUCACUAUCUCCCCCGCGAGGCCAACCACCA,36,66,40,48,190
7132,0,X63786.1/549-739,AUACCUUCUCGGCCUUUUGGCUAAGAUCAAGUGUAGUAUCUGUUCUUAUCAGUGUGAAAACUGAUACUGUCCCUACUGGGACAUGUGGUUUCACAUUAAUUUUUCAAGGGGUCGGAUAUAUUAGUGGCUUGCCACUGGUCCCGACGCUGUUGCCCUUAGCAUGCACGUAACUAAGGAGUGGCUAACCCUAA,44,61,44,42,191
7133,0,AAIW01000278.1/13786-13979,CCAGCUCUCUUUGCCAUUAUGGCUUAGAUCAAGUGUAGUAUCUGUUCUUUUCAGUUUAAUCUCUGAAAGUAUUCUAAGGAAUACAACAUUGAUUAAUCUCAUUUUUGGAAUCCGUGGGAAGACCUCUGUGCUUGCGCAUGUUUUCCUGCACCGUGUCAUCGGUCUUUCACUACCACCGAUCGACGCGAACCCAC,44,66,36,48,194
7134,0,ABBC01002283.1/5942-6135,CCAGCUCUCUUUGCCAUUAUGGCUUAGAUCAAGUGUAGUAUCUGUUCUUUUCAGUUUAAUCUCUGAAAGUAUUCUAAGGAAUACAACAUUGAUUAAUCUUAUUUUUGGAUCCCGCAGGAAAAUCUCUGUGCUUGCGCAUGUUUUCCGGCACCGUGUCAUCAGUCUUACACUACCGCUGAUUGACGCGAAUUUUC,45,71,35,43,194
7135,0,AASM01001106.1/7439-7242,CACCCUUCUCGGCCUCUUGGCUAAGAUCAAUUUGUAGUACCUGUUCUUAUCAGCGUGAUAGCUGAUAUGGUCUCAAUAGAGGCCUUAUCAAUUUCACAAAAAUUUUUGAUAGGGGAAAGGAUAAUUUGAAGCUUGCUUCUUAUAACCUUUCGCGCGUUGCCUUACCCUUGCACUAAAGGUUUGUACAGUGCACCCUUA,49,67,38,44,198
7136,0,AAWC01001022.1/39371-39181,AUCCAUUCUGGCCUUUUGGCUUAGAUCAAGUGUAGUAUCUGUUCUUAUCAGUGUAAUUACUGGUAUUGGUUCAUCGAACCAAUCAAUUAAUUACUCUUAUCUUUGCAAUGCCCUCAAUCAUAACCUAGCUUGCUAGACUGAUUGGGAUGAUGGCCUUGGGCUCACACUACUCCCUUGUGCUGUCAGGCAAA,45,67,36,43,191
7137,0,AC187487.2/140157-140345,AUCACUUCUUGGCCUUUUGGCUAAGAUCAAGUAUAGUAUCUGUUUUUAUCAGUUUCAUAUCUGAUAUGUCCUCUAUCCAAGGACAAUAUAUUACAUGGAUUUUUGGAAACAGGAUCGAAUAAGAGCUUGCUACAUCCACUCCACACAUUGACCUAGUAUUGCAGUACUUCCAGGAACAGUGCACCCAAA,56,61,31,41,189
7138,0,CAAI01005114.1/671-870,ACCCCUUCUCGGCCUCUUGGCUAAGAUCAAUUUGUAGUACCUGUUCUUAUCAGCGUGAUAGCUGAUAUGGUCUCAAUUGAGACCUUAUCAAUUUUCACAUAAAUUUUUAAUAGGGGAAAGGAUCAUUUGAAGCUUGCUUCUUAUAGCCUUUCGCGCGUUGCCUUACCCUAGCACUAAUAGGUUUGUACAGUGCACCCUUA,48,70,37,45,200
7139,0,AAGK01000002.1/903654-903460,AUACCUUCUCGGCCUCUUGGCUAAGAUCAAUUUGUAGUACCUGUUCUUAUCAGCGUGAUAGCUGAUACGGGUCCAACUGGACUCUGUAUUAUCACGGUUAUUUUUCGUUGGGUUAAGAGAUUUUCCGAGCUUGCUCGUCAUUCUCUUAUCGCGUUGCCUUCCCCUUACACUCCCGGGUUGAGCGGUGCACCCACA,35,67,42,51,195
7140,0,AAXI01000029.1/108904-109093,CCAGCUCUCUUUGCCUUUUGGCUUAGAUCAAGUGUAGUAUCUGUUCUUUUAAGUUUAAUCGCUUAAAUUCCUCCACGGAGGUUUCCGAUUAAAUCGAUUUUUGAAACUAGCUGAUGAGUCCCUGGGCUUGCUCAUACUCAUCGGCACAGUGUCGUCUCUAUCGCACUACUUGAGACUGACGCGACCUUUU,39,68,37,46,190
7141,0,DQ114948.1/136-329,AUACCUUCUCGGCCUUUUGGCUAAGAUCAAGUGUAGUAUCUGUUCUUAUCAGUGUGAAAACUGGUAUCUUCCCUACUGGGAAGCUAUUUUCACAUUAAUUUCUUCAGGGUCGCUCAGCAGGAGGGUGUUUACAUCAUCCGCUAAGCAAUUUGUUGUCGAAGCAUCGCACCACCGCUUUGUUCAGCAAGCCCUAU,44,64,40,46,194
7142,0,AAKM01000005.1/1407395-1407197,ACCCCUUCUCGGCCUCUUGGCUAAGAUCAAUUUGUAGUACCUGUUCUUAUCAGCGUGAUAGCUGAUAUGGUCUCAAUCGAGACCUUAUCAAUUUUCACAGUAAUUUUUGAUGGGGGAAAGGAUAAUUUGAAGCUUGCUUCAUGUAACCUUUCGCGCGUUGCCUUACCCUAGCACCAUAGGUUUGUACAGUGCACCCUUU,45,68,40,46,199
7143,0,AAXT01000001.1/1056302-1056495,AUACCUUCUCGGCCUCUUGGCUAAGAUCAAUUUGUAGUACCUGUUCUUAUCAGCGUGAUAGCUGAUACGAGUCCAAUUGGACUCUAUCUCAUCACGGGUAUUUUUCUUUGGGGAAGAAACAUACCUGGGCUUGCCCGGUAGUUCUUCAGGCGUCGCCUCCCCCUUACACUCUCGGGUUGUGCGGUGCACCCAUC,36,61,44,53,194
7144,0,AAJI01001427.1/51501-51693,CCAGCUCUCUUUGCCGUAAGGCUAAGAUCAAGUGUAGUAUCUGUUCUUUUCAGUUUAAUCUCUGAAAGUAUUCUAAGGAAUACAACAUUGAUUAAUCUCAUUUUUGGAUCUCGCGUUCGGCCCGCUGUGCUUGCGCAUGGUCGUCCGCACCGUGUCCUCGGUCUUACACUACCACCGAGCGAUGCGAAAUGCA,42,61,41,49,193
7145,0,AABS01001062.1/345-536,AUCGCUUCAAGGCUAUUUUAGCUGUGAUCAAGUGUAGUACCUGUUCUUCUCAGGUUGAAAUCUGAGACGGAAACGAUUCGUUUCCUCUAUAUUUCAUUCGGAUUUUUGAACACACGGAAGGUAAUGAAGCUUGCUUCUACUUGCUCCGGGUUGUCCUGGUUUUGCAUUAUCGCCAGGUUCGGCCCACGUUCC,39,67,43,43,192
7146,0,X71483.1/1-192,AUACCUUUCUCGGCCUUUUGGCUCAGAUCAUGUGUAGUAUCUGUUCUUAUAAGCUUAAUCGCUUAUAUGGUUCUCAUUGAGAACCUGCGAUUAACUUUAAUAUUUUAGGGGGUCAAGGCAAUGGGGGCGCUUGCGUCCCGCCGCGACAGCUUGGCAGGAGGCUUACACUACCUCUCUUGCCGAGCACCCCAG,39,59,46,48,192
7147,0,AAXJ01017415.1/259-455,AUACCUUCUCGGCCUUUUGGCUAUGAUCAAGUGUAGUAUCUGUUCUUAUAAGUGUGACAACUUAUAUGUUAGCUACUGCUAACUUGAACUGUCACAACAAUUUUUCACUGGGGAGUCGGUGGCUUUGGUCUCUGACCAUGCUCCGACUCGACUGUCGCCUCAGCCCUGCACGACUUGCUGAGUGCGGCGGACCCGAG,39,61,47,50,197
7148,0,X51375.1/389-580,AUCGCUUCUUCGGCUUAUUAGCUAAGAUCAAAGUGUAGUAUCUGUUCUUAUCGUAUUAACCUACGGUAUACACUCGAAUGAGUGUAAUAAAGGUUAUAUGAUUUUUGGAACCUAGGGAAGACUCGGGGCUUGCUCUCGANUUCCCAAGGGUCGUCCUGGCGUUGCACUGCUGCCGGNNUCGGCCCANNCCCC,41,57,45,44,192
7149,0,AF325695.1/199-9,AUCGCUUCUCGGCUCUCUGAGCUAAGAUCAUGUGUAGUAUCUGUUCUUUGCAGUGUAAUUUCUGCAACGGUCUCUAAACUGAGACCAAUGAAAUUACCUGUAUUUUUCACCUCCGGACGGGUGCUGUGAGCUUGCUCAACCCCGUCCACGGGUCGGCCUCGUAUUGCAUUGCCUCGAGGAUUGGAAGCUUG,37,60,46,48,191
7150,0,AAFT01000058.1/3256-3060,CUAAAUCUCUUUGCCAUUUGGCUUAGAUCAAGUGUAGUAUCUGUUCUUUUCAGUGUAACAGCUGAAACGUCAUCAUUGAUGACAUUUACAUUUUUACCCUAUUUUUGGAUCUCAGGUGGUAAAGCUUGAUGGGCUUGCUCACACUUUACCACACAGUGUCGUUACCAUUGCACCUUCGGUUUCUGACGCGAACUUCA,45,72,36,44,197
7151,0,AP004918.1/55019-55207,AUACCUUUCUUUGGCUAAGAUCAAGUGUAGUAUCUGUUUUUAUCAGUUUAAUAUCUGAUAUGUGGGCCAAUGGCCCACACGAUAUUAAAUUAAUUUUUUAAGGGUGAGGGCCUAUCUCAGUAGCUUGCUGCUGGGGCUCUCGAUUGUCGCCCAUGCGUUGCACUAUUGCACGGGCCUGGCGCAUCCCAC,40,63,44,42,189
7152,0,AAID01003241.1/2743-2932,AGACUUUCUCUCUAUAGGCUUAGAUCAAGUGUAGUAUCUGUUCUUUUCAGUUUAAUCUCUGAAAGAUCGUCACUGACGGUCACAUUGAUUAUACUUAUUUUUGUCCCUCGGGAUUGGUCCGCUGUGCUUGCGCAUGAUCAUUCCCACAGUUUCCCUGGUAUUACACUGCCUCCAGGUGAAGCGAACAUCU,40,68,37,45,190
7153,0,AATT01000021.1/233305-233109,GCAUCCUCUCAGGCCUUUUGGCUAAGAUCAAGUGUAGUAUCUGUUCUUUUCAGUGUGACAACUGAAACUCGGAGUUCGCUCCGAUUGUUGUCAAACUUAUUUUUGAUGGUUCGCAGAGCUUGGUUAGUUGCUUGCAACGCCUCGCCGAGCACAGGUGUCCCUCCUAUUGCACUAUCUGGAGGUGACGCCGAGUGCUC,37,63,49,48,197
7154,0,CP000498.1/1665432-1665627,AUCUCUUUGCCUUUUGGCUUAGAUCAAGUGUAGUAUCUGUUCUUUUCAGUGUAACAGCUGAAACGUCAUCAUUGAUGACUUUACUAAUUGUUACCUUUAUUUUUGGACUACCAGCUGGCAGGCUUGAUGGGCUUGCUCACACCUACCAGCACAGUGUCGAUGCCAUUGCACACCCCGGUUUCUGACGCAAAUCUUU,42,69,38,47,196
7155,0,AAFM01000022.1/42807-42996,AUCUCUUUGCCUUUUGGCUUAGAUCAAGUGUAGUAUCUGUUCUUUUCAGCGUAACAGCUGAAACGUCGUCAUUGACGACAUCAAUAUAUACAUAUUUUUGGACAAUUGCUUGUGGGAUCGAUGGGCUUGCUCACACCCACUAGCGCAGUGUCGUUGCCAUUGCACAUCUCGGCUUCUGACGCAACCCCUC,41,62,39,48,190
7156,0,AY007785.1/849-1044,AUACCUUCUCGGCCUUUUGGCUAAGAUCAAGNGUAGUAUCUGUUCUUAUCAGCUUAAUAUCUGAUACAGCACACUUGUGUGUCGAUGAGUUGAUGUGAAUUUUUCACGGGGGUGGCGGGUAGCUCUGAGGCAAACUCAGAGUCCGCCACACGUGUUGCCCUGGAGCUGCACUACAUCAGGAGUUGGCACACCCGAU,43,56,51,45,196
7157,0,AAGT01000476.1/108951-108760,ACAGUGUUUUCACGUACAGGCUUAGAUCAAGUGUAGUAUCUGUUCUUUUCAGUUUAAUCUCUGAAAGAUCGUCACAGACGGUCACAUUGAUUAUACUUAUUUUUGUCCUUCGGGGAUGGUCCGCUGUGCUUGCGCAUGAUCAUUCCCAUAGUUUCCCUGGUAUUACACUGCCUCCAGGUGAAGCGAACAACU,43,66,40,43,192
7158,0,DQ235686.1/7795-7608,AUCCUCUCUGGCCUUUUGGCUUAGAUCAUGUGUAGUAUCUGUUCUUAUAAGUUUAACCACUUAUAUGGGUCCACCGGACCCAUCUGGUUUACUUCUUUUUGCCUUGCCCGUCCGGCCAUCCUCUGCUUGCACGACGGCCGGACACGAUGACCUUGCCACUGCACUGCCGGCUUGUGUUGUCAGGGACC,29,61,42,56,188
7159,0,AATU01001299.1/7335-7151,AUACCUUCUCGGCCUCAAGGCUAAGAUCAAGUGUAGUAUCUGUUCUAAUCAGUGUGAAAACUGGUUUUCGCCUUUUGGCGGACUUUUUCACUCGCAUUUUUGGGCAAUCGUCUGCGGCUAGCUUGCUAGCGGCGGACGAGCGGUCUCCGGGGGCGUUCACCUUUCCCCCGCGAGGCCAACUACAC,33,53,48,51,185
7160,0,AAGI01000215.1/38061-38253,UCUCCUUCUCAGUUUGCCUUUUGGCUUAGAUCAAGUGUAGUAUCUGUUCUUUCUAGUUUAAUCGCUAGAACUUUCCUACGGGAAUUCACGAUUAUUCUUAUUUUUGCAACUGGUCAAUGGCUCACUGGGCUUGCCCAUAGUCACUGGCACUGUGUCGUUCCUCUCACACUACCUGGAAUGUACGCGACCCUUU,36,72,36,49,193
7161,0,AAGD02001363.1/26266-26450,AUCGCUUCUUCGGCUUAUUAGCUAAGAUCAAAGUGUAGUAUCUGCUCUUAUCGUAUUAACCUACGGUAUACACUCGAAUGAGUGUAAUAAAGGUUAUAUGAUUUUUGGAACCUAGGAAAGGGCUUUCUCCGACUUUCUAAGGGUCGUCCCGGCGUUGCACUGCUGCCGGGCUCGGCCCAGUCCCC,41,57,43,44,185
7162,0,AADS01000047.1/234093-233905,UUACCACUCUGGCCUUUUGGCUUAGAUCAAGUGUAGUAUCUGUUCUUAAUAGUUUAACCACUAUUAUGAGGGCACCGCCCUCAUUAUUGGUUAUCAAAUUUUUGCCGCCCUUGUCCCCCGAGCUCUGCUUGCAACUCGGGGGCGUGAUGACCUUGCCACUGCAGUACCGGCUUGCGUCGUCGGGGGAUA,34,60,45,50,189
7163,0,AANW02001910.1/4438-4250,AACCCUUCUCGGCCUUUAUGGCUUUGAUCAAGUGUAGUAUCUGUUCUAGCAAGCUUAAUAUCUUGCUCACCUCUACGGAGGUGCAAAUAUUAAACAAUUUUUGCGAUGGGGUCUAGUCGUGUUGAGGCUUGCCAAAGACACGAUUAGACAAGAAUGUGCUUGGUUACGGCCAUGUCGCAUUUACCCUCU,45,61,42,41,189
7164,0,DQ158857.1/121770-121585,CUACCUAUCUCGGCCUUUUGGCUAAGAUCAAGUGUAGUAUCUGUUCUUAGCAACUUAACCGUUGCUAUGAGAUUCAAAGAAUCUCGUCUCAAUUUUUACUAAGGCUUUACCAAUUAAGGAAUUCGGCCUUGCUAAUCAUUUAUUAUUUAUCUAAUAAAUCAAUAACGUUGGAAAGAUAUAUGAAUU,57,68,28,33,186
7165,0,CP000599.1/149439-149632,AACUUUUCUCGAGCUUUCGCUCAGAUCAAGUGUAGUAUCUGUUCUAUUAUGUUUAAACACAUAAUGAGGCUUUCUUAAGCCUUCAUUAGUUUAACCGAAUUUCUUCAGAGGGCGUUAUUCAAACAGGCUUGUUUACAAGUCGAAUACGCGAGCAUGUUCUUGGCCUUGCACUUUGCCUCGAACGUGUACCUCGA,47,68,37,42,194
7166,0,AAWT01070971.1/3028-3217,AGUGCUUCUAGCUUCAUAGCUAUGAUCAAAAGUGUAAGAACUGUUCUUCUCAGUUUAAUCGCUGGGACAAAGUUCAUUGAUCUUAAUUCGAGAUUAAAUUGAUUUUUGUAACUUUACAGACACUCCAAGGCUUGCCAAGCUCUGUCGUAGUGGACCUUACAUUGCAUUACAGUUUGGUCUGCUUGUUUAA,50,69,36,35,190
7167,0,AACP01000091.1/4899-4707,CUCACCUCUCACAGGGCUUAGAUCAUGUGUAGUAUCUGUUCUAAAUAGAUUGACAUCUAUUUUUCCUUGCUCCGGCGAGGAUAUAAUUGUCAUACACUUUUUCCUUGCGGGAGAUCACCGUUCUGGUGCUUGCACCUCGGGAUCUCAUGGAUGUCCUUGGCCCUACACUUCCGCCUUGAGACGUCCGCCGUCC,35,63,41,54,193
7168,0,AAFP01000557.1/11449-11264,AUCCUCUCUGGCCUCUUUUGGCUAAGAUCAUGUGUAGUAUCUGUUCUUAACGCUGUGAGAAGCGUUACAACCCUACGGGGUUUACUUCUCGCGAAGUUUUUCUGCGCCCGCGUUGCCUCUUCAGCUUGCUGAAUGUAACGCACGAUGUCGCUGGCACCGCACUACCGCCUUCUGAUGUCAGGGUUC,31,59,44,52,186
7169,0,AAFI02000140.1/17830-17618,AUUCUUCUUGAAGCGUAAUAGCUUUAAUCAAGUGUAGUAUCUGUUCUAGAACGUUUAAAAUCGUUCUUGCUUUCUAAGUGAAAGCAUUCGAAUUUAAAAUAAUUUUUUAUUCGAGGUUUAGAUGUUAUGAUAUCGGCAUGCCUUUAUUACAUCUAAAAUAGCAUUCGCUCUGUAUUGCACAAUUUCAGAGUUUAUAAAAAGAGUGCUACCUCU,64,83,34,32,213
7170,0,AAFB02000004.1/138313-138494,UCACCUUCUCGGCCUUUAUGGCUUUGAUCAAGUGUAGUAUCUGUUCUAGCAAGCUUAACAUCUUGCUUGCCCUUACGGGGGUAAAAGAAAAAUAAUUUUUAGAGGGAGGUUAAGGGAAUUGAAGGCAAGCCUUUUAUGAACUUAACGAGGAUGUGCAUGGAAACAUGAUGCGUCUACCCUAA,52,55,43,32,182
7171,0,AAPO01000010.1/72363-72562,AUCUCUUUGCCAUUUGGCUUAGAUCCAGUGUAGUAUCUGUUCUUUUCAGUGUAAUAGCUGAAAUGUCAUCAUUGAUGGCAAAUACAAAUAUAAUUUUUUACAUUUAUUUUUGGAACAAAUGGUGGGAUUGGUUUCAAAUGGGCUUGCUCAUAAUCAUUCCCACACAGUGUCGUUGCCAUUACACGUUCAUCGAGGCUCCU,51,75,37,37,200
7172,0,AAFX01115267.1/519-717,UUUGUUCCCCAGCUUUUGGCUUUGAUCAAGUGUAGUAUCUGUUCUUUUGAUUUUGAUAAAUCAAACGUGGCUUCGGUCACGCUUUAUAUCAAAUCAUUCUUUGGCUUGGGGAGGCGGCGUGUGCAGCUUGCUGUGCUCGCCGUCUCGCGUGCUGCGCGUCCUUUGCACUAACUGGGACGAAUGCUGCGGCGCACCUACU,31,68,52,48,199
7173,0,AANV02000585.1/5693-5873,ACACCUUCUCGGCCUUUAUGGCUUUGAUCAAGUGUAGUAUCUGUUCUAGCAAGCUUAACAUCUUGCUUGCCCUUACGGGGGUAAAAGAAAAGAAUUUUUAGAGGGAAGUUAAGGAAAUGGAAGGCAAGCUUUUCAAGAACUUAACAAGGAUGUGCAUGGAAACAUGAUGCGUCUACCCUAA,56,51,42,32,181
7174,0,DQ012953.1/31-235,AUUCUUCUUGAAGCGUAAUAGCUUUAAUCAAGUGUAGUAUCUGUUCUAGAACGUUUAAAAUCGUUCUUGCUUUCUAAGUGAAAGCAUUCGAAUUUAAAAUAAUUUUUUAUUCGAGGUUUAGAUGUUAUGAUAUCGGCAUGCCUUUAUUACAUCUAAAAUAGCAUUCGCUCUGUAUUGCACAAUUUCAGAGUUUAUAAAAAGAGUG,63,80,34,28,205
7175,0,AAFO01000053.1/189105-188894,AUCUCUUUGCCUUUUGGCUUAGAUCCAGUGUAGUAUCUGUUCUUUUCAGUGUAACAACUGAAAUGUCAUCAUUGAUGACUUUACAUUUAUGUUACAAAUUUAUUUAUUUUUGGAUAUUGGGUAGAUUGAUUUAUUAAAGUGGGCUUGCUCACAGUCUUUCUACAUAGUGUCGUUGCCACUGUACUUUUAUUUUGGCUUCUGACGCAAAUUUU,48,94,37,33,212
7176,0,AABY01000227.1/3654-3483,AUCUCUUUGCCUUUUGGCUUAGAUCAAGUGUAGUAUCUGUUCUUUUCAGUGUAACAACUGAAAUGACCUCAAUGAGGCUCAUUACCUUUUAAUUUGUUACAAUACACAUUUUUUGGCACCCAAAUAAUAAAAUGGACGGGAAGGGACUUUCCAAGCGGGCUGUUUUCCGCUA,46,60,32,34,172
7177,0,Z36100.1/1808-1619,AUCUCUUUGCCUUUUGGCUUAGAUCAAGUGUAGUAUCUGUUCUUUUCAGUGUAACAACUGAAAUGACCUCAAUGAGGCUCAUUACCUUUUAAUUUGUUACAAUACACAUUUUUUGGCACCCAAAAUAAUAAAAUGGACGGGAAGAGACUUUUUAAGCAAGUUGUUUUCCGCUAAUGUCAGGUCUCACUAC,54,68,32,36,190
7178,0,AC167922.2/17996-18182,ACAUUCAGACGCAUUUGCUGACCUUCAACCUUCUAGUUCUUUUCAGUUUAAUCUCUGAAACGUCACUACGGUGACAUUCUAUGAUUAUACUUAUUUUUGGACCUCCGUCGGUGGCCGCUGGGCUUGCUCAUGUCACUGACGACCGUGUCGCCAGUAUUGCACUGCCUCUGGCUGACGCGAACUACUU,36,62,38,51,187
7179,0,AAZN01000309.1/86876-87072,AUCUCUUUGCCUUUUGGCUUAGAUCAAGUGUAGUAUCUGUUCUUUUCAGUGUAACAGCUGAAAUGACCUCAAUGAGGCUCAUUACCUUACGUUUUGUUACAACACAUUUUUUGGAAACUUUUAUUUCGGGUUUAGAGAGAUUGUUACUUAUUUGAUUUUCUGAGAUUAUGCACUUCAUUGGGUAUAGUCUUCUCCCU,44,84,35,34,197
7180,0,AADM01000307.1/26094-25895,AUCUCUUUGCCUUUUGGCUUAGAUCAAGUGUAGUAUCUGUUCUUUUCAGUGUAACAACUGAAAUGUCCUCAAUGAGGAUGUUUAUUAAGUUACAAAUCAUAUUUUUGGAAAUGACUUAGGGAGGAGAGAGAUGUAAGGGUCCCUGGUAUCCAGGGGAAGGGGUCUUAUAUGUGGCUGGGCUGUAAGUUUUGUUACGGAGA,51,69,54,26,200
7181,0,AL590446.1/168546-168725,CCACCUCUCAAGCCAAUCGGCUUUGAUCAAGUGUAGUAUCUGUUCUUGCCAGUGUAAGAACUGGCAUUAUCCGUCAGGAUAAACUCACGAAUUUUUGGGCGGCGAGAUGAGGCAGCGGAGCUUGAGCGCUUGCGUUUCGGUUGCUCUGCCAGAGGCUCGCGGGCUCCCGGGCUGUAGAUC,35,47,53,45,180
7182,0,AF053589.1/90-279,CCACCUCUCAAAGCUCAUAGCUUUGAUCAAGUGUAGUAUCUGUUCUUGUCAGUGUGACAGCUGACAAACUAGCUCCUUGGAGCUAGAAUAUGCUGGUGUGUGUGUGGAUGCUUUGACAGGCUUGCUUGUAGGGGCCAUGCACACACCAGGCAGACUCCCGGAAGUUGUUCCGUCCGGAGCUGCACUUUUU,39,56,50,45,190
7183,0,Z50072.1/229-412,CUCACUCUCAAAGUUAUCGGCUUUGAUCAAGUGUAGUAUCUGUUCUAGUCGGCUUAACAACUGACUUAUCCGCAAGGAGUAUAAUACUUAGAAAAGUGGAGAUGUAAAAUGAGAGAUGUGCUUGCAUAAUCAUCAUUUUUUAUAGAUCUCUGGCAUCUUAAGAUGCUUUUUUAUUUAAUUUUUU,53,70,33,28,184
7184,0,AAHC01001365.1/13705-13888,UUUGCACUCAGGGCGAUUCGCUCUGAAUAAGUGUAGUAUCUGUUCUGAAUCGCUUGACAGCGGUUCGCCUGGUAUGUGCCAGGCGCCUCUGUUCAUACUAAUUUAUUAACUCAUUGUCCUAGCAUGUCUAGGCGAUGGAUUUAGGCGGUGUCUUCACUAUCUCACCUAACCUAAAUCACCCAAU,40,60,39,45,184
7185,0,AF287991.1/4898-5088,AUCGCUUCUCGGCCUUUUGGCUAAGAUCAAGUGUAGUAUCUGUUCUUAUCAGUUUAAUAUCUGAUACGUCCUCUAUCCGAGGACAAUAUAUUAAAUGGAUUUUUGGAGCAGGGAGAUGGAAUAGGAGCUUGCUCCGUCCACUCCACGCAUCGACCUGGUAUUGCAGUACCUCCAGGAACGGUGCACCCCCU,45,57,43,46,191
7186,0,M33777.1/191-381,AUCGCUUCUCGGCCUUUUGGCUAAGAUCAAGUGUAGUAUCUGUUCUUAUCAGUUUAAUAUCUGAUACGUCCUCUAUCCGAGGACAAUAUAUUAAAUGGAUUUUUGGAGCAGGGAGAUGGAAUAGGAGCUUGCUCCGUCCACUCCACGCAUCGACCUGGUAUUGCAGUACCUCCAGGAACGGUGCACCCCCU,45,57,43,46,191
7187,0,S64581.1/735-926,AUCGCUUCUCGGCCUUUUGGCUAAGAUCAUGUGUAGUAUCUGUUCUUUUCAGCUUAAUAUCUGAAACGCGACUCACCGAGUCGCUUGUAUAUUAAACUGAUUUUUGAACUUAGGCCAUGGAAUAGGGGCUUGCUCCGUCCUGGCCACGGGUUGGCCCGGUAUUGCAGUACCUCCGGGAUCGGCCCACCCCUC,36,59,46,51,192
7188,0,AAKO01002676.1/16743-16938,AUCGCUUCUCGGCCUUAUGGCUAAGAUCAAAGUGUAGUAUCUGUUCUUAUCAGCUUAACAUCUGAUAGUUCCUCCAUUGGAGGACAACAAAUGUUAAACUGAUUUUUGGAAUCAGACGGAGUGCUAGGAGCUUGCUCCACCUCUGUCGCGGGUUGGCCCGGUAUUGCAGUACCGCCGGGAUUUCGGCCCAACUGAA,45,57,48,46,196
7189,0,AAPQ01007349.1/370124-370319,AUCGCUUCUCGGCCUUAUGGCUAAGAUCAAAGUGUAGUAUCUGUUCUUAUCAGCUUAACAUCUGAUAGUUCCUCCAUUGGAGGACAACAAAUGUUAAACUGAUUUUUGGAAUCAGACGGAGUGCUAGGAGCUUGCUCCACCUCUGUCGCGGGUUGGCCCGGUAUUGCAGUACCGCCGGGAUUUCGGCCCAACUGAA,45,57,48,46,196
7190,0,AAIZ01004041.1/16829-17024,AUCGCUUCUCGGCCUUAUGGCUAAGAUCAAAGUGUAGUAUCUGUUCUUAUCAGCUUAACAUCUGAUAGUUUCUCCAUUGGAGAACAACAAAUGUUAAACUGAUUUUUGGAAUCAGACGGAGUGCUAGGGGCUUGCUCCACCUCUGUCGCGGGUUGGCCCGGUAUUGCAGUACCGCCGGGAUUUCGGCCCAACUUAA,45,59,47,45,196
7191,0,AAYL01000061.1/287788-287596,AUACCUUCUCGGCCUUUUGGCUAUGAUCAAGUGUAGUAUCUGUUCUUAUCAGUGUGACAACUGAUAUGGGUCCAACUGGACCCAAUUAUGUCACAUCAAUUUUUGUUUGGGGAGGCUAGGUUUCUGAGCUUGCUCAGGCCUUCCUCAAGCGUCGCCUUCCUCCUGCACUCCCGGGAAGAGCGGUGCACCCUUU,36,62,45,50,193
7192,0,AL683874.1/16263-16071,UCAGCUCUCUUUGCCUUUUGGCUUAGAUCAAGUGUAGUAUCUGUUCUUUUCAGUUUAAUCUCUGAAAGUGUUCUAAGGAACACAACAUUGAUUAAUCUCAUUUUUGGAUCUCGUGGCAAGGCCUCUGUGCUUGCGCAUGCCUUGCCACACAGUGUCAUUGGGCUUACACUACCCCCAAUUGACGCGACCCUUU,40,68,37,48,193
7193,0,AAIH02000488.1/9382-9189,CCAGCUCUCUUUGCCUUUUGGCUUAGAUCAAGUGUAGUAUCUGUUCUUUUCAGUUUAAUCUCUGAAAGUGUUCCAUAGGAACACAACAUUGAUUAAUCUUAUUUUUGGUCUCCGUGGCAGGGCCCCUGUGCUUGCGCAUGCCUUGCCACACAGUGUCAUCGGGCUUACACUAUCCCCGAUAGACGCGAACUCCU,39,65,39,51,194
7194,0,AAKE03000002.1/1730972-1731164,UCAGCUCUCUUUGCCUUUUGGCUUAGAUCAAGUGUAGUAUCUGUUCUUUUCAGUUUAAUCUCUGAAAGUGUUCUAAGGAACACAACAUUGAUUAAUCUCAUUUUUGGACCCCGUGGCGAGGCCUCUGUGCUUGCGCAUGCCUUGCCACACAGUGUCAUUGGGCUUACACUACCCCCAAUAGACGCGACCCUUU,40,65,38,50,193
7195,0,AAEL01000160.1/10170-10364,AUACCUUCUCGGCCUUUUGGCUAUGAUCAAGUGUAGUAUCUGUUCUUAUCAGUGUGACAACUGAUAUGGGUCCUACGGGACCUAUUAAUAGUCACAGAAAUUUUUUUCUGGGUGAAUGCGAUCUCUGAGCUUGCUCAUGUCUCGUUCAAAUUGUUGCCUCGUCCUUACACUACCGACUUGUGCGGCAUACCCUCU,40,69,40,46,195
7196,0,AATX01000107.1/79359-79166,CCAGCUCUCUUUGCCAUUAUGGCUUAGAUCAAGUGUAGUAUCUGUUCUUUUCAGUUUAAUCUCUGAAAGUAUUCUAAGGAAUACAACAUUGAUUAAUCUUAUUUUUGGACCUCGCGGAGAGACCUCUGUGCUUGCGCAUAUCUUUCCGCACCGUGUCAUCGGUCUUACACUACCACCGAUCGACGCGAAACCCA,46,64,35,49,194
7197,0,AANS01001054.1/6664-6467,CACCCUUCUCGGCCUCUUGGCUAAGAUCAAUUUGUAGUACCUGUUCUUAUCAGCGUGAUAGCUGAUAUGGUCUCAAUAGAGGCCUUAUCAAUUUCACAAAAAUUUUUGAUAGGGGAAAGGAUAAUUUGAAGCUUGCUUCUUAUAACCUUUCGCGCGUUGCCUUACCCUUGCACUAAAGGUUUGUACAGUGCACCCUUA,49,67,38,44,198
7198,0,AABL01000318.1/11806-12005,ACCCCUUCUCGGCCUCUUGGCUAAGAUCAAUUUGUAGUACCUGUUCUUAUCAGCGUGAUAGCUGAUAUGGUCUCAAUUGAGACCUUAUCAAUUUUCACAUAAAUUUUUAAUAGGGGAAAGGAUCAUUUGAAGCUUGCUUCUUAUAGCCUUUCGCGCGUUGCCUUACCCUAGCACUAAUAGGUUUGUACAGUGCACCCUUA,48,70,37,45,200
7199,0,CAAJ01003844.1/3754-3953,ACCCCUUCUCGGCCUCUUGGCUAAGAUCAAUUUGUAGUACCUGUUCUUAUCAGCGUGAUAGCUGAUAUGGUCUCAAUUGAGACCUUAUCAAUUUUCACAUAAAUUUUUAAUAGGGGAAAGGAUCAUUUGAAGCUUGCUUCUUAUAGCCUUUCGCGCGUUGCCUUACCCUAGCACUAAUAGGUUUGUACAGUGCACCCUUA,48,70,37,45,200
7200,0,EF140768.1/2-192,CCUUCUCGGCCUCUUGGCUAAGAUCAAUUUGUAGUACCUGUUCUUAUCAGCGUGAUAGCUGAUAUGGUCUCAAUAGAGGCCUUAUCAAUUUCACAAAAAUUUUUGAUAGGGGAAAGGAUAAUUUGAAGCUUGCUUCUUAUAACCUUUCGCGCGUUGCCUUACCCUUGCACUAAAGGUUUGUACAGUGCACC,47,65,38,41,191
7201,0,AB179181.1/1-163,AUCGCUUCUCGGCCUUUUGGCUAAGAUCAAGUGUAGUAUCUGUUCUUAUCAGUUUAAUAUCUGAUACGUCCUCUAUCCGAGGACAAUAUAUUAAAUGGAUUUUUGGAGCAGGUUCCCCCCGCACCUGGCACACCCAGAUCAGCACCAGCAACCUGUACCUGCC,39,48,31,45,163
7202,0,AC198944.2/184805-184614,AUUGCUUCUCGGCCUUUUGGCUAACAUCAAGUGUAAUGUUUGUCCUUAUCAAUUUAAUAUCUGAUAUGUCCUGUAUCCAAGGAACAAUAUAUUAAGUGGACUUUUGGAAGUAGGAGGUAGAAUAACAACUUCCUCUGUCCACUCCACACAUCAUCUUGGUAUUGCAGUACUUCCAUAAAUGAUGCAUCCUCC,53,66,32,41,192
7203,0,AACQ01000018.1/49571-49783,AUCUCUUUGCCUUUUGGCUUAGAUCCAGUGUAGUAUCUGUUCUUUUCAGUGUAACAACUGAAAUGUCAUCAUUGAUGACUUUACAUUUAUGUUACAAAUUUAUUUAUUUUUGGAUAUUGGGUAGAUUGAUUUAUUAAAGUGGGCUUGCUCACAGUCUUUCUACAUAGUGUCGUUGCCACUGUACUUUUAUUUUGGCUUCUGACGCAAAUUUUU,48,95,37,33,213
7204,0,AE017345.1/926592-926777,AUCCUCUCUGGCCUCUUUUGGCUAAGAUCAUGUGUAGUAUCUGUUCUUAACGCUGUGAGAAGCGUUACAACCCUACGGGGUUUACUUCUCGCGAAGUUUUUCUGCGCCCGCGUUGCCUCUUCAGCUUGCUGAAUGUAACGCACGAUGUCGCUGGCACCGCACUACCGCCUUCUGAUGUCAGGGUUC,31,59,44,52,186
7205,0,AAEY01000026.1/44265-44450,AUCCUCUCUGGCCUCUUUUGGCUAAGAUCAUGUGUAGUAUCUGUUCUUAACGCUGUGAGAAGCGUUACAACCCUACGGGGUUUACUUCUCGCGAAGUUUUUCUGCGCCCGCGUUGCCUCUUCAGCUUGCUGAAUGUAACGCACGAUGUCGCUGGCACCGCACUACCGCCUUCUGAUGUCAGGGUUC,31,59,44,52,186
7206,0,AACO02000044.1/38107-37922,AUCCUCUCUGGCCUCUUUUGGCUAAGAUCAUGUGUAGUAUCUGUUCUUAACGCUGUGAGAAGCGUUACAACCCUACGGGGUUUACUUCUCGCGAAGUUUUUCUGCGCCCGCGUUGCCUCUUCAGCUUGCUGAAUGUAACGCACGAUGUCGCUGGCACCGCACUACCGCCUUCUGAUGUCAGGGUUC,31,59,44,52,186
7207,0,AACI02000565.1/65-236,AUCUCUUUGCCUUUUGGCUUAGAUCAAGUGUAGUAUCUGUUCUUUUCAGUGUAACAACUGAAAUGACCUCAAUGAGGCUCAUUACCUUUUAAUUUGUUACAAUACACAUUUUUUGGCACUCAAAAUAAUAAAUGGAUGGGAAGAGACUUUCCAAGCGGGCUAUUUCCCGCUA,48,61,30,33,172
7208,0,AACF01000175.1/12372-12544,AUCUCUUUGCCUUUUGGCUUAGAUCAAGUGUAGUAUCUGUUCUUUUCAGUGUAACAACUGAAAUGACCUCAAUGAGGCUCAUUACCUUUAUUAUUUGUUACAAUACUCAUUUUUUGGAAGCACUUAAAUGGGCGGGAAGAAACUGAGAGGAUCCUUCCUAUUGUCUAUUCAAU,46,65,31,31,173
7209,0,AAFW02000011.1/661534-661345,AUCUCUUUGCCUUUUGGCUUAGAUCAAGUGUAGUAUCUGUUCUUUUCAGUGUAACAACUGAAAUGACCUCAAUGAGGCUCAUUACCUUUUAAUUUGUUACAAUACACAUUUUUUGGCACCCAAAAUAAUAAAAUGGACGGGAAGAGACUUUUUAAGCAAGUUGUUUUCCGCUAAUGUCAGGUCUCACUAC,54,68,32,36,190
7210,0,AAEG01000106.1/129944-130133,AUCUCUUUGCCUUUUGGCUUAGAUCAAGUGUAGUAUCUGUUCUUUUCAGUGUAACAACUGAAAUGACCUCAAUGAGGCUCAUUACCUUUUAAUUUGUUACAAUACACAUUUUUUGGCACCCAAAAUAAUAAAAUGGACGGGAAGAGACUUUUUAAGCAAGUUGUUUUCCGCUAAUGUCAGGUCUCACUAC,54,68,32,36,190
7211,0,AY007788.1/537-683,AUAUCUUCUCGGCUAUUUAGCUAAGAUCAUGUUUAUAAACUGUUCUUAUCAGAGUAACUCCUGAUACUGCCUUCGGGCAAAGGAAUAGAAAUUAUAACUCAAGGUUGUUUCCCUGGAGUUCCACGUUUCCAGGGGAGCAACUCUUUU,39,50,28,30,147
7212,0,M58665.1/571-739,AUAUCUUCUCGGCUAUUUAGCUAAGAUCAUGUUUAUAAACUGUUCUUAUCAGAGUAACUCCUGAUACUGCCUUCGGGCAAAGGAAUAGAAAUUAUAUCUCAAGGUUGUUUCCCUGGAGUUCCACGUUUCCAGGGAGCAACUCUUUUUUUCUCCUAGGAGCAGAACAUCU,44,58,31,36,169
7213,0,U23406.1/206-352,AUAUCUUCUCGGCUAUUUAGCUAAGAUCAUGUUUAUAAACUGUUCUUAUCAGAGUAACUCCUGAUAUUGCCUUCGGGCAAAGGAAUAGAAAUCAUGGUACUAGGUUGUUUCUCUGGAGUUCCACCUUUCCAGGGGAGCAGCUACCUU,37,50,30,30,147
7214,0,EF052257.1/89-253,AUUCAGUCAGCCUUUGAGUUAAAAUCAAGUGUAGUAUAGGUUACCAGUUUAACAUCUGAUGACAAGAUCUUAAAUGCAUUUUUGGAGCUGGGAGACAAAAGAAGCUUGCUGUUCACUCCACGCAUCAACCUGGUAUUGCAGUACCUCCAGGAAUGAGCCCCCGAC,49,45,35,36,165
7215,0,AACA01000784.1/509-337,AUCUCUUUGCCUUUUGGCUUAGAUCAAGUGUAGUAUCUGUUCUUUUCAGUGUAACAACUGAAAUGACCUCAAUGAGGCUCAUUACCUUUUACUUUGUUACAAUACUCAUUUUUUGGCACUCAAAAUAAUAAAAUGGACGGGGAGAGAUUUUCCAAGCGGGCUGUUGCCGCUAA,46,61,33,33,173
7216,0,AABZ01000169.1/11839-11668,AUCUCUUUGCCUUUUGGCUUAGAUCAAGUGUAGUAUCUGUUCUUUUCAGUGUAACAACUGAAAUGACCUCAAUGAGGCUCAUUACCUUUAAUUUGUUACAAUACACAUUUUUUGGCACACUCAAAUAAUAAAUGAAUGGAAAGAGAUUUUUUAAGCGAGCUGUUUCCUGCUA,50,64,28,30,172
7217,0,X56454.1/125-277,AUAUCUUCUCGGCUUUUUAGCUAAGAUCAUGUUUUUAAAAUGUUCUUAUCAGAGUAACUCCUGAUAUUUGCCUUCGGGCAAUUAGGAAUACGAAAUCUUUGAUCACGCGAGUUUUCCUGGAGUUCCACUCUUUCCAGGCGAAGCUCGCCCUUU,35,56,28,34,153
7218,0,AC008368.21/83891-84039,AUAUCUUCUCGGCUAUUUAGCUAAGAUCAAGUUAUUAAACUGUUCUUAUCAGAGUAACUCCUGAUACGGGCCUUUGGCCCAAGGAUCAAAACUGUUGGCUGUCCCGCGUUCUUCCGGGGUUCCACUUGUCCGGAUGGAGCGCGACGGUC,31,45,36,37,149
7219,0,M58666.1/571-718,AUAUCUUCUCGGCUAUUUAGCUAAGAUCAAGUUAUUAAACUGUUCUUAUCAGAGUAACUCCUGAUAUGGGCCUCGGCCCAAGGAUAGUAACUGUUGAGGCGCCGGCGUCCUCCCGGAGUUCCACGUGUCCGGUUGGGGCGCCGCCUCC,29,41,38,40,148
7220,0,AAHK01000589.1/17217-17069,AUAUCUUCUCGGCUAUUUAGCUAAGAUCAAGUUUUUAAACUGUUCUUAUCAGAGUAAUUCCUGAUAUGGGCUUCGUCCCAGGAAUAGAAACCGCUGAUCUCUCAAGCGUUCUUCCGGAGUUCCACGUGUCCGGAUGGAGCGCUUCCUUU,33,50,31,35,149
7221,0,AF326335.1/1-142,AUAUCUUCUCGGCUUUUUAGCUAAGAUCAUGUUUAUAAACUGUUCUUAUCAGAGUAACUCCUGAUAUUGCCUUCGGGCAAAGGAAUACAAAUGAUCGCACUAGGUUGUUUCCCUGGAGUUCCACCUUUCCAGGGGAGCAACU,36,47,28,31,142
7222,0,CAAC02000548.1/434719-434909,AUCGCUUCUUCGGCUUAUUAGCUAAGAUCAAAGUGUAGUAUCUGUUCUUAUCGUAUUAACCUACGGUAUACGCUCGAAUGAGUGUAAUAAAGGUUAUGUGAUUUUUGGAACCUAGGAAAGACUCGGGGCUUGCUCCGACUUUCCAAGGGUCGUCCCGGCGUUGCACUGCUGCCGGGCUCGGCCCAGUCCCC,40,57,48,46,191
7223,0,AACE03000009.1/583940-584128,AUAAAUCUCUUUGCCUUUUGGCUUAGAUCAAGUGUAGUAUCUGUUCUUUUCAGUGUAACAACUGGAAUGUCCUCAACGAGGGCGUUACGCUAAGUUACAGCCCACUUUUUGGAACCUUAGGGAGAAGAAGGCUCGGAAUCGUCGCUGGGUGGCGCAUCGGCAAUACGGAGCUACCUGGAUGCAGGCCUG,44,53,51,41,189
7224,0,AABX02000002.1/241678-241484,UUAGCUCUCUUUGCCUUUUGGCUUAGAUCAAGUGUAGUAUCUGUUCUUUUCAGUUUAAUCUCUGAAACUGCUCUACGGAGUAGAAUCGUGAUUAUUCUAAUUUUUGCAACUCGGUCGGCAUCCCUCUGGGCUUGCCUAUGGUUGCCGACCACUGUGUCCCUGGUAUUACACUGCCUCCAGGCGACGCGAACUCAA,37,68,41,49,195
7225,0,AASC02023314.1/7214-7405,AUCGCUUCUCGGCCUUUUGGCUAAGAUCAAAGUGUAGUAUCUGUUCUUAUCAGCUUAAUAUCUGAUACGUGGCUUCCUAGCGACUACGAUAUUAAACUGAUUUUUGGACACAGGCGAGAUGCCCGGGGCUUGCUCCGCUCUCGCCACGGGUCGGCCCGGUAUUGCAGUCCCUCCGGGAAUGGCCCAAUAUAA,40,55,47,50,192
7226,0,AAFD02000010.1/1244775-1244583,ACAUCUCUCUUCGCCUAUUGGCUUUGAUCUUGUGUAGUAACUGUUCUAAAACUUUUAACAAAGUUUUGAGGGCCACUGGUCCUCACACUGUUAAACUACUUUUUGCACUCUAGGAGCAUCACUUCUGCUUGCAGAACAUGCCUCCGCGGAUGGUCGAAGCAUUUCACUAGCCGCUACGAUCCGUCCACCCCCC,42,60,35,56,193
7227,0,AAZY02000001.1/986053-985858,AUACCUUCUCGGCCUUUUGGCUAUGAUCAAGUGUAGUAUCUGUUCUUAUCAGUGUGACAACUGAUAUGGAUCCUACGGGAUCCAAACUCUAGUCACAGAAAUUUUUAUACGGGAGAUAUAGAUCACUGAGCUUGCUCAUAUCAAUGUCGAAAUGUCGCCUCGUCCUUACACUACCGAUGAGAGUGGCAUGCCCUAC,51,60,40,45,196
7228,0,ABFM01000169.1/24531-24724,CCAGCUCUCUUUGCCAUUAUGGCUUAGAUCAAGUGUAGUAUCUGUUCUUUUCAGUUUAAUCUCUGAAAGUAUUCUAAGGAAUACAACAUUGAUUAAUCUUAUUUUUGGACCUCGCGGAGAGACCUCUGUGCUUGCGCAUGUCUUUCCGCACCGUGUCAUCGGUCUUACACUACCACCGAUCGACGCGAAACCCA,45,64,36,49,194
7229,0,AAQM02000124.1/160019-159827,AUACCUUCUCGGCCUUUUGGCUAUGAUCAAGUGUAGUAUCUGUUCUUAUCAGUGUGACAACUGAUAUGGGUCCAACUGGACCCAAUUAUGUCACAUCAAUUUUUGUUUGGGGAGGUUAGGUUUCUGAGCUUGCUCAGGCCUUCCUCAAGCGUCGCCUUCCUCUUGCACUCCCGGGAAGAGCGGUGCACCCUUU,36,64,45,48,193
7230,0,CR382136.2/900319-900516,AUCUCUUUGCCUUUUGGCUUAGAUCAAGUGUAGUAUCUGUUCUUUUCAGUGUAACAACUGAAACGUCAUCAUUGAUGACUUUUAUAAAAUGUUACCUUUAUUUUUGGAUUAUUCGUUCGAAGGAUUGAUAAGCUUGCUUACACCUUUGGACACAGUGUCGUUGCUAUUGCACCAUAUUGGCUUCUGACGCAAUUUUUU,46,82,35,35,198
7231,0,AAGV020390824.1/478-668,AUCGCUUCUCGGCCUUUUGGCUAAGAUCAAGUGUAGUAUCUGUUCUUAUCAGUUUAAUAUCUGAUAUGUCCUCCAUUUGAGGACAGCAUAUUAAAUUGAUUUUUGGAACAGGGAUGUGGAAAAGGAGCUUGCUCUAUCCACUCCACGCAUCAGCCUGGUAUUGCAGUACUUCCAGGAAUGGUGCACUUCCC,46,63,41,41,191
7232,0,X58842.1/1-191,AUACCUUCUCGGCCUUUUGGCUAAGAUCAAGUGUAGUAUCUGUUCUUAUCAGUGUGAAAACUGAUACUGUCCCUACUAGGGACAUGUGGUUUCACAUUAAUUUUUCACAGGGGUCGGAUUUACUAGUGGCUUGCCCUAGUCCCGACGCGGUUGCCCUUGGCAUGCACGCUACUAAGGAGCGGCUACCCCUG,39,59,46,47,191
7233,0,AAKN02019678.1/9356-9546,AUCGCUUCUCGGCCUUUUGGCUAAGAUCAAGUGUAGUAUCUGUUCUUAUCAGUUUAAUAUCUGAUACGUCCUCUAUCCGAGGACAAUAUAUUAAAUGGAUUUUUGGAGCUGGGAGAUGGAAUAGGAGCUUGCUCCGUCCACUCCACGCAUCGACCUGGUAUUGCAGUACCUCCAGGAACGGUGCACCCCUC,44,58,43,46,191
7234,0,AAWR02015112.1/62289-62483,ACCGCUUCUAGGCCUUUUGGCUAAGAUCAAGUGUAGUAUCUGUUCUUAUCAGUUUAAUAUCUGAUACAUCCUCUAUCCAAGGACAAUAUAUUAAAUGGAUUUUUGGAACAAGGAGAUGGAAUAGGAGCUUGCUUGCUCCGUCCACUCCACGCAUCGACCUGGUAUUGCAGUACUUCCAGGAACGGUGCACCAAAA,54,58,40,43,195
7235,0,ABDF02000003.1/1932068-1932260,UUAGCUCUCUUUGCCUUUUGGCUUAGAUCAAGUGUAGUAUCUGUUCUUUUCAGUUUAAUCUCUGAAAGGUCUCUAAGGAGACCAAUCGUGAUUAUUCUUAUUUUUGUCCUCGGAGCAGUUUCCUCUGUGCUUGCGCAUGAUUCUGCUCACAGUGUCCCUGGUAUUACACUGCCUCCAGGCGACGCGACCUUGA,35,72,40,46,193
7236,0,M12856.1/361-551,AUCGCUUCUCGGCCUUUUGGCUAAGAUCAAGUGUAGUAUCUGUUCUUAUCAGUUUAAUAUCUGAUACGUCCUCGAUGAGAGGACUUUAUAUUAAACGGAUUUUUGGGCGCGGGAGUUGGACCCGGAGCUUGCUCCCUCCGCUCCGCGCAUCGUCCCGGUAUGGCAGUACCUCCGGGCACGGUGCACCUCCC,34,56,49,52,191
7237,0,AACS02000012.1/1565410-1565598,UUACCACUCUGGCCUUUUGGCUUAGAUCAAGUGUAGUAUCUGUUCUUAAUAGUUUAACCACUAUUAUGAGGGCACCGCCCUCAUUUUUGGUUAUCUAAUUUUUGCCGCCCCAGUUCCUCGAGCUCUGCUUGCAACUCGAGGACGCGAUGACCUUGCUAUUGCAGUACCGGCUUGUGUCGUCGGGGGAUC,34,64,43,48,189
7238,0,ABEG02004067.1/53561-53371,AUCGCUUCUUCGGCUUAUUAGCUAAGAUCAAAGUGUAGUAUCUGUUCUUAUCGUAUUAACCUACGGUAUACACUCGAAUGAGUGUAAUAAAGGUUAUAUGAUUUUUGGAAUCUAGGAAAGACUCGGGGCUUGCUCCGACUUUCCAAGGGUCGUCCUGGCGUUGCACUACUGCCAGGCUCGGCCCAGUCCCC,44,59,44,44,191
7239,0,AAIL02000026.1/644385-644193,UUAGCUCUCUUUGCCUUUUGGCUUAGAUCAAGUGUAGUAUCUGUUCUUUUCAGUUUAAUCUCUGAAAGGUCCCCAAGGGGACCAAUCGUGAUUAUUCUUAUUUUUGCACCUCGAGCAGUUUCCUCUGCGCUUGCGCAUGAUCCUGCUCACUGUGUCCCUGGUAUUACACUGCCUCCAGGCGACGCGACCCUUU,33,69,39,52,193
7240,0,AAQY02000293.1/11238-11050,AUACCUUCUCGGCCUUUGGCUAAGAUCAAGUGUAGUAUCUGUUCUAAUCAGUGUGAAAACUGGUUUCCCUGCUUUUGGUGGGGUCUUUUUCACAUUUAUUUUUGGAACUGCUGCUUUCGGUUAGCUUGCUAGCCAAUCGCGGUACGGUCUCCGGGGGCUUUCACCUAUCCCUCGUGAGGCCAACUACUA,33,67,44,45,189
7241,0,AADG06003467.1/1334-1527,AUCGCUUCUCGGCCUUUUGGCUAAGAUCAAAGUGUAGUAUCUGUUCUUAUCAGCUUAAUAUCUGAUAUACUCUCUAGUGAGAGUUAAAAAUAUUAUACUGAUUUUUGAAACGUGGUGGAAGUUUUAGAGCUUGCUCUACUUCUACCGUGAGUCGGCAUGACAUUGCAGAUUUGUCGUGUUUCGGCUCAAUAUUA,48,73,40,33,194
7242,0,AAGJ04020931.1/13670-13861,AUCGCUUCUCGGCCUUUUGGCUAAGAUCAUGUGUAGUAUCUGUUCUUUUCAGCUUAAUAUCUGAAACGCGACUCACCGAGUCGCUUGUAUAUUAAACUGAUUUUUGAAUCUAGACCAUGGAAUAGGGGCUUGCUCCAUCCUGGUCACGGGUUGGCCCGGUAUUGCAGUACCUCCGGGAUCGGCCCACCCCUC,38,60,44,50,192
7243,0,AAGU03035529.1/35295-35485,AUUGCUUCUUGGCCUUUUGGCUAAGAUCAAGUGUAGUAUCUGUUCUUAUCAGUUUAAUAUCUGAUAAGUCCGCUAUCUGAGGACAAUAUAUUAAACAGAUUUUCGGAGCUGGGAGAUGGAAUAGGAGCUUGCUCCGUCCACUUCUCUCAUCGACUUGGUAUUGCACUACCUCCAGGAAGGGUGCAUGCCUC,45,63,43,40,191
7244,0,AFQF01002518.1/111488-111680,UUAGCUCUCUUUGCCUUUUGGCUUAGAUCAAGUGUAGUAUCUGUUCUUUUCAGUUUAAUCUCUGAAAGAUGUCUAAGGACAUCAAUCGUGAUUAUUCCUAUUUUUGGCUUUCGGGCAGUUUCCUCUGUGCUUGCACAUGAUUCUGCCCACAGUGUCCCUGGUAUUACACUGCCUCCAGGUGACGCGAACACUA,38,72,38,45,193
7245,0,AAGW02065159.1/39337-39527,AUCGCUUCUCGGCCUUUUGGCUAAGAUCAAGUGUAGUAUCUGUUCUUAUCAGUUUAAUAUCUGAUACGUCCUCUAUCCGAGGACAACAUAUUAAAUGGAUUUUUGGAGCCGGGAGUUGGAAUAGGAGCUUGCUCCGUCCACUCCUCGCAUCGACCCGGUAUUGCAGUACCUCCGGGCACGGUGCAAAAAAA,46,56,44,45,191
7246,0,AAWZ02022241.1/1219-1409,AUCGCUUCUCGGCCUUUUGGCUAAGAUCAAGUGUAGUAUCUGUUCUUAUCAGUUUAAUAUCUGAUAUGUCCUCUAUCUGAGGACUAUAUAUUAAAUGGAUUUUUGGACUUGGGAGAUGGAAUAGGGGCUUGCUCCAUCCACUCCACGCAUCGACCUGGUAUUGCAGUGCUUCCAGGAACGGUGCACCUCCC,42,63,43,43,191
7247,0,CAAB02025078.1/1453-1643,AUCGCUUCUCGGCCUUUUGGCUAAGAUCAAGUGUAGUAUCUGUUCUUAUCAGUUUAAUAUCUGAUACGUCCCCUACCCGGGGACCAUAUAUUAAAUUGAUUUUUGGAACAGGGAGAUGGAAUAGGGGCUUGCUCCGUCCACUCCACGCAUCGACCUGGUAUUGCAGUAUCUCCAGGAACGGUGCACCCCCC,43,56,43,49,191
7248,0,AAQR03042593.1/1155-1347,AUCGCUUCUCGGCCUUUUGGCUAAGAUCAAGUGUAGUAUCUGUUCUUAUCAGUUUAAUAUCUGAUACGUCCUCUAUCCGAGGACAACGUAUUAAAUGGAUUUUUGGAGUAGGGAGUUGGAACUAGGAGCUUGCUCUGUCCACUCCACGCAUCGACCUGGUAUUGCAGUAUCUUCCGGGAACGGUGCACCCUUC,42,62,45,44,193
7249,0,AACU03000093.1/631552-631747,CCAGCUCUCUUUGCCUUUUGGCUUAGAUCAAGUGUAGUAUCUGUUCUUUUCAGUUUAAUCUCUGAAACUGGUCUAUUUGACCAGAAUCAAAUGAUUAUACUUAUUUUUGUCACUAGGAGGGUUUCCGCUGGGCUUGCCCAUGAUUCCCUCCACUGUGUCCCUCCUAUCACACUGCCUGGAGGCGACGCGAACCUUU,38,70,38,50,196
7250,0,AE014186.2/1461495-1461298,CACCCUUCUCGGCCUCUUGGCUAAGAUCAAUUUGUAGUACCUGUUCUUAUCAGCGUGAUAGCUGAUAUGGUCUCAAUAGAGGCCUUAUCAAUUUCACAAAAAUUUUUGAUAGGGGAAAGGAUAAUUUGAAGCUUGCUUCUUAUAACCUUUCGCGCGUUGCCUUACCCUUGCACUAAAGGUUUGUACAGUGCACCCUUA,49,67,38,44,198
7251,0,FR799006.1/251703-251558,AUAUCUUCUCGGCUAUUUAGCUAAGAUCAUGUUUAUAAACUGUUCUUAUCAGAGUAACUCCUGAUACUGCCUUCGGGCAAAGGAAUAGAAAUUAUAAGUCGAGGUUGUUUCCCUGGAGCUCCACCUUUCCAGGGGAGCAACUUCUU,38,48,29,31,146
7252,0,AAFN02000024.1/475809-475596,AUCUCUUUGCCAUUUGGCUUAGAUCCAGUGUAGUAUCUGUUCUUUUCAGUGUAACAGCUGAAAUGUCAUCAUUGAUGACUUUACAUUAUGUUACAAAUUUAUACUUAUUUUUGGAUAUUGGGUAGAUUGAUGUAUUAAAGUGGGCUUGCUCACAGUCUUUCUACAUAGUGUCGUUGCCACUGUACUUUUAUUUUGGCUUCUGACGCAAAUUCUU,49,91,39,35,214
7253,0,K00034.1/420-610,AUCGCUUCUCGGCCUUUUGGCUAAGAUCAAGUGUAGUAUCUGUUCUUAUCAGUUUAAUAUCUGAUACGUCCUCUAUCCGAGGACAAUAUAUUAAAUGGAUUUUUGGAACUAGGAGUUGGAAUAGGAGCUUGCUCCGUCCACUCCACGCAUCGACCUGGUAUUGCAGUACCUCCAGGAACGGUGCACCCCCU,45,59,41,46,191
7254,0,ABDG02000029.1/618164-617972,UUAGCUCUCUUUGCCUUUUGGCUUAGAUCAAGUGUAGUAUCUGUUCUUUUCAGUUUAAUCUCUGAAAGGUCUCUAAGGAGACCAAUCGUGAUUAUUCUUAUUUUUGUCCUCAGGGCGGUCUCCUCUGUGCUUGCACAUGAUUCCGCCCACAGUGUCCCUGGUAUUACACUGCCUCCAGGCGACGCGAACACUU,36,69,39,49,193
7255,0,AP004871.3/124344-124540,AUACCUUUCUCGGCCUUUUGGCUAAGAUCAAGUGUAGUAUCUGUUCUUAUCAGUUUAAUAUCUGAUAUGUGGGCCAUGUGCCCACUUCGAUAUUAAAUUUAUUUUUUGUGGGGGAGGGCCCACUACAGUGGCUUGCCACUGGGGUCCUCGCGUGUCGCCCAGGCGUUGCACUACAGCCUGGGCCUGGCGCACCCCAA,36,61,50,50,197
7256,0,URS0000D6B294_12908/1-91,UGCGCAUGAGGUUAGAAAAUCUGCUAGGCUAACACCGGAUAGCGAAAGCUUGAGUAGGAGAUGAAGGGUUCGCACAGUCCUUCCAUGCGCU,25,20,27,19,91
7257,0,URS0000D69D92_12908/1-104,AACUGUUGAGGUGGGAACCGCCACCCCACGCACUUGGCCGCAAAGCCAAGUAAUUAACCGCCGUAAGGCGGCCAAGAGAUCGCGGUUGGCAACGCGCGACAGUU,27,15,31,31,104
7258,0,URS0000D6D449_12908/1-87,GCCGCCAGAGGUCGAAAGGGGACGACGCACCGAAAGCUAAUGCUUUCGGUCACGAGAAAUGUGGGUUUCCUCGCCCCACCUGGCGGU,19,15,28,25,87
7259,0,URS0000D65C46_12908/1-79,AGACUUAGAGGAUAGGAAUUGCAGUACUAUCGCCCCGUAAUUGGAAGGAGACGCAAGGUAGCUGCGCUUGCCUAAGUCU,22,18,23,16,79
7260,0,URS0000D6B8AE_12908/1-97,GUAAAACGAGGUGGAAAGGGCGACCAUACACCUAACGCAUAUUCUUAGAAAUAUGGGGGUCAGAGAGAUGAAAGACAUGCCCGACUUUCCGUUUUAC,32,21,25,19,97
7261,0,URS0000D6D3FA_12908/1-130,AAACUAAGAGGUGGAAAGUGACCUUCCAUACGCCUACGGUAUAGGAAACUAUACAAAGGGUGAUAGAAGCCCGUAACAGGUUAAGCUGACGAGGAUAAGAGAUUUCGGAAUUGGUCUCCGAACUUAGUAU,45,29,34,22,130
7262,0,URS0000D6AE4F_12908/1-129,AAACUAAGAGGUGGAAAGUGACCUUCCAUACGCCUACGGCAUAGGAAACUACGCAAGGGGUGAUAGAAGCCCGUAACAGGUUAAGCUGACGAGGAUAAGAGAUUUCGGAUUGGUCUCCGAACUUAGUAU,42,27,36,24,129
7263,0,URS0000D68B7C_12908/1-76,AUGCCUCGAGGACGGAGAUAAUGUACUUCCGUCACUUCCUAAAAGAGAUGUAGGGCCGGUACUCCUACCGAGGCUU,19,18,20,19,76
7264,0,URS0000D69013_12908/1-71,UCUCAAUGAGGAUAGAACUGGCAUCUAUCGCCCAACGAGGAGAUGUGAGGUAUUGUCACUCACCAUUGAGA,21,17,18,15,71
7265,0,URS0000D6C137_366602/1-103,CGCUGAUGAGGUGAGAACUCCCUCCUCACACACUCCGCUUCGGCGGCGUAAAGUAGGCGAAAGCCGAAAGAGAUGCGGGAAUGUUGGGACCCCGCCAUCAGCG,25,16,32,30,103
7266,0,URS0000D6D1E6_12908/1-130,UUGUCGCGAGGUGAGAACGGCCUUCUCACGCCCCUUUGGUCAGAGAGAGGGAAAGUAGCUGGUUGCGGGUUUCCGUCUCCUUCCCCGCACUCCAGUGAAGAGGUCCGGGAGUGGCGACCCGGCGCGACAG,22,26,45,37,130
7267,0,URS0000D69E08_12908/1-100,UGCUUGCGAGGUGAGAACGGCCUGCUCACGCUCCUGCAGUUUUGCAGGACAGUAGCCGAAAGGUGAAGAGAUCCUGGGAAUUGGCAUCCAGGCGCAAGUA,24,20,33,23,100
7268,0,URS0000D6CCAB_12908/1-112,CGGCUGCGAGGUGAGAAAACUGUCUGCUCACGCGUCUGGUUAUUCAGGUUAAGUAGGAAGCGGUCACGGCCGCGUCUGAAGAGAUUCGGGGAUGGGCAUCCCGGCGCAGUUG,22,24,41,25,112
7269,0,URS0000D686FB_12908/1-105,GCCACCAGAGGUAGAAAGAACCCGUCGCUAUACACCGAUCCGUCAGGGUUGGCAAAGCUCGAAAGGGCUAUGAGAGAUGCGGGGGUGGCGGUCCUGCCUGGUGGU,24,18,38,25,105
7270,0,URS0000D66846_12908/1-94,GUGCCUAGAGGCGAGAACGUCCUCCUCACGCACCUACGUUGGGUAAAGUAGCCGCAAGGUGAAGAGAUCGCGGAUUUGCCAUCGCGCUAGGCAU,22,18,29,25,94
7271,0,URS0000D6B406_1245469/1-112,GAGUUUUGAGGUGAGAACGGCCUCCUCACACGCCUGUCGAUCGAACGUUCAACAGGCAAAGUAGCUGGGAAACCAGCGAAGAGAUCUGGGUGUGGGCACCCCAGCAAAUCUA,31,20,33,28,112
7272,0,URS0000D66EEC_441620/1-127,GAGAUUUGAGGUGAGAACGGCCUCCUCACGCGCCCACGCUCAAUGCGGGGGCAAAGUAGCACCGGCUGCACGGCAUGCCAUGCGGUCGGUGUGAAGAGAUCCGGAUUUGGGCAUCCCGGCAACGUUU,26,23,43,35,127
7273,0,URS0000D69743_595536/1-113,CAGUUUCGAGGUGAGAACGGCCUCCUCACGCGCCGGGCGUUCGAUCGUUCGCUCGGCAAAGUAGCUAGGGCGACUUAGCGAAGAGAUCCGGAAUUGGGCGUCCGGCGAACCGG,22,20,40,31,113
7274,0,URS0000D69C52_12908/1-94,CAGCUAAGAGGUGGGAACGGCUACCCCACGCACCGGAAACGGUAAGUAAGCCCGCAAGGGUCCAAGAGAUGAGUGUUAGCAAGCUCCUUAGUUA,28,15,28,23,94
7275,0,URS0000D6C3A7_12908/1-146,ACUAAAAGAGGUGGAAAUUAGGGAGUCCACACGCUUACAGCUUUAGAAGUAGAACACAGCUAAAGUCAAUAGUGAUAGAUACCCAUUGCUAGGGAUAGCAUUGAUAAGGAUAAGAGAUGAGGGGAGUUUCUCUCCCUCCUUUUAGU,49,37,36,24,146
7276,0,URS0000D6D14D_12908/1-78,GAGCUAUGAGGACGUGAGAGUGAUACCGUCGCCCCGUGACUGGAAGGAGAUGUAGGAUCGUCAGCCCUACCUUAGCUU,18,17,25,18,78
7277,0,URS0000D6CC79_12908/1-78,GAGCUAUGAGGACGUGAGAGUGACAACGUCGCCCCGUGACUGGAAGGAGAUGUAGGAUCGUCAGCCCUACCUUAGCUU,19,16,25,18,78
7278,0,URS0000D6C3F1_12908/1-78,GAGCUAUGAGGACGUGAGAGUGACACCGUCGCCCCGUGACUGGAAGGAGAUGUAGGAUCGUCAGCCCUACCUUAGCUU,18,16,25,19,78
7279,0,URS0000D68505_12908/1-78,GAGCUAUGAGGACGUGAGAGUGACACCGUCGCCCCAUAAUCGGAAGGAGAUGUAGGAUCGUCAGCCCUACCUUAGCUU,20,16,23,19,78
7280,0,URS0000D67F69_12908/1-78,GAGCUAUGAGGACGUGAGAGUGACACCGUCGCCCCAUAAUUGGAAGGAGAUGUAGGAUCGUCAGCCCUACCUUAGCUU,20,17,23,18,78
7281,0,URS0000D6582E_12908/1-78,GAGCUAUGAGGACGUGAGAGUGACACCGUCGCCCCAUAAUUGGAAUGAGAUGUAGGAUCGUCAGCCCUACCUUAGCUU,20,18,22,18,78
7282,0,URS0000D66670_12908/1-92,UUUAUUUAAGGGUGGAAAGGGCCCCGCCAGGCCUUGUAAUUAUAUUACGAGGUGAGAAAAUCGGAUGCAGAGUUGCCCGUCUGCUAAAUAAA,27,24,25,16,92
7283,0,URS0000D6D236_12908/1-96,ACAGCCUGAGGACCGGAAAACCUGCUGCCGGCCCGCCUUGACAUACCCUCCCAACCAACAAGGUGCGAUGUGGGGAAGGCAGUCCCACCAGGCUGU,23,13,27,33,96
7284,0,URS0000D685BF_12908/1-99,ACAGCCUGAGGACCGGAAAACCUGCCGCCGGCCCGCCUUGACAUAUUUUUUUAUCAAGGAAACAAGGUGGAUGUGGGGAACGCAGUCCCACCAGGCUGU,25,19,28,27,99
7285,0,URS0000D6750D_12908/1-99,ACAGCCUGAGGACCGGAAAACCUGCCGCCGGCCCGCCUUGAUAAAUUUUUUCUCAAGGAAACAAGGUGCGAUGUGGGGAAAGCAGUCCCACCAGGCUGU,26,18,28,27,99
7286,0,URS0000D6C585_12908/1-93,ACAGUCUGAGGACCGGAAAAUCUGCUGCCGGCCCGCCCGGUGAAAAGUCAUGGAAAAGGGCGCGAUGUGGGAGUGGCAGUCCCACCGGACUGU,22,14,33,24,93
7287,0,URS0000D69C4E_12908/1-89,AUCACCAGAGGUAGAAAUUUCCGCCGCUACGCACCGAGCCGCAAGGCCGGUCACAGAAGAUGUCGGGACUGGCGGACCGACCUGGUGAU,22,13,28,26,89
7288,0,URS0000D68252_1356854/1-81,CACCGUAGAGCGAUGGAACGGACAGCCAUCGGGCACACGAAAGUGGUAGUCGAUGCAGGGUAGGUCAACCUGCCUACGGUG,21,12,28,20,81
7289,0,URS0000D6A361_12908/1-70,GGGCCGUGAGGACGGAAAGGCUUCCGUCGCCUGAGUGGAAAUCCAGAUAGUUGCCGACCUGGCACGGUUC,14,13,25,18,70
7290,0,URS0000D67345_12908/1-70,GGAUCGUGAGGACGGAAAGACUUCCGUCGCCGGUGUGGAAAUCCAGGAGCUUGUCGACCUGGCACGGUUC,14,14,25,17,70
7291,0,URS0000D694E2_12908/1-83,ACUUCUCGAGGUAGAAAAUUUAUGGCAUCUACACAACUAGAAAUAGGAUUGAGAUGUGGGGUAAGCGACACCCACCGAGAAGU,29,18,21,15,83
7292,0,URS0000D66E39_12908/1-83,ACUUCUCGAGGUAGAAAAUUUGUGGCAUCUACACAACUAGAAAUAGGAUUGAGAUGUGGGGUAAGCGACACCCACCGAGAAGU,28,18,22,15,83
7293,0,URS0000D69B32_12908/1-83,ACUUCUCGAGGUAGAAAAUUUGUGGCCUCUACACAACUAGAAAUAGGAUUGAGAUGUGGGGUAAGCGACACCCACUGAGAAGU,27,19,22,15,83
7294,0,URS0000D6BB14_12908/1-83,ACUUCUCGAGGUAGAAAAUUUGUGGCCUCUACACAACUAGAAAUAGGAUUGAGAUGUGGGGUAAGCGACACCCACCGAGAAGU,27,18,22,16,83
7295,0,URS0000D68133_12908/1-83,ACUUCUCGAGGUAGAAAAUUUGUGGCCUCUACACAACUAGAAAUAGGAUUGAGAUGUGGGGUAAGCGACACCCACCGAGAAGC,27,17,22,17,83
7296,0,URS0000D66647_12908/1-83,AUUUCUCGAGGUAGAAAAUUUGUGGCAUCUACACAACUAGAAAUAGGAUUGAGAUGUGGGGUAAGCGACACCCACCGAGAAGU,28,19,22,14,83
7297,0,URS0000D690C0_12908/1-83,UCUUCUCGAGGUAGAAAAUUUGUGGCAUCUACACAACUAGAAAUAGGAUUGAGAUGUGGGGUAAGCGACACCCACCGAGAAGC,27,18,22,16,83
7298,0,URS0000D65713_414684/1-96,GGUCCGCUGAGGUGGGAACGGCCGCCCCACGCCCCCGUAGCGGGGAGAGUAGCCGCAAGGUGAAAGAGAUUCCGGAGUGGCACCCGGACUCGGACA,20,10,37,29,96
7299,0,URS0000D66C72_12908/1-131,GGCUCUCAGAGGUGGGAACGGCCUCCCCACACACCACCGGCGCUGUGGCGCAGGUGGUACAGUAGCUCUGACAGAGUACAGUUGCUCUGGCAGAGUGAAGAGAUCCGGGCGUGGGCACCCCGGCUAGAGCC,26,20,46,39,131
7300,0,URS0000D6B38B_12908/1-112,GGCUUUAGAGGUGGGAACAGCCUCCCCACACACCACCAUUGCUGCGGCAGCGGUGGUACAGUAACCCUGAAUUGGGUGAAGAGAUUCGGGUGUGGGCAACCCGGCUAAGGCC,25,20,37,30,112
7301,0,URS0000D6AE0D_12908/1-97,UUUGUCUGAGGUGAGAAAUUUUGCCACCCACUCACACACUGAGUCCGUAAAAGGCCAGUCAAGGUAGAUGCAGGGCGUGGUGGACCUGCCAGACAAA,27,20,27,23,97
7302,0,URS0000D6B097_12908/1-82,AAGAAUAGAAGUAGAAAAACAUCGGGAACUACGCACCCUUUGGGUAUCUGAAAAGCGGGGAAUUCCCGUCCCGCCUAUUCCA,27,16,19,20,82
7303,0,URS0000D6C069_12908/1-84,AGGAAAUGAAGUAGAAAAAUAUCGGACGCACACGCACCCAAAAGGGUAUCUGAGGGGCGGGGAAUGUCCGUCCCGCCAUUUCCU,26,14,24,20,84
7304,0,URS0000D6885F_12908/1-84,AGGAAAUGAAGUAGAAAAAUAUCGGACGCACACGCACCCGAAAGGGUAUCUGAGAGGUGGGGAAAGUCCGUCCCGCCAUUUCCU,27,14,24,19,84
7305,0,URS0000D6B8DC_1302863/1-84,AGGAAAUGAAGUAGAAAAAUAUCGGACGCACACGCACCCGAAAGGGUAUCUGAGAGGUGGGGAAUGUCCGUCCCGCCAUUUCCU,26,15,24,19,84
7306,0,URS0000D6B8DC_12908/1-84,AGGAAAUGAAGUAGAAAAAUAUCGGACGCACACGCACCCGAAAGGGUAUCUGAGAGGUGGGGAAUGUCCGUCCCGCCAUUUCCU,26,15,24,19,84
7307,0,URS0000D6A531_12908/1-84,AGGAAAUGAAGUAGAAAAAUAUCGGACGCACACGCACCCAAAAGGGUAUCUGAGAGGUGGGGAAUGUCCGUCCCACCAUUUCCU,28,15,22,19,84
7308,0,URS0000D67D47_12908/1-84,AGGAAGUGAAGUAGAAAAAUAUCGGACGCACACGCACCCGAAAGGGUAUCUGAGAGGUGGGGAAUGUCCGUCCCACCAUUUCCU,26,15,24,19,84
7309,0,URS0000D69F23_12908/1-84,AGGAAAUGAAGUAGAAAAAUAUCGGACGCACACGCACCCGAAAGGGUAUCUGAGAGGUGGGGAAUGUCCGUCCCACCAUUUCCU,27,15,23,19,84
7310,0,URS0000D65F3E_12908/1-84,AGGAAAUGAAGUAGAAAAAUAUCGGACGCACACGCACCCGAAAGGGUAUCUGAGAGGUGGGGAAUGUCCGUCCCACCAUUUCCG,27,14,24,19,84
7311,0,URS0000D6591C_12908/1-84,AGGAAAUGAAGUAGAAAAAUAUCGGACGCACACGCACCCGAAAGGGUAUCUGAGAGGUGGGGAGUGUCCGUCCCACCAUUUCCU,26,15,24,19,84
7312,0,URS0000D6BC01_12908/1-84,AGGAAAUGAAGUAGAAAAAUAUCGGACGAACACGCACCUGAAAGGGUAUCUGAGAGGUGGGGAAUGUCCGUCCCACCAUUUCCU,28,16,23,17,84
7313,0,URS0000D6BE08_12908/1-84,AGAAAAUGAAGUAGAAAAAUAUCGGACGCACACGCACCUGAAAGGGUAUCUGAGAGGCGGGGAAUGUCCGUCCCGCCAUUUCCU,27,15,23,19,84
7314,0,URS0000D668ED_12908/1-84,AGGAAAUGAAGUAGAAAAAUAUCGGACGCACACGCACCUGAAAGGGUAUCUGAGAGGCGGGGAAUGUCCGUCCCGCCAUUUCCU,26,15,24,19,84
7315,0,URS0000D68D9B_1156433/1-84,AGGAAAUGAAGUAGAAAAAUAUCGGACGCACACGCACCUGAAAGGGUAUCUGAGAGGCGGGGAAUGUCCAUCCCGCCAUUUCCU,27,15,23,19,84
7316,0,URS0000D6BBB7_12908/1-83,UAAAGUAAAAGUAGAAAAACAUCGGGCCCUACACACCCUAACGGGUUCCUGAGAGGUGGGGAAUGCCCGUCCCACUUACUUUA,26,17,19,21,83
7317,0,URS0000D6653C_12908/1-83,AAAAGUAAAAGUAGAAAAAUAUCGGGCCCUACACACCCUAACGGGUUCUUGAGAGGUGGGGAAUGCCCGUCCCACUUACUUUU,26,19,19,19,83
7318,0,URS0000D6645C_12908/1-83,AAAAGUAAAAGUAGAAAAAUAUCGGGCCCUACACACCCUAACGGGUUCCUGAGAGGUGGGGAAUGCCCGUCCCACUUACUUUU,26,18,19,20,83
7319,0,URS0000D69808_12908/1-83,AAAAGUAAAAGUAGAAAAAUAUCGAGCCCUACACACCCUAACGGGUUCCUGAGAGGUGGGGAAUGCCCGUCCCACUUACUUUU,27,18,18,20,83
7320,0,URS0000D6807E_12908/1-85,AAAGAUAGAAGUAGAAAACUCGGGCGCUACACACCUUUGCGCAAGGUUUCUGGAGAUGAGGGGAAUGCCCGUCCCUCCUAUCUUU,23,20,22,20,85
7321,0,URS0000D6AB4C_12908/1-85,AAAGAUAGAAGUAGAAAACUCGGGCGCUACACACCUUUGUGCAAGGUUUCUGGAGAUGAGGGGAAUGCCCGUCCCUCCUAUCUUU,23,21,22,19,85
7322,0,URS0000D68784_12908/1-124,AUCAGAAGAAGUAGAAACAUGCAGUCUACACACUUGCCGGAUUCAUUAAAUCUUCGGAUUUCGAGGCGAGUCUAAAAAAAGCUUAACCGCUAAGAGAUGUGGGAAAGUCACCCCACCUUCUGAU,42,29,26,27,124
7323,0,URS0000D69152_12908/1-109,ACUAAGAGAGGUGGAAAAAUGGACAUCCAUGAGCCUUAUACCCUUUGGCAGAGAUGCAGGGCAGUAUUGGUAUAAGAGAGAUGCGGGGCGAGUCCUCCCGCCUCUUAGU,30,24,33,22,109
7324,0,URS0000D68865_12908/1-82,CUGAAUAGAGGAUAGGAGUUAUAGCACUAUCACACCUUUAUGGUAGAAAGAGACGUUGGGGGAGCUGUCCCAACCUAUUCAC,25,20,21,16,82
7325,0,URS0000D69FA2_12908/1-82,UUGAAUAGAGGAUAGGAGUUAUAGCGCUAUCACACCUUUAUGGUAGAAAGAGACGUUGGGGGAGCUGUCCCAACCUAUUCAC,24,21,22,15,82
7326,0,URS0000D658A0_12908/1-84,GCUUCUUGAGGUGGUCAAUUGCGGCAACCACACACCUAUUUAUAGGGAUAAGAGAUCCAAGGACAGCCGGACUUGGCAAGAGGC,24,17,24,19,84
7327,0,URS0000D6CFA1_12908/1-96,AAUUGACGAGGUGGGAACAGCUACCCCACACGCCCGGCAACGGGUAAUUAGGUCUUUCGAGGCUGAAGAGAUGCAGGUUGGCAACUGCCGUUGUAU,24,20,30,22,96
7328,0,URS0000D68F08_767817/1-86,CGUUUUGGAGGUGGGCAAAACCCGUCCCCCACACACCUCACAGGAGGUCAAAAGAGAUGCAGGAACAGGCGGUCAUGCCCAAAACG,26,11,24,25,86
7329,0,URS0000D65CEC_12908/1-74,GAGCAUCUAGGGCGGAACAGACAACCGCCACCUUUAGUAUGGAUAUGUGGGGAAUCGCCGUCCCACCGGUGUUA,18,15,22,19,74
7330,0,URS0000D682A8_12908/1-81,AAGUGUUGAGGUAGAAAGUUCUAUCACGGUGGCUAACGACCAAUAUCGGGAGGUGUGGGGUAUACCGUCCCACCAACACUU,22,19,23,17,81
7331,0,URS0000D67BB4_12908/1-81,AAGUGUUGAGGUAGAAAGUUCUAUCACGGUGGCUAACGACCAAUAUCGGGAGGUGUGGGGAAUACCGUCCCACCAACACUU,23,18,23,17,81
7332,0,URS0000D6922F_1233171/1-89,AGGUUUUGAAGUUGGAAAGAGUCCAAUACUCUACUUAAAGGUUUUAAGUAAUUGUGAGAGAUGCAGAAUUACUCGCUCUGCCAAACCUA,29,27,19,14,89
7333,0,URS0000D6ADFE_1233170/1-88,AGGUUUUGAAGUUGGAAAGGGUCCAAUACUCUACUUAAAGUUUUUAAGUAAUUGUGAGAGAUGCAGAAUUACUCGCUCUGCCAAACCU,27,28,19,14,88
7334,0,URS0000D69A8F_12908/1-87,CGAAUUUGAGGGCUGAAAGGGUUGCAGCCGCCCCUUACGCUCUGCGUAAGGUUAGGAGAUGUGGAAGUUACUGUCCCACCAAAUUCA,21,21,25,20,87
7335,0,URS0000D65BFC_1107544/1-101,AUCAACCGAAGGCGGAAAGUUACCGCCACCUAGCAACCAGGAGGGCACCACACUUCUAGUGCUUAACGGAGAUGCAGGAGUUUAGCGACCUGCCGGUUGUA,28,18,28,27,101
7336,0,URS0000D67966_12908/1-81,AGGACUAAAGGGUAGAAGGGUCAGCUACCGCCACAGAGAAGCUCUGGUAGGAGAUGUUGGGUUGACAGCCAGCUUAGUUCU,22,17,27,15,81
7337,0,URS0000D65B09_12908/1-81,AGGACUAAAGGGUAGAACGGUCAGCUACCGCCACAGAGAAGCUCUGGUAGGAGAUGCUGGGUUGACAGCCAGCUUAGUUCU,22,16,26,17,81
7338,0,URS0000D65B05_12908/1-97,AUUAUUUGAGGUGGAAAAUUUCGCACGAUCCCCACGCUGUUGGUACAGACAAGGGAAACCUGAGAGAUGCAGGAGAAGUGUGCGCCUGCCAAAUAAU,30,21,27,19,97
7339,0,URS0000D69473_1118056/1-77,AAUCAUAGAGGUUAAGAAAUCUGCCGAUAACGCUAUUUUAUAGAAAUGUGGGAGAGGAGGCAGUCCCACCUAUGUUU,25,21,19,12,77
7340,0,URS0000D6A532_12908/1-82,UCGUUACGAGGGCGGAACAGGCAGCCGCCACCUCCGAGCAAUCGGAACAGGAGAUGCAGGGUACGCCGUCCUGCCACGACGC,19,9,27,27,82
7341,0,URS0000D68E80_12908/1-85,AGUAGGAGAGGUGGACAAUUUCGGCACGUCCACACACCUUAUGGGUCAAAAGAGAUGAGGGAGAAUGUGCCGCCCUCCUCCUAAA,25,16,24,20,85
7342,0,URS0000D68EA7_12908/1-82,AUAGGAAAAGGUGGAAAAAUGAUGCGUCCACACACCCACAGGGUCAAAAGAAAUGAGAGAAUGGCGUCACUCUCUUUCCUAU,30,16,19,17,82
7343,0,URS0000D69A39_12908/1-82,AUAGGAAAAGGUGGAAAAUUGAUGCGUCCACACACCCACAGGGUCAAAAGAGAUGAGAGAAUGGCGUCACUCUUUUUCCUAU,28,18,20,16,82
7344,0,URS0000D67C60_12908/1-82,AUAGGAAAAGGUGGAAAAUUGAUGCGUCCACACACCCACAGGGUCAAAAGAGAUGAGAGAAUGGCGUCACUCUCUUUCCUAU,28,17,20,17,82
7345,0,URS0000D69573_12908/1-82,AUAGGAAAAGGUGGAAAAAUGAUGCGUCCACACACCCACAGGGUCAAAAGAGAUGAGAGAAUGGCGUCACUCUCUUUCCUAU,29,16,20,17,82
7346,0,URS0000D6A1F6_12908/1-82,AUAGGAAAAGGUGGAAAAAUGAUGCGUCCACACACCCACAGGGUCAAAAGAGAUGAGAGAACGGCGUCACUCUCUUUCCUAU,29,15,20,18,82
7347,0,URS0000D6A239_12908/1-82,AUAGGAAAAGGUGGAAAAUUGAUGCGUCCACACACCCACAGGGUCAAAAGAGAUGAGAGAAUGGCGUCACUCUCUUUACUAU,29,17,20,16,82
7348,0,URS0000D66052_12908/1-82,AUAGGAAAAGGUGGAAAAAUGAUGCGUCCACACACCCACAGGGUCAAAAGAGAUGAGAGAAUGGCGUCACUCUCUUUACUAU,30,16,20,16,82
7349,0,URS0000D69360_12908/1-88,UGUAGAAAAGGUGGAAAAAUUCGAUGCGUCCACACUCAAUUGAAAAAUUGAUAAGAGAUGAGGGAGAAAGCGUCGCCCUCUUUCUAUG,31,21,22,14,88
7350,0,URS0000D65807_12908/1-88,UGUAGAAAAGGUGGAAAAUUUCGAUGCGUCCACACUCAAUUGAAAAAUUGAUAAGAGAUGAGGGAGAAAGCGUCGCCCUCUUUCUAUG,30,22,22,14,88
7351,0,URS0000D6AF57_12908/1-88,UGUAGAAAAGGUGGAAAAAUUCGACGCGUCCACACUCAACUGAAAAAUUGAUAAGAGAUGAGGGAGAAAGCGUCGCCCUCUUUCUAUG,31,19,22,16,88
7352,0,URS0000D6C929_12908/1-88,UGUAGAAAAGGUGGAAAAAUUCGACGCGUCCACACUCAAUUGAAAAAUUGAUAAGAGAUGAGGGAGAAAGCGUCGCCCUCUUUCUAUG,31,20,22,15,88
7353,0,URS0000D680A3_12908/1-88,UGUAGAAAAGGUGGAAAAUUUCGACGCGUCCACACUCAAUUGAAAAAUUGAUAAGAGAUGAGGGAGAAAGCGUCGCCCUCUUUCUAUG,30,21,22,15,88
7354,0,URS0000D65F9F_12908/1-87,GGUGGAAAAGGUGGAAAAAUUCGAUGCGUCCACGCUCAAUUAAAAAUUGAUAAGAGAUGAGGGAGAAAGCGUCGCCCUCUUUCCAAU,30,19,23,15,87
7355,0,URS0000D6B685_12908/1-82,AUGCCCCGAGGAUAGAGAAUGUAGCGCUAUCACACCCUUAGGGUCAAAAGGAAUGCGGGACAGGCUACACCCGCCGGGGCAC,23,11,25,23,82
7356,0,URS0000D6A06F_12908/1-69,AUGCUCCGAGGAUAGAACGGGCAGCUAUCGCCAAUGUGGAGAUGCGUGAGUGCCGACACGCCGGAGCAA,18,10,24,17,69
7357,0,URS0000D67CAF_12908/1-81,AGAAGCUGAGGACGGAACAGGUAUCCGUCACCCUAUCUUCUUAUAGAUAGUUGGAGAUGCAGAUUACCACCUGCCUCUUCU,21,22,18,20,81
7358,0,URS0000D6AF24_12908/1-82,GAGAAGUGAGGUAGAGAUGAUAGUGUUCCUACGCACCCAUGAGGUAGAAGAGAUGACGGGACAGACACACCGUCCACUACUC,26,14,24,18,82
7359,0,URS0000D65FD8_12908/1-82,GAGAAGUGAGGUAGAGAUGAUAGUGUUCCUACGCACCCAUGAGGUAGAAGAGAUGACGGGACAGACACACCGUCCACUGCUC,25,14,25,18,82
7360,0,URS0000D65B06_1321820/1-81,GAAUAAUGAAGUAGAGAUUUAGUGUUCCUACGCACCCAAGAGGUAUAAGAGAUGACGGGAUAGACACACCGCCCAUUAUUC,28,18,19,16,81
7361,0,URS0000D6C07A_12908/1-110,AAAGCGUGAGGAUAGAAAAGCGUCGGCUAUUGCGGACUAUGAAAUAGUCUCAAGUGUAGAAGAUUAUUAAUCUUUGAUGAGAUGUUGGAAGUGAUGCCCAACCACGCCUA,36,28,29,17,110
7362,0,URS0000D67BD9_12908/1-109,AAAGCGUGAGGAUAGAAAAGCGUCGGCUAUCGCGGACCCUUAUGGGUCUCAAGUGUAGAAGAUUAUUAAUCUUUGAUGAGAUGCUGGAAGUGAUGCCCAACCACGCCUA,32,26,30,21,109
7363,0,URS0000D663A1_12908/1-109,AAAGCGUGAGGAUAGAAAAGCGUCGGCUAUCGCGGACCCUUAUGGGUCUCAAGUGUAGAAGAUUAUUAAUCUUUGAUGAGAUGUUGGAAGUGAUGCCCAACCACGCCUA,32,27,30,20,109
7364,0,URS0000D6B696_12908/1-109,AAAGCGUGAGGAUAGAAUGGCAUCGGCUAUCGCGGACCCUUAUGGGUCUCAAGUGUAGAAGAUUAUUAAUCUUUGAUGAGAUGCUGGAAGUGAUGCCCAACCACGCCUA,31,27,30,21,109
7365,0,URS0000D6B763_12908/1-110,AAAGCGUGAGGAUAGAAUGGCAUCGGCUAUCGCGGACUAUGAAAUAGUCUCAAGUGUAGAAGAUUAUUAAUCUUUGAUGAGAUGUUGGAAGUGAUGCCCAACCACGCUAA,36,28,29,17,110
7366,0,URS0000D6725D_12908/1-110,AAAGCGUGAGGAUAGAAAAGCGUCGGCUAUCGCGGACUAUGAAAUAGUCUCAAGUGUAGAAGAUUAUUAAUCUUUGAUGAGAUGUUGGAAGUGAUGCCCAACCACGCCUA,36,27,29,18,110
7367,0,URS0000D6BA93_12908/1-80,AAGACUUGAGAAUAGAGAUAUGGGACUAUCGCCCCCAUAAAUUGAAAGGAAAUGUGGGAAUCCCAGCCCCACCAAGUCUU,28,16,18,18,80
7368,0,URS0000D669F5_12908/1-99,UAAGUUAGAAGUUGAAAGUGAAUAGCACACUGUCCCAACGCGCCAAGCCUGAAAAGGAAGGUGUAAAGAGAUGUGGGGGUGAUAGUCCCACCUAACUUU,33,21,27,18,99
7369,0,URS0000D6C730_12908/1-101,UAGGUUAGAGGUUGAAAAGUAUUAAGUUACGCUGUCUCAACACGCUAUACUCGAAAGAGAAGUAAAAAGAAAUGUGGGGUUUGGCAGUCCCACCUAAACUA,36,25,24,16,101
7370,0,URS0000D65D9F_12908/1-101,UAGGUUAGAGGUUGAAAAGUAUUAAGUUACGCUGUCUCAACACGCUAUACUCGAAAGAGAAGUAACAAGAAAUGUGGGGGUUGGCAGUCCCACCUAACCUA,34,24,25,18,101
7371,0,URS0000D6B4AD_12908/1-101,UAGGUUAGAAGUUGAAAAGUAUUAAGUUACGCUGUCUCAACACGCUAUACUCGAAAGAGAAGUAACAAGAAAUGUGGGGGUUGGCAGUCCCACCUAACCUA,35,24,24,18,101
7372,0,URS0000D69B5D_12908/1-101,UAAGUUAGAGGUUGAAAAGUAUUAAGUUACGCUGUCUCAACACGCUAUACUCGAAAGAGAAGUAACAAGAAAUGUGGGGGGUGGCAGUCCCACCUAACUUU,34,25,25,17,101
7373,0,URS0000D6A83E_12908/1-101,UAUGUUAGAGGUUGAGAAGUAUUAAGUUACACUGUCGCAAUACGCCAAGCCCGGAAGGGAAGGUGACAAGAGAUGUGGGGAGGGCUGUCCCACCUAACUUA,30,22,31,18,101
7374,0,URS0000D6BF7E_12908/1-101,UAGGUUAGAAGUUGAAAAGUAUUAAGUUACGCUGUCCCAACGCGCCAGGCCCUUAAGGGAAGGUGUAAAGAGAUGUGGAGGUGAUAGUCCUACCUAACCUA,31,24,28,18,101
7375,0,URS0000D67C10_12908/1-101,UAGGUUAGAAGUUGAAAAGUAUUAAGUUACGCUGUCCCAACGCGCCAAGCCCUGAAGGGAAGGUGUAAAGAGAUGUGGAGGUGAUAGUCCCACCUAACCUA,32,22,28,19,101
7376,0,URS0000D68B76_12908/1-101,UAGGUUAGAAGUUGAAAAGUAUUAAGUUACGCUGUCCCAACGCGCCAAGCCCGGAAGGGAAUGUGUAAAGAGAUGUGGAGGUGAUAGUCCCACCUAACCUA,32,22,28,19,101
7377,0,URS0000D69FDC_12908/1-100,UAGGUUAGAAGUUGAAAGUAUUAAGUUACGCUGUCCCAACGCGCCAAGCCCUGAAGGGAAGGUGUAAAGAGAUGUGGAGGUGAUAGUCCCACCUAACCUA,31,22,28,19,100
7378,0,URS0000D69685_12908/1-104,UAGGUUAGAAGUUGAGAAGUAUUAAGUUACGCUGUCCCAACGCGCCAAGCCCUAAAUGGGAAGGUGACAAGAAGAUGUGGGGGUUGGCAGUCCUACCUAACCUA,31,23,30,20,104
7379,0,URS0000D66BE8_12908/1-104,UAGGUUAGAAGUUGAAAAGUAUUAAGUUACGCUGUCCCAACGCGCCAAGCCUAAAAUGGGAAGGUGACAAGAAGAUGUGGGGGUUGGCAGUCCCACCUAACCUA,33,22,29,20,104
7380,0,URS0000D6B871_12908/1-104,UAGGUUAGAAGUUGAGAAGUAUUAAGUUACGCUGUCCCAACGCGCCAAGCCCAAAAUGGGAAGGUGACAAGAAGAUGUGGGGUUUGGCAGUCCCACCUAACCUA,32,22,29,21,104
7381,0,URS0000D69EE7_12908/1-104,UAGGUUAGAAGUUGAGAAGUAUUAAGUUACGCUGUCCCAACGCGCCAAGCCCAAAAUGGGAAGGUGACAAGAAGAUGUGGGGGGUGGCAGUCCCACCUAACCUA,32,20,31,21,104
7382,0,URS0000D6A08D_12908/1-101,UAGGUUAGAAGUUGAGAAGUAUUAAGUUACGCUGUCCCAACGCGCCAAGCCCUUAAGGGAAGGUGACAAGAGAUGUGGGGAGGGCUGUCCCACCUAACCUA,29,21,30,21,101
7383,0,URS0000D66E07_12908/1-110,UAAGUUAGAAGUUGAAAUAGUUGUUAUUAAUUAAUGAUGCGGUCCCAACGCAUCAAGCCCUAAUUGGGAGGUGAUAAGUGAUGUGGGGGGUGGCAGUCCCACCUAACCUA,32,30,30,18,110
7384,0,URS0000D66B0B_12908/1-111,UAAGUUAGAAGUUGAAAUAGUUGUUAUUAAUUAAUGAUGCGGUCCCAACGCAUCAAGCCCUAAUUGGGAGGUGAUAAGUGAUGUGGGGGGGUGGCAGUCCCACCUAACCUA,32,30,31,18,111
7385,0,URS0000D685FE_12908/1-109,UAAGUUAGAAGUUGAAAUAGUUGUUAUUAAUUAAUGAUGCGGUCCCAACGCAUCAAGCCCUAAUUGGGAGGUGAUAAGUGAUGUGGGGGUGGCAGUCCCACCUAACCUA,32,30,29,18,109
7386,0,URS0000D684F9_12908/1-110,UAAGUUAGAAGUUGAAAUAGUUGUUAUUAAUUAAUGAUGCGGUCCCAACGCAUCAAGCCCUAAUUGGGAGGUGAUAAGAGAUGUGGGGGGUGGCAGUCCCACCUAACCUA,33,29,30,18,110
7387,0,URS0000D6C9E0_12908/1-109,UAGGUUAGAAGUUGAAAUAGUCGUUAUUAUUUAAUGAUGCGGUCCCAACGCGCCAAGCCCUUAAGGGAAGGUGACAAGAGAUGUGGGGAGGGCUGUCCCACCUAACCUA,31,26,31,21,109
7388,0,URS0000D6A13E_12908/1-109,UAGGUUAGAAGUUGAAAUAGUCAUUAUUAUUUAAUGAUGCGGUCCCAACGCGCCAAGCCCGGAAGGGAAGGUGACAAGAGAUGUGGGGAGGGCUGUCCCACCUAACUUA,32,25,32,20,109
7389,0,URS0000D69382_12908/1-101,UAAGUUAGAGGUUGAAAAGUAUUAAGUUACGCUGUCUCAACACGCUAUACUCGAAAGAGAAGUAAAAAGAAAUGUGGGGGGUGGCAGUCCCACCUAACUUU,35,25,25,16,101
7390,0,URS0000D666F2_12908/1-99,UGUAUGUGAGGAUAGAAAGAUGGCUAUCGCGCACGAAAGUGUCAAGGGUAGGAAUGUAAAUUCUGAUGAGAUGUGGGAACUAUCGCCCCAUCAUAUACA,32,24,28,15,99
7391,0,URS0000D657A2_12908/1-98,AAUUGCUGAGGAUAGAAAGAUGGCUAUCGCGCACGAAAGUGUCAAGUGUAGGGUUAUAAACUCGAUGAGAUGUGGGAACAAUUGCCCCACCAGUUAAU,32,23,27,16,98
7392,0,URS0000D66B0E_12908/1-98,AAUUACUGAGGAUAGAAAGAUGGCUAUCGCGCACGAAAGUGUCAAGUGUAGGGUUAUAAACUCGAUGAGAUUUGGGAACAAUUGCCCCACCAGUUAAU,33,24,25,16,98
7393,0,URS0000D6C166_12908/1-98,AAUUACUGAGGAUAGAAAGAAGGCUAUUGCGCACGAAAGUGUCAAGUGUAGGGUUAUAAACUCGAUGAGAUGUGGGAACAAUUGCCCCACCAGUUAAU,34,23,26,15,98
7394,0,URS0000D67E76_12908/1-99,UGUACGUGAGGAUAGAAAGAUGGCUAUCGCGCAUGAAAAUGUCAAGGGUAGGGAUGUAAAUCCUGAUGAGAUGUGGGAACUAUCGCCCCACCACGUACA,31,21,29,18,99
7395,0,URS0000D65735_12908/1-90,GAAGAUAGAGGUUGAGAACCUGUCACCAACGCGGCAUCUCUUAUGAGAUGUGUCAGAAAUGUAGGAGACCCGACAGUCCUACCUAUCGUU,26,21,23,20,90
7396,0,URS0000D69D8C_637909/1-87,AAAGAUAGAGGUUGAGAAUCUGUCACCAACACGCCGCUUAGCUAGCGGGUCAGAAAUGCGGGAGCCUCGACAGUCCCGCCUAUCUUA,24,17,23,23,87
7397,0,URS0000D69D8C_12908/1-87,AAAGAUAGAGGUUGAGAAUCUGUCACCAACACGCCGCUUAGCUAGCGGGUCAGAAAUGCGGGAGCCUCGACAGUCCCGCCUAUCUUA,24,17,23,23,87
7398,0,URS0000D66230_12908/1-88,AAGGAUAGAGGUUGAGAAUCUGUCACCAACGCGCCAUUUAGCUAGUAGGUCGAGAAAUGCAGGAGCCUCGACAGUCCUGUCUAUCCUU,24,21,23,20,88
7399,0,URS0000D671B0_12908/1-88,AAGGAUAGAUGUUGAGAAUCUGUCACCAACGCGCCAUUUAGCUAGUGGGUCGAGAAAUGCAGGAGCCUCGACAGUCCUGCCUAUCCUU,23,21,23,21,88
7400,0,URS0000D6A9C7_1415764/1-86,AAAGAUAGAGGUUGAGAAUCUGUCACCAACGCGCCACUUAUAGUGGGUCGAGAAAUGCAGGAGCCCCGACAGUCCUGCCUAUCUUG,24,18,23,21,86
7401,0,URS0000D6A9C7_1415758/1-86,AAAGAUAGAGGUUGAGAAUCUGUCACCAACGCGCCACUUAUAGUGGGUCGAGAAAUGCAGGAGCCCCGACAGUCCUGCCUAUCUUG,24,18,23,21,86
7402,0,URS0000D6A9C7_1054460/1-86,AAAGAUAGAGGUUGAGAAUCUGUCACCAACGCGCCACUUAUAGUGGGUCGAGAAAUGCAGGAGCCCCGACAGUCCUGCCUAUCUUG,24,18,23,21,86
7403,0,URS0000D6A9C7_1315310/1-86,AAAGAUAGAGGUUGAGAAUCUGUCACCAACGCGCCACUUAUAGUGGGUCGAGAAAUGCAGGAGCCCCGACAGUCCUGCCUAUCUUG,24,18,23,21,86
7404,0,URS0000D6A9C7_889205/1-86,AAAGAUAGAGGUUGAGAAUCUGUCACCAACGCGCCACUUAUAGUGGGUCGAGAAAUGCAGGAGCCCCGACAGUCCUGCCUAUCUUG,24,18,23,21,86
7405,0,URS0000D6A9C7_1239791/1-86,AAAGAUAGAGGUUGAGAAUCUGUCACCAACGCGCCACUUAUAGUGGGUCGAGAAAUGCAGGAGCCCCGACAGUCCUGCCUAUCUUG,24,18,23,21,86
7406,0,URS0000D6A9C7_1415759/1-86,AAAGAUAGAGGUUGAGAAUCUGUCACCAACGCGCCACUUAUAGUGGGUCGAGAAAUGCAGGAGCCCCGACAGUCCUGCCUAUCUUG,24,18,23,21,86
7407,0,URS0000D6BED9_12908/1-86,AAGGAUAGAGGUUGAGAAUCUGUCACCAACGCGCCACUUAUAGUGGGUCGAGAAAUGCAGGAGCCCCGAUAGUCCUGCCUAUCCUU,23,19,23,21,86
7408,0,URS0000D6C324_12908/1-86,AAGGAUAGAGGUUGAGAAUCUGUCACCAACGCGCCACUUAUAGUGGGUCGGGAAAUGCAGGAGCCCCGACAGUCCUGCCUAUCCUU,22,18,24,22,86
7409,0,URS0000D66CC7_12908/1-86,AGGGAUAGAGGUUGAGAAUCUGUCACCAACGCGCCACUUAUAGUGGGUCGAGAAAUGCAGGAGCCCCGAAAGUCCUGCCUAUCCUU,23,18,24,21,86
7410,0,URS0000D68105_12908/1-86,AAGGAUAGAGGUUGAGAAUCUGUCACCAACGCGCCACUUAUAAUGGGUCGAGAAAUGCAGGAGCCCCGACAGUCCUGCCUAUCCUU,24,18,22,22,86
7411,0,URS0000D6B3FD_12908/1-87,AAGGAUAGAGGUUGAGAAUCUGUCACCAACGCGCCACUUAUAAGUGGGUCGAGAAAUGCAGGAGCCCCGACAGUCCUGCCUAUCCUU,24,18,23,22,87
7412,0,URS0000D670BE_1161421/1-88,AAGGAUAGAGGUUGAGAAUCUGUCACCAACGCGCCAUUUAGCUAGUGGGUCGAGAAAUGCAGGAGCCUCGACAGUCCUGUCUAUCCUU,23,21,24,20,88
7413,0,URS0000D670BE_12908/1-88,AAGGAUAGAGGUUGAGAAUCUGUCACCAACGCGCCAUUUAGCUAGUGGGUCGAGAAAUGCAGGAGCCUCGACAGUCCUGUCUAUCCUU,23,21,24,20,88
7414,0,URS0000D670BE_999424/1-88,AAGGAUAGAGGUUGAGAAUCUGUCACCAACGCGCCAUUUAGCUAGUGGGUCGAGAAAUGCAGGAGCCUCGACAGUCCUGUCUAUCCUU,23,21,24,20,88
7415,0,URS0000D670BE_864570/1-88,AAGGAUAGAGGUUGAGAAUCUGUCACCAACGCGCCAUUUAGCUAGUGGGUCGAGAAAUGCAGGAGCCUCGACAGUCCUGUCUAUCCUU,23,21,24,20,88
7416,0,URS0000D68B27_12908/1-88,AAGGGUAGAGGUUGAGAAUCUGUCACCAACGCGCCAUUUAGCUAGUGGGUCGAGAAAUGCAGGAACCUCGACAGUCCUGCCUAUCCUU,23,20,24,21,88
7417,0,URS0000D67EF7_12908/1-88,AAGGAUAGAGGUUGAGAAUCUGUCACCAACGCGCCAUUUAGCUAGUGGGUCGAGAAAUGCAGGAACCUCGACAGUCCUGCCUAUCCUU,24,20,23,21,88
7418,0,URS0000D6CBE5_12908/1-88,AAGGAUAGAGGUUGAGAAUCUGUCACCAACGCGCCAUUUAGCUAGUGGGUCGAGAAAUGCAGGAGCCUCGACAGUCCUGCCUAUCCUU,23,20,24,21,88
7419,0,URS0000D6D157_1315308/1-86,AAAGAUAGAGGUUGAGAAUCUGUCACCAACGCGCCAUUUAUAGUGGGUCGAGAAAUGCAGGAGCCCCGACAGUCCUGCCUAUCUUG,24,19,23,20,86
7420,0,URS0000D6595F_12908/1-86,AAGGAUAGAGGUUGAGAAUCUGUCACCAACGCGCCACUUAUAGUGGGUCAAGAAAUGCAGGAGCCCCGACAGUCCUGCCUAUCCUU,24,18,22,22,86
7421,0,URS0000D65FC0_585202/1-86,AAGGAUAGAGGUUGAGAAUCUGUCACCAACGCGCCACUUAUAGUGGGUCGAGAAAUGCAGGAGCUCCGACAGUCCUGCCUAUCCUU,23,19,23,21,86
7422,0,URS0000D65FC0_12908/1-86,AAGGAUAGAGGUUGAGAAUCUGUCACCAACGCGCCACUUAUAGUGGGUCGAGAAAUGCAGGAGCUCCGACAGUCCUGCCUAUCCUU,23,19,23,21,86
7423,0,URS0000D69ACA_12908/1-86,AAGGACAGAGGUUGAGAAUCUGUCACCAACGCGCCACUUAUAGUGGGUCGAGAAAUGCAGGAGCCCCGACAGUCCUGCCUAUCCUU,23,17,23,23,86
7424,0,URS0000D6A997_12908/1-86,GAGGAUAGAGGUUGAGAAUCUGUCACCAACGCGCCACUUAUAGUGGGUCGAGAAAUGCAGGAGCCCCGACAGUCCUGCCUAUCCUU,22,18,24,22,86
7425,0,URS0000D6AA45_12908/1-86,GAAGAUAGAGGUUGAGAAUCUGUCACCAACGCGCCACUUAUAGUGGGUCGAGAAAUGCAGGAGCCCCGACAGUCCUGCCUAUCCUU,23,18,23,22,86
7426,0,URS0000D66BD0_12908/1-86,AAAGAUAGAGGUUGAGAAUCUGUCACCAACGCGCCACUUAUAGUGGGUCGAGAAAUGCAGGAGCUCCGACAGUCCUGCCUAUCUGU,24,19,23,20,86
7427,0,URS0000D65E20_760779/1-86,AAAGAUAGAGGUUGAGAAUCUGUCACCAACGCGCCACUUAUAGUGGGUCGAGAAAUGCAGGAGCCCCGACAGUCCUGCCUAUCUGU,24,18,23,21,86
7428,0,URS0000D65E20_914148/1-86,AAAGAUAGAGGUUGAGAAUCUGUCACCAACGCGCCACUUAUAGUGGGUCGAGAAAUGCAGGAGCCCCGACAGUCCUGCCUAUCUGU,24,18,23,21,86
7429,0,URS0000D65E20_12908/1-86,AAAGAUAGAGGUUGAGAAUCUGUCACCAACGCGCCACUUAUAGUGGGUCGAGAAAUGCAGGAGCCCCGACAGUCCUGCCUAUCUGU,24,18,23,21,86
7430,0,URS0000D65E20_406562/1-86,AAAGAUAGAGGUUGAGAAUCUGUCACCAACGCGCCACUUAUAGUGGGUCGAGAAAUGCAGGAGCCCCGACAGUCCUGCCUAUCUGU,24,18,23,21,86
7431,0,URS0000D65E20_760764/1-86,AAAGAUAGAGGUUGAGAAUCUGUCACCAACGCGCCACUUAUAGUGGGUCGAGAAAUGCAGGAGCCCCGACAGUCCUGCCUAUCUGU,24,18,23,21,86
7432,0,URS0000D6597D_12908/1-86,AAAGAUAGAGGUUGAGAAUCUGUCACCAACGCGCCACUUAUAGUGGGUCGAGAAAUGCAGGAGCCCCGACAGUCCUGCCUAUCUUA,25,18,22,21,86
7433,0,URS0000D6AACD_12908/1-88,AAGGAUAGAGGUUGAGAAUCUGUCACCAACGCUCCAUUUAGCUAGUGGGUCGAGAAAUGCAGGAGCCUCGACAGUCCUGCCUAUCCUU,23,21,23,21,88
7434,0,URS0000D6C072_12908/1-86,AAGGAUAGAGGUUGAGAAUCUGUCACCAACGCGCCACUUAUAGUGGGUCGAGAAAUGCAGGAGCCCCAACAGUCCUGCCUAUCCUU,24,18,22,22,86
7435,0,URS0000D69497_12908/1-86,AAGGAUAGAGGUUGAGAAUCUGUCACCAACGCGCCACUUAUAGUGGGUCGAGAAAUGCAGGAGCCCCGACAGUCCUGCCUAUCCUU,23,18,23,22,86
7436,0,URS0000D69497_1239792/1-86,AAGGAUAGAGGUUGAGAAUCUGUCACCAACGCGCCACUUAUAGUGGGUCGAGAAAUGCAGGAGCCCCGACAGUCCUGCCUAUCCUU,23,18,23,22,86
7437,0,URS0000D69497_1340484/1-86,AAGGAUAGAGGUUGAGAAUCUGUCACCAACGCGCCACUUAUAGUGGGUCGAGAAAUGCAGGAGCCCCGACAGUCCUGCCUAUCCUU,23,18,23,22,86
7438,0,URS0000D699E5_12908/1-88,GAGGAUAGAGGUUGAGAAUCUGUCACCAACGCGCCACUUAGCUAGUGGGUCAAGAAAUGCAGGAGCCCCGACAGUCCUGCCUAUCCUU,23,18,24,23,88
7439,0,URS0000D695D6_12908/1-88,AAGGAUAGAGGUUGAAAAUCUGUCACCAACGCGCUACUUAGUUAGUGGAUCGAGAAAUGCAGGAGCCUCGACAGUCCUGCCUAUCCUU,25,21,22,20,88
7440,0,URS0000D6BF06_12908/1-93,GAGGAUAGAGGUUGAAAAGCAUCCGCCUCCAACGCGCCACUUAGCUAGUGGGUCGAGAAAUGCGGGCGACAUUCGGCGGUCCCGCCUAUUCUU,21,19,28,25,93
7441,0,URS0000D69800_12908/1-93,AAGGAUAGAGGUUGAAAAGCAUCCGCCUCCAACGCGCCACUUAGCUAGUGGGUCGAGAAAUGCGGGCGACAUUCGGCGGUCCCGCCUAUCCUU,22,18,27,26,93
7442,0,URS0000D6C40D_12908/1-93,GAGGAUAGAGGUUGAAAAGCAUCCGCCUCCAACGCGCCACUUAGCUAGUGGGUCGAGAAAUGCGGGCGACAUUCGGCGGUCCCGCCUAUCCUU,21,18,28,26,93
7443,0,URS0000D687BA_12908/1-93,GAGGAUAGAGGUUGAAAAGUAUCCGCCUCCAACGCGCCACUUAGCUAGUGGGUCGAGAAAUGCGGGCGACAUUCGGCGGUCCCGCCUAUCCUU,21,19,28,25,93
7444,0,URS0000D687BA_768726/1-93,GAGGAUAGAGGUUGAAAAGUAUCCGCCUCCAACGCGCCACUUAGCUAGUGGGUCGAGAAAUGCGGGCGACAUUCGGCGGUCCCGCCUAUCCUU,21,19,28,25,93
7445,0,URS0000D65DC5_12908/1-93,AAAGAUAGAGGUUGAAAAGUAUCCGCCUCCAACGCGCCACUUAGCUAGUGGGUCGAGAAAUGCGGGCGACAUUCGGCGGUCCCGCCUAUCUUG,23,19,27,24,93
7446,0,URS0000D6779B_12908/1-93,AAAGAUAGAGGUUGAAAAGUAUCCGCCUCCAACGCGCCACUUAGCUAGUGGGUCGAGAAAUGCGGGCGACAUCCGGCGGUCCCGCCUAUCUUG,23,18,27,25,93
7447,0,URS0000D6A4BE_12908/1-93,GAGGAUAGAGGUUGAAAAGUAUCCGCCUCCAACGCGCCACUUAGUUAGUGGGUCGAGAAAUGCGGGCGACAUUCGGCGGUCCCGCCUAUCCUU,21,20,28,24,93
7448,0,URS0000D6AE2F_12908/1-93,GAGGAUAGAGGUUGAAAAGCAUCCGCCUCCAACGCGCCACUUAGUUAGUGGGUCGAGAAAUGCGGGCGACAUUCGGCGGUCCCGCCUAUCCUU,21,19,28,25,93
7449,0,URS0000D6608E_12908/1-93,GAGGAUAGAGGUUGAAAAGUAUCCGCCUCCAACGCGCCACUUAGCUAGUGGGUCGAGAAAUGCGGGCGACAUCCGGCGGUCCCGCCUAUCCUU,21,18,28,26,93
7450,0,URS0000D68579_12908/1-93,AGAGAUAGAGGUUGAAAAGUAUCCGCCUCCAACGCGCCACUUAGCUAGUGGGUCGAGAAAUGCGGGCGACAUUCGGCGGUCCCGCCUAUCUUG,22,19,28,24,93
7451,0,URS0000D6A5CB_12908/1-93,AAGGAUAGAGGUUGAAAAGCAUCCGCCUCCAACGCGCCACUUAGUUAGUGGGUCGAGAAAUGCGGGCGACAUUCGGCGGUCCCGCCUAUCCUU,22,19,27,25,93
7452,0,URS0000D6A503_12908/1-93,AAGGAUAGAGGUUGAAAAGUAUCCGCCUCCAACGCGCCACUUAGCUAGUGGGUCGAGAAAUGCGGGCGACAUUCGGCGGUCCCGCCUAUCCUU,22,19,27,25,93
7453,0,URS0000D6AD92_12908/1-95,GAGGAUAGAGGUUGAAAAGUAUCCGCCUCCAACGCGCCACUUAGCUAGUGGGUCGAGAAAUGCGGGCGACAUUCGGCGGUCCCGCGCCUAUCCUU,21,19,29,26,95
7454,0,URS0000D66077_12908/1-90,GAGGAUAGAGGUUGAGAAUCUGUCACCAACGCGCCACUUAGCUAGUGGGUCGAGAAAUGCGAGCGACAUCUGGCGGUCCCGCCUAUCCUU,21,19,27,23,90
7455,0,URS0000D66077_997830/1-90,GAGGAUAGAGGUUGAGAAUCUGUCACCAACGCGCCACUUAGCUAGUGGGUCGAGAAAUGCGAGCGACAUCUGGCGGUCCCGCCUAUCCUU,21,19,27,23,90
7456,0,URS0000D68273_12908/1-96,AAGCUUAGAGGUUGAAAAGUAUCCGCCUCUUCCAACGCGCCACCGAAAUGGUGGGAACAGAAAUGCGGGCGACCAAAGGCGGUCCCGCCUAAGCUU,27,16,27,26,96
7457,0,URS0000D68898_12908/1-93,AAGCUUAGAGGUUGAAAAGUAUCCGUCUCCAACGCGCCACCGAAAUGGUGGGUCGAGAAAUGCGGGCGACAAAAGGCGGUCCCGCCUAAGCUU,26,16,28,23,93
7458,0,URS0000D69FB6_12908/1-93,AAGCUUAGAGGUUGAAAAGUAUCCGCCUCCAACGCGCCACCGAAAUGGUGGGUCCAGAAAUGCGGGCGACCAAAGGCGGUCCCGCCUAAGCUU,25,15,27,26,93
7459,0,URS0000D6D271_12908/1-93,AAGCUUAGAGGUUGAAAAGUAUCCGUCUCCAACGCGCCACCGAAAUGGUGGGUCCAGAAAUGCGGGCGACCAAAGGCGGUCCCGCCUAAGCUU,25,16,27,25,93
7460,0,URS0000D69D82_12908/1-93,AAGCUUAGAGGUUGAAAAGUAUCCGUCUCCAACGCGCCACCGAAAUGGUGGGUCGAGAAAUGCGGGCGACCAAAGGCGGUCCCGCCUAAGCUU,25,16,28,24,93
7461,0,URS0000D6587F_12908/1-93,AAGCUUAGAGGUUGAAAAGUAGCCGUCUCCAACGCGCCACCGAAAUGGUGGGUCCAGAAAUGCGGGCGACCAAAGGCGGUCCCGCCUAAGCUU,25,15,28,25,93
7462,0,URS0000D6C08B_12908/1-93,AAGCUUAGAGGUUGAAAAGUAGCCGUCUCCAACGCGCCACCGAAAUGGUGGGUCGAGAAAUGCGGGCGACCAAAGGCGGUCCCGCCUAAGCUU,25,15,29,24,93
7463,0,URS0000D6B1F0_12908/1-93,AAGCUUAAAGGUUGAAAAGUAGCCGUCUCCAACGCGCCACCGAAAUGGUGGGUCGAGAAAUGCGGGCGACCAAAGGCGGUCCCGCCUAAGCUU,26,15,28,24,93
7464,0,URS0000D675DA_12908/1-93,AAGCUUAGAGGUUGAAAAGUAUCCGCCUCCAACGCGCCACCGAAAUGGUGGGUCGAGAAAUGCGGGCGACCAAAGGCGGUCCCGCCUAAGCUU,25,15,28,25,93
7465,0,URS0000D6C12B_12908/1-93,AAGCUUAGAGGUUGAAAAGUAUCCGUCUCCAACGCGCCACCGAAAUGGUGGGUCGAGAAAUGCGGGCGACCAAAGGCGGUCCCGACUAAGCUU,26,16,28,23,93
7466,0,URS0000D65A38_12908/1-93,AAGCUUAGAGGUUGAAAAGUAUCCGUCUCCAACGCGCCACCGAAAUGGUGGGUCCAGAAAUGCGGUCGACCAAAGGCGGUCCCGCCUAAGCUU,25,17,26,25,93
7467,0,URS0000D67E25_12908/1-92,AAGCUUAGAGGUUGAAAAGUAUCCGUCUCCAACGCGCCACCGAAAUGGUGGGCCAGAAAUGCGGGCGACCAAAGGCGGUCCCGCCUAAGCUU,25,15,27,25,92
7468,0,URS0000D6B92D_12908/1-93,AAGCUUAGAGGUUGAAAAGUAUCCGACUCCAACGCGCCACCGAAAUGGUGGGCCCAGAAAUGCGGGCGACCAAAGGCGGUCCCGCCUAAGCUU,26,14,27,26,93
7469,0,URS0000D6842F_12908/1-93,GAGCUUAGAGGUUGAAAAGUAGCCGUCUCCAACGCGCCACCGAAAUGGUGGGUCCAGAAAUGCGGGCGACCAAAGGCGGUCCCGCCUAAGCUU,24,15,29,25,93
7470,0,URS0000D69E71_12908/1-93,AAGCUUAGAGGUUGAAAAGUAUCCGUCUCCAACGCGCCACCGAAAUGGUGGGUCGAGAAAUGCGGGCGACAUCAGCCGGUCCCACCUAAGCAU,26,16,26,25,93
7471,0,URS0000D694EC_12908/1-94,CGGUUUAGAGGUUGAAAAGUAUCCGGCUCCAACGCGCCACCGGUAUUGGUGGGUCGAGAAAUGUGGGCGACAUCCGCCGGUCCCACCUAAACUG,21,19,29,25,94
7472,0,URS0000D66F66_12908/1-91,CGGUUUAGAGGUUGAAAAGUAUUCCCGCUCCAACGCGCUGUCUUAAUGACAGGCCGAGAAAUGUGGGCGACCGCGGGUCCCACCUAAAUCG,22,19,26,24,91
7473,0,URS0000D6BBB6_12908/1-90,AAGCUUAGAGGUUGAAAAGUAUCCGCCUCCAACGCGCCGUCCUUGUGACGGGCCGAGAAAUGUGGGCGACCGCGGGUCCCGCCUAAGCUU,19,17,28,26,90
7474,0,URS0000D69A99_12908/1-90,AAGCUUAGAGGUUGAAAAGUAUCCCGCUCCAACGCGCCGUCCUUGUGACGGGCCGAGAAAUGUGGGCGACCGCGGGUCCCACCUAAGCUA,21,16,27,26,90
7475,0,URS0000D6BA10_12908/1-90,AAGCUUAGAGGUUGAAAAGUAUCCCGCUCCAACGCGCCGUCCUUGUGACGGGCCGAGAAAUGUGGGCGAUCGCGGGUCCCACCUAAGCUU,20,18,27,25,90
7476,0,URS0000D66FA0_12908/1-90,AAGCUUAGAGGUUGAAAAGUAUCCCGCUCCAACGCGCCGUCCUUGUGACGGGCCGAGAAAUGUGGGCGACCGCGGGUCCCGCCUAAGCUU,19,17,28,26,90
7477,0,URS0000D65B6D_12908/1-90,UAGCUUAGAGGUUGAAAAGUAUCCCGCUCCAACGCGCCGUCCUUGUGACGGGCCGAGAAAUGUGGGCGACCGCGGGUCCCGCCUAAGCUU,18,18,28,26,90
7478,0,URS0000D6695B_12908/1-90,CGGUUUAGAGGUUGAAAAGUAUCCCGCUCCAACGCGCCGUAUUUAUGACGGGCCGAGAAAUGUGGGCGACUGCGGGUCCCACCUAAACCG,21,18,27,24,90
7479,0,URS0000D6574A_12908/1-90,CGGUUUAGAGGUUGAAAAGUAUCCCGCUCCAACGCGCCGUAUUUAUGACGGGCCGAGAAAUGUGGGCGACUGCGGGUCCCACCUAAACUG,21,19,27,23,90
7480,0,URS0000D66964_12908/1-91,UGGUUUAGAGGUUGAAAAGUAUCCCGCUCCAACGCGCCACCAGUAAUGGUGGGCCGAGAAAUGUGGGCGACCGCGGGUCCCACCUAAGCUA,22,17,28,24,91
7481,0,URS0000D67DBC_12908/1-82,AGAUAUUGAGGUGGUAAACAGGUGCAACCACACACCAGAUUGGUUAAAAGAGAUCCGGGGAAUGCGCCACCCGGCAAUAUCA,28,14,22,18,82
7482,0,URS0000D6CE01_12908/1-82,AGAUAUUGAGGUGGUAAAGCGGUGCAACCACGCACCAGUUUGGUUAAAAGAGAUCCGGGGAAUGCGCCACCCGGCAAUAUCG,24,15,25,18,82
7483,0,URS0000D6CE95_12908/1-91,UGAGAAUGAGAAUAGAAAAGCGAAAGCAAGUGACACUAUCACACCCUUUGGGUCAAAAGAGAUGUUGGGAUAGUCGCACCAACCAUUCUCA,34,18,21,18,91
7484,0,URS0000D661F3_12908/1-91,UGAGAAUGAGGAUAGAAAAGCGAAAGCAAGUGACACUAUCACACCCUUUGGGUCAAAAGAGAUGUUGGGACAGUCACACCAGCCAUUCUCA,33,17,22,19,91
7485,0,URS0000D6BB7A_12908/1-91,UGAGAAUGAGGAUAGAAAAGCGAAAACAAGUGACACUAUCACACCCUUUGGGUCAAAAGAGAUGUUGGGACAGUCACACCAGCCAUUCUCA,34,17,21,19,91
7486,0,URS0000D6AFC5_12908/1-91,UAAGAAUGAGGAUAGAGAAGCGAAAGCAAGUGACACUAUCACACCUUUUGGGUCAAAAGAGAUGUUGGGACAGUCACACCAACCGUUCUUA,33,19,22,17,91
7487,0,URS0000D6BFF0_12908/1-91,UAAGAAUGAGGAUAGAGAAGCAAAAGCAAGUGACACUAUCACACCUUUUAGGUCAAAAGAGAUGUUGGGACAGUCACACCAACCGUUCUUA,35,19,20,17,91
7488,0,URS0000D6BFF0_1321779/1-91,UAAGAAUGAGGAUAGAGAAGCAAAAGCAAGUGACACUAUCACACCUUUUAGGUCAAAAGAGAUGUUGGGACAGUCACACCAACCGUUCUUA,35,19,20,17,91
7489,0,URS0000D6B664_12908/1-91,UAAGAAUGAGGAUAGAGAAGCGAAAGCAAGUGACACUAUCACACCUUUUAGGUCAAAAGAGAUGUUGGGACAGUCACACCAACCGUUCUUA,34,19,21,17,91
7490,0,URS0000D6864F_12908/1-91,UAAGAAUGAGGAUAGAGAAGCAAAAGCAAGUGACACUAUCACACCUUUUAGGUCAAAAGAGAUGUUGGGACAGUCACACCAGCCAUUCUCA,35,18,20,18,91
7491,0,URS0000D67F76_12908/1-84,GUAGCUUGAGGAUAGGGAGUUGGUGACGCUAUCACACCCUUUGGGUCAAAAGAGAUGCUGGGUCAGUCACACCAGCCAAGUUAC,22,19,25,18,84
7492,0,URS0000D6CE65_12908/1-84,GUAACUUGAGGAUAGGGAGUUGGUGACGCUAUCACACCCUUUGGGUCAAAAGAGAUGCUGGGUCAGUCACACCAGCCAAGUUAC,23,19,24,18,84
7493,0,URS0000D6997A_12908/1-95,CGCAACGAAGGGCAGAACAGGCAGCUGCCGCCCGAACGUGAGACCGCAAAUACUCAUGCUGUUGGAGAUGCCGGAGCGCCGACCGGCUCGUUGCG,22,12,32,29,95
7494,0,URS0000D68CD4_12908/1-95,CGCAACGAAGGGCAGAACAGGCAGCUGCCGCCCGGACGUGAGACCGCAAAUACUCAUGCUGUUGGAGAUGCCGGAGCGCCGACCGGCUCGUUGCG,21,12,33,29,95
7495,0,URS0000D65AB3_12908/1-95,UGCAACGGAGGGCAGAACAGGCAGCUGCCGCCUGAAAGCGAGAUCGCAAAUGCUCGCUGUGUUGGAGAUGCCGGAAUGCCGACCGGCUCGUUGCG,21,15,34,25,95
7496,0,URS0000D67E75_12908/1-95,CGCAACGGAGGGCAGAACAGGCAGCUGCCGCCAGAAAGCGAGAUCGCAAAUACUCGCGGUGUUGGAGAUGCCGGAAUGCCGACCGGCUCGUUGCA,24,12,33,26,95
7497,0,URS0000D6C48D_12908/1-95,CGCAGUGGAGGGCAGAAAGGCAAUCUGCCGCCCGGAAGCGAGACCGCAAAUACUCGCAUUGUUGGAGAUGCCGGAGCGCCGACCGGCUCACUGCG,22,12,33,28,95
7498,0,URS0000D6B643_12908/1-95,CGCAGUGGAGGGCAGAAAGGCAAUCUGCCGCCCGGAGGCGAGACCGCAAAUACUCGCAUUGUUGGAGAUGCCGGAGCGCCGACCGGCUCACUGCG,21,12,34,28,95
7499,0,URS0000D6CC2D_12908/1-79,UAAUAUAGAGGAUAGAACAGGUAGCUAUCACCACACAGAAAUGUGUUAGGAGAUGUGGAAUGACCGACCACCUAUAUUA,30,18,18,13,79
7500,0,URS0000D69434_12908/1-81,ACUGCGCGAAGUAGAGAAUCUGCCGUCUACGCCCCCUUGCGGGCAAAAGAAAUGUGGAAGUUGGCAGUCCCACCGCGCAGU,20,14,24,23,81
7501,0,URS0000D6CD79_12908/1-106,GCUGCUUGAAGUAGCGAAUCUGCCGUCUACACGCUGGUCGGGCGCAAGACCAAGUGUGCUCAACCGGCUAAAAGAGAUGCGGGACUUGGCAGACCCGCCGUGUGGC,23,19,35,29,106
7502,0,URS0000D6BDA4_12908/1-69,GGCUAUUGAGGAUAGAACAGGUAUCUAUCGCCUUUAAUUGGAGAUGUGGGUUACCAACCACCAAUAGCC,20,18,17,14,69
7503,0,URS0000D673D0_12908/1-84,AGAUUUUGAGGUGGAAAAGAUUUCCCAUGCGCUUACUUUUAGUAAAUUAUCAGAAAUGCAGGAUACGCUGACCUGCAAAAGUAU,28,25,18,13,84
7504,0,URS0000D66A3E_12908/1-78,CGGACUAGAGGAUAGAACAGGUAGCUAUCGCACUGGAGACAUCCGGUGAGAUGCGGGAGUACCACCCCGCCUAGUCGA,21,12,25,20,78
7505,0,URS0000D6B3F3_12908/1-92,GGGCUUUGAGGUGGAAAAAGCGUUCCCAUACGCCACACGCCUUCGGGUAGUGGGCAAAAGAGAUGCCGGGAGUGACGCUCCGGCCAAAGUCC,22,15,31,24,92
7506,0,URS0000D6BDC5_12908/1-92,GGGCUUUGAGGUGGAAAAAGCGUUCCCAUACGCCACACGCCUUUUGGUAGUGGGCAAAAGAGAUGCCGGGAGUGACGCUCCGGCCAAAGUCC,22,17,30,23,92
7507,0,URS0000D6B2B8_12908/1-92,GGGCUUUGAGGUGGAAAAAGCGUUCCCAUACGCCACACGCCUUCGGGUAGUGGGCAAAAGAGAUGCCGGGAGUGACGCUCCGGCCGAAGUCC,21,15,32,24,92
7508,0,URS0000D67B0D_12908/1-92,AGGCUUUGAGGUGGAAAAAGCGUUCCCAUACGCCACACGCCUUUGGGUAGUGGGCAAAAGAGAUGCUGGGAGUAACGCUCCGGCCAAAGUCC,24,17,29,22,92
7509,0,URS0000D669EE_12908/1-92,GGGCUUUGAGGUGGAAAAAGCGUUCCCAUACGCCACACGCCUUUUGGUAGUGGGCAAAAGGGAUGCCGGGAGUGACGCUCCGGCCAAAGUCC,21,17,31,23,92
7510,0,URS0000D68D34_12908/1-92,GGCUUUUGAGGUGGAAAAAGCGUUCCCAUACGCCACACGCCUUUUGGUAGUGGGCAAAAGAGAUGCCGGGAGUGACGCUCCGGCCAAAGUCC,22,18,29,23,92
7511,0,URS0000D6B61C_12908/1-91,AUUCUUUGAGGUGAAAAAAGCGUAGUCAUACACCGCAUGCCAUUUGGCAAUGGGUAAAAGAGAUGUUGGAGUGACGCACCAACCAAGGAAU,31,20,24,16,91
7512,0,URS0000D6D1A7_12908/1-91,AGUCUUCGAGGUGAAAAGUGCGUCGUCAUACGCCACAUGCCUUUGGCAAUGGGCAAAAGAGAUGCUGGGAGUGACGCUCCAGCCGAGGGCU,22,18,30,21,91
7513,0,URS0000D6C55A_12908/1-91,GGUCUUCGAGGUGAAAAAUGCGUCGUCAUGCGCCACAUGCUUUAUGCAAUGGGCAAAAGAGAUGCUGGGAGUGACGCUCCGGCCGAAGGCU,22,19,30,20,91
7514,0,URS0000D6A0D0_12908/1-91,GGUCUUCGAGGUGAAAAAUGCGUCGUCAUGCGCCACAUGCUUUAUGCAAUGGGCAAAAGAGAUGCUGGGAGUGACGCUCCAGCCGAAGGCU,23,19,29,20,91
7515,0,URS0000D675A7_12908/1-91,GAUCUUCGAGGUGAAAAAAGCGUCUUCAUGCGCCGCAUGCCUUGUGCAAUGGGCAAAAGAGAUGUCGGGAGUGACGCUCCGGCCGAAGAUU,23,19,29,20,91
7516,0,URS0000D68658_12908/1-91,GAUCUUCGAGGUGAAAAAAGCGUCUUCAUGCGCCACAUGCCUUGUGCAAUGGGCAAAAGAGAUGUCGGGAGUGACGCUCCGGCCGAAGAUU,24,19,28,20,91
7517,0,URS0000D66CD9_1262824/1-91,UAUCUUCGAGGUGAAAAAAGCGUCUUCAUGCGCCGCAUGCCUUGUGCAAUGGGCAAAAGAGAUGUCGGGAGUGACGCUCCGGCCGAAGAUU,23,20,28,20,91
7518,0,URS0000D6BA71_12908/1-91,GAUCUUCGAGAUGAAAAAAGCGUCUUCAUGCGCCGCAUGCCUUGUGCAAUGGGCAAAAGAGAUGUCGGGAGUGACGCUCCGGCCGAAGAUU,24,19,28,20,91
7519,0,URS0000D69819_12908/1-91,AAUCUUUGAGGUGAAAAAUGCGUCGUCAUGCGCCGCAUGCAAAUUGCAAUGGGCAAAAGAGAUGUUGGGAGUGACGCUCCAACCAAAGAUU,29,20,25,17,91
7520,0,URS0000D69819_1262988/1-91,AAUCUUUGAGGUGAAAAAUGCGUCGUCAUGCGCCGCAUGCAAAUUGCAAUGGGCAAAAGAGAUGUUGGGAGUGACGCUCCAACCAAAGAUU,29,20,25,17,91
7521,0,URS0000D67F8B_12908/1-91,AAUCUUUGAGGUGAAAAAUGCGUCGUCAUGCGCCACAUGCAAAUUGCAAUGGGCAAAAGAGAUGUUGGGAGUGACGCUCCAACCAAAGAUU,30,20,24,17,91
7522,0,URS0000D66C85_12908/1-91,AUUCUUUGAGGUGAAAAAAGCGUAGUCAUGCACCACAUGCCGUUGGCAAUGGGUAAAAGAGAUGUUGGGAGUGACGCACCAACCAAAGAAU,31,19,25,16,91
7523,0,URS0000D6CD91_12908/1-91,GUCUUUCGAGGUGAAAAUUGCGUCCUCACGCGCCGCGUGCUGUGUGCAACGGGCAAAAGAGAUACCGGGGGUGACGCGCCGGUCGAAAGAG,20,16,33,22,91
7524,0,URS0000D67742_12908/1-91,GUCUUUCGAGGUGAAAAUUGCGUCCUCACGCGCCGCGUGCUUCGUGCAACGGGCAAAAGAGAUACCGGGGGUGACGCGCCGGUCGAAAGAG,20,16,32,23,91
7525,0,URS0000D6BDE6_12908/1-91,GUCUUUCGAGGUGAAAAUUGCGUCCUCACGCGCCGCGUGCUUCAUGCAACAGGCAAAAGAGAUACCGGGGGUGACGCGCCGGUCGAAAGAG,22,16,30,23,91
7526,0,URS0000D6CC0D_12908/1-91,GUCUUUCGAGGUGAAAAUUGCGUCCUCACGCGCCGCGUGCUGUCUGCAACGGGCAAAAGAGAUACCGGGGGUGACGCGCCGGUCGAAAGAG,20,16,32,23,91
7527,0,URS0000D688FC_12908/1-91,GGCUUUUGAGGUGAAAACAGCGUCCUCACGCGCCGCAUGCUUCAUGCAAUGGGCAAAAGAGAUGUCGGAUGUGACGCUCCGACCAAAAGCA,25,17,26,23,91
7528,0,URS0000D6C1B9_12908/1-91,GGCUUUCGAGGUGAAAAUAGCGUCCUCACGCGCCGCAUGCUUCGUGCAAUGGGCAAAAGAGAUGUCGGGUGUGACGCUCCGACCGAAAGUG,21,18,30,22,91
7529,0,URS0000D6806D_12908/1-91,GGCUUUCGAGGUGAAAAUAGCGUCCUCACGCGCCGCAUGCUUCGCGCAAUGGGCAAAAGAGAUGUCGGGUGUGACGCUCCGACCGAAAGUA,22,17,29,23,91
7530,0,URS0000D6AE5A_12908/1-91,GGCUUUUGAGGUGAAAACAGCGUCCUCACGCGCCGCAUGCUUCAUGCAAUGGGCAAAAGAGAUGUCGGGUGUGACGCUCCGACCAAAAGCA,24,17,27,23,91
7531,0,URS0000D6D2A0_12908/1-91,GGCUUUUGAGGUGAAAACAGCGUCCUCACGCGCCGCAUGCUUUAUGCAAUGGGCAAAAGAGAUGUCGGGUGUGACGCUCCGACCAAAAGCA,24,18,27,22,91
7532,0,URS0000D6A89D_12908/1-91,GGCUUUUGAGGUGAAAACAGCGUCCUCACGCGCCGCAUGCUUUAGGCAAUGGGCAAAAGAGAUGUCGGAUGUGACGCUCCGACCAAAAGCA,25,17,27,22,91
7533,0,URS0000D68520_12908/1-91,UGCUUUUGAGGUGAAAAAAGCGUCCUCACGCGCCGCAUGCUUUAUGCAAUGGGCAAAAGAGAUGUCGGGUGUGACGCUCCGACCAAAAGCA,25,19,26,21,91
7534,0,URS0000D683FF_936381/1-90,UGCUUUUGAGGUGAAAAAAGCGUCCUCACGCGCCGCAUGCUUCGGCAAUGGGCAAAAGAGAUGUCGGGUGUGACGCUCCGACCGAAAGCG,22,17,29,22,90
7535,0,URS0000D6A5FA_12908/1-90,GGCUUUUGAGGUGAAAAAAGCGUCCUCACGCGCCGCAUGCUUCGGCAAUGGGCAAAAGAGAUGUCGGGUGUGACGCUCCGACCGAAGGCG,21,16,31,22,90
7536,0,URS0000D6673B_12908/1-91,GGCUUUUGAGGUGAAAAAAGCGUCCUCACGCGCCGCAUGCUUUAUGCAAUGGGCAAAAGAGAUGUCGGGUGUGACGCUCCGACCAAAAGCA,25,18,27,21,91
7537,0,URS0000D669DA_12908/1-91,GGCUUUUGAGGUGAAAACAGCGUCCUCACGCGCCGCAUGCUUUAUGCAAUGGGCAAAAGAGAUGUCGGAUGUGACGCUCCGACCAAAAGCA,25,18,26,22,91
7538,0,URS0000D66A39_12908/1-82,UAAAGAUGAGGAUAGAGAAUGUGUCACUAUCGCCCCUUGUAAAAGGUAGGAGAUGUGGGAAAUGGCAGACCCACCGUUUUUU,25,21,23,13,82
7539,0,URS0000D66BD4_12908/1-85,UAAAAAUGAGGAUAGAGAAUGUGCCGCUAUCGCCCCUUUUAAAAAAGGUAUGGAGAUGUGGGAAAAGGCAGACCCACCGUUUUUU,28,21,22,14,85
7540,0,URS0000D65E7C_12908/1-86,UAAAAAUGAGGAUAGUGAAUGUGCCGCUAUCUCCCCUUUUAUAAAAAGGUAUGGAGAAGUGGGAAACGGCAGACCCACCAUUUUUU,28,23,20,15,86
7541,0,URS0000D65D4D_12908/1-79,AUAUGUUGAGGUGAGAAACGGCUCUCACACACCCUAUGGGUCAAAAGAGAUGUAGGUACCGCUGGACCUACCAACAUAU,25,17,19,18,79
7542,0,URS0000D68A09_12908/1-79,AUAUAUUGAGGUGAGCAACAGUUCUCACGCACCUUAUGGGUUAAAAGAGAUGUAGGUACAGCUGGACCUACCAAUAUAU,26,21,18,14,79
7543,0,URS0000D6AA66_12908/1-86,AAUAAAUAAGGACGGAACAGGCGGCUGUCGCCAGAAAACUAUAUGGUUUGAUUAGGAGAUGUUGGAUCGCCACCCAGCUAUUUAUU,27,22,22,15,86
7544,0,URS0000D692A3_12908/1-72,UAUUAUAGAAGAUAGAAAUAGUAGCUAUCGCCAUAAUUUAGGAAAUGUAGGGGUACUGUCCUACCUAUAAUA,27,22,14,9,72
7545,0,URS0000D6B6AC_12908/1-72,UAUUAUAGAAGAUAGAAAUAGUAGCUAUCGCCAUAAUUUAGGAAAUGUAGGGGUGCUGUCCUACCUAUAAUA,26,22,15,9,72
7546,0,URS0000D664DB_12908/1-87,AAAAGUAGCGAAUAGAACAGGCGGCUAUCACUCCUGACUAAUAUCAGAUCUUAUAAGAGAGGUGGGAUUGCCACCCCGCCUACUUUC,27,20,19,21,87
7547,0,URS0000D6ACB7_12908/1-84,GUUAUCUGAGGUGAAGAUUUCGUCCGUGUCACACACCCUAUGGGUUAAAAGAUAUGCGGGAGGUUCGGACGCCCGCCAGAUAAC,21,20,24,19,84
7548,0,URS0000D668C0_1074134/1-82,AACAUCUGAGGACAGGAAGGUUUCUGACGCACCCUAAGUUUGAGGUAACUGAGAUGACGUAGUUACUGACCGUCAAGAUGUU,24,21,22,15,82
7549,0,URS0000D668C0_1074149/1-82,AACAUCUGAGGACAGGAAGGUUUCUGACGCACCCUAAGUUUGAGGUAACUGAGAUGACGUAGUUACUGACCGUCAAGAUGUU,24,21,22,15,82
7550,0,URS0000D668C0_1074154/1-82,AACAUCUGAGGACAGGAAGGUUUCUGACGCACCCUAAGUUUGAGGUAACUGAGAUGACGUAGUUACUGACCGUCAAGAUGUU,24,21,22,15,82
7551,0,URS0000D668C0_1074165/1-82,AACAUCUGAGGACAGGAAGGUUUCUGACGCACCCUAAGUUUGAGGUAACUGAGAUGACGUAGUUACUGACCGUCAAGAUGUU,24,21,22,15,82
7552,0,URS0000D668C0_857146/1-82,AACAUCUGAGGACAGGAAGGUUUCUGACGCACCCUAAGUUUGAGGUAACUGAGAUGACGUAGUUACUGACCGUCAAGAUGUU,24,21,22,15,82
7553,0,URS0000D668C0_857134/1-82,AACAUCUGAGGACAGGAAGGUUUCUGACGCACCCUAAGUUUGAGGUAACUGAGAUGACGUAGUUACUGACCGUCAAGAUGUU,24,21,22,15,82
7554,0,URS0000D668C0_12908/1-82,AACAUCUGAGGACAGGAAGGUUUCUGACGCACCCUAAGUUUGAGGUAACUGAGAUGACGUAGUUACUGACCGUCAAGAUGUU,24,21,22,15,82
7555,0,URS0000D668C0_511691/1-82,AACAUCUGAGGACAGGAAGGUUUCUGACGCACCCUAAGUUUGAGGUAACUGAGAUGACGUAGUUACUGACCGUCAAGAUGUU,24,21,22,15,82
7556,0,URS0000D668C0_1074121/1-82,AACAUCUGAGGACAGGAAGGUUUCUGACGCACCCUAAGUUUGAGGUAACUGAGAUGACGUAGUUACUGACCGUCAAGAUGUU,24,21,22,15,82
7557,0,URS0000D668C0_1074146/1-82,AACAUCUGAGGACAGGAAGGUUUCUGACGCACCCUAAGUUUGAGGUAACUGAGAUGACGUAGUUACUGACCGUCAAGAUGUU,24,21,22,15,82
7558,0,URS0000D668C0_1074153/1-82,AACAUCUGAGGACAGGAAGGUUUCUGACGCACCCUAAGUUUGAGGUAACUGAGAUGACGUAGUUACUGACCGUCAAGAUGUU,24,21,22,15,82
7559,0,URS0000D668C0_1074160/1-82,AACAUCUGAGGACAGGAAGGUUUCUGACGCACCCUAAGUUUGAGGUAACUGAGAUGACGUAGUUACUGACCGUCAAGAUGUU,24,21,22,15,82
7560,0,URS0000D668C0_1074101/1-82,AACAUCUGAGGACAGGAAGGUUUCUGACGCACCCUAAGUUUGAGGUAACUGAGAUGACGUAGUUACUGACCGUCAAGAUGUU,24,21,22,15,82
7561,0,URS0000D668C0_857144/1-82,AACAUCUGAGGACAGGAAGGUUUCUGACGCACCCUAAGUUUGAGGUAACUGAGAUGACGUAGUUACUGACCGUCAAGAUGUU,24,21,22,15,82
7562,0,URS0000D668C0_1074114/1-82,AACAUCUGAGGACAGGAAGGUUUCUGACGCACCCUAAGUUUGAGGUAACUGAGAUGACGUAGUUACUGACCGUCAAGAUGUU,24,21,22,15,82
7563,0,URS0000D66269_857145/1-82,AACAUCUGAGGACAGGAAGGUUUCUGACGUACCCUAAAUUUGAGGUAACUGAGAUGACGUAGUUACUGACCGUCAAGAUGUU,25,22,21,14,82
7564,0,URS0000D66269_857108/1-82,AACAUCUGAGGACAGGAAGGUUUCUGACGUACCCUAAAUUUGAGGUAACUGAGAUGACGUAGUUACUGACCGUCAAGAUGUU,25,22,21,14,82
7565,0,URS0000D66269_1074120/1-82,AACAUCUGAGGACAGGAAGGUUUCUGACGUACCCUAAAUUUGAGGUAACUGAGAUGACGUAGUUACUGACCGUCAAGAUGUU,25,22,21,14,82
7566,0,URS0000D66269_1074151/1-82,AACAUCUGAGGACAGGAAGGUUUCUGACGUACCCUAAAUUUGAGGUAACUGAGAUGACGUAGUUACUGACCGUCAAGAUGUU,25,22,21,14,82
7567,0,URS0000D66269_1074173/1-82,AACAUCUGAGGACAGGAAGGUUUCUGACGUACCCUAAAUUUGAGGUAACUGAGAUGACGUAGUUACUGACCGUCAAGAUGUU,25,22,21,14,82
7568,0,URS0000D66269_857155/1-82,AACAUCUGAGGACAGGAAGGUUUCUGACGUACCCUAAAUUUGAGGUAACUGAGAUGACGUAGUUACUGACCGUCAAGAUGUU,25,22,21,14,82
7569,0,URS0000D66269_1074177/1-82,AACAUCUGAGGACAGGAAGGUUUCUGACGUACCCUAAAUUUGAGGUAACUGAGAUGACGUAGUUACUGACCGUCAAGAUGUU,25,22,21,14,82
7570,0,URS0000D66269_857103/1-82,AACAUCUGAGGACAGGAAGGUUUCUGACGUACCCUAAAUUUGAGGUAACUGAGAUGACGUAGUUACUGACCGUCAAGAUGUU,25,22,21,14,82
7571,0,URS0000D66269_12908/1-82,AACAUCUGAGGACAGGAAGGUUUCUGACGUACCCUAAAUUUGAGGUAACUGAGAUGACGUAGUUACUGACCGUCAAGAUGUU,25,22,21,14,82
7572,0,URS0000D69EF8_1074169/1-82,AACAUCUGAGGACAGGAAGGUUUCUGACCCACCCUAAGUUUGAGGUAACUGAGAUGACGUAGUUACUGACCGUCAAGAUGUU,24,21,21,16,82
7573,0,URS0000D68722_1074113/1-82,AACAUCUGAGGAUAGGAAGGUUUCUGACGCACCCUAAGUUUGAGGUAACUGAGAUGACGUAGUUACUGACCGUCAAGAUGUU,24,22,22,14,82
7574,0,URS0000D67CE2_12908/1-79,GAGUCAUGAGGUGGACAACAGCUUCCACGCACCCUUUGGGUUAAAAGAGAUGCGAGAACAGCUGGCCUCGCCAUGACUC,21,15,22,21,79
7575,0,URS0000D690E4_12908/1-91,GACAUUCGAGGUGGUAAAUUUCGUACAAACCACACACCGAAGGCAGGCAAAAGCCGAGAGAUGCGGGAGAACUGUACGCCCGCCGAAUGUA,30,13,26,22,91
7576,0,URS0000D6B06C_12908/1-84,AUUAUCCGAGGUGGGAAAGUUCGUUGCACCCACACGCCUUAAUGGUUAAAAGAGAUGUAACAGAAGCGACGGUUACUGGAUAGA,27,19,23,15,84
7577,0,URS0000D6C395_12908/1-80,GUUACUAGAGGUAGAGAGCGUCCCUCUACGCGCCCUAGUGGUCAAAAGAGAUGUGGGAAAGGGGACACCCACCUAGUAAC,23,14,24,19,80
7578,0,URS0000D6A915_12908/1-80,AUUAAAUGAGGUGGACAAUGGCAUCCACGCACCUAUAUUGGUUAAAAGAGAUGAAAGUACAGCCAGACUUUCCAUUUAAU,29,21,16,14,80
7579,0,URS0000D65DD1_12908/1-85,AUUGCCCGAGGUGGGAAAAUACGUUGCACCCACACACCCUAUGGGUUAAAAGAGAUCCUGCAGAAUGCGACGGCAGGCGGGCAUU,24,15,25,21,85
7580,0,URS0000D676C1_12908/1-85,AAUGCCGGAGGUGGGAAAAUUCGUUGCACCCACACACCUUAUGGGUUAAAAGAGAUGCAGUAGAAAGCGACGGCUGCCCGGCAUU,25,16,25,19,85
7581,0,URS0000D6CE31_12908/1-85,AAUGCCGGAGGUGGGAAACUGCGUUGCACCCACGCACCCUAUGGGUUAAAAGAGAUGUAGUAGAUAGCGACGGAUACCCGGCAUA,25,15,26,19,85
7582,0,URS0000D6CD1A_12908/1-85,UUUGCCGGAGGUGGGAAAAUUCGUUGCACCCACGCACCCUAUGGGUUAAAGGAGAUGGAGCAGAUUGCGACGGCUUCCCGGCAGA,20,17,28,20,85
7583,0,URS0000D6B09B_12908/1-98,CAUGCCGGAGGUGGGAAAUUGUGUUGCACCCACGCACCUUGCGUACAUGACGUAACGGUUAAAAGAGAUGGAGCAGAUUGCAACGGCUCCCCGGCAUA,26,19,29,24,98
7584,0,URS0000D6D43D_12908/1-85,UAUGCCAGAGGUGGGAAAAUGCGUUGCACCCAUGCGCCGAAUUGGCUAAAAGAGAUGCUGCAGAUUGCGACGGCAGCCUGGCAAA,24,15,27,19,85
7585,0,URS0000D66307_12908/1-84,GGAGACUGAAGUAGAGAACGUGCUUCUACACGCCGCGUGAGUGGUAGACAAGAAAUGCGGGAAAGGGCACACCCGCCGGUUUCC,23,13,28,20,84
7586,0,URS0000D6C08D_12908/1-95,ACUCUUUGAGGUGGUAAAUUUCGUGUCGACCACACGCCGCCGGUAGGACAGGGGCAACCCGAGAGAUGCAGGAGCAGGCACGCCUGCCAAAGAGU,24,15,31,25,95
7587,0,URS0000D6B7C7_12908/1-94,GCGCUUUGAGGUGGAAAUUUUGUGUCGCCAUACGCCGCAUGCCUUUGGGCAAUGGGCAAAAGAGAUGCAGGGCCAGGCACGCCUGCCAAAGCAC,22,18,30,24,94
7588,0,URS0000D66F0F_12908/1-95,AUUAUUUGAGGUGGAAAUUUCGUGUCGCCACGCGCCACAUGCUUUCGGGCAAUGGGCAAAAGAAAUGCAGGGGAAUGGCACGCCUGCCAAAUAAC,27,20,27,21,95
7589,0,URS0000D67988_12908/1-95,AUUAUUUGAGGUGGAAAUUUUGUGUCGCCACGCGCCACAUGCUUUCGGGCAAUGGGCAAAAGAAAUGCAGGGGAAUGGCACGCCUGCCAAAUAAC,27,21,27,20,95
7590,0,URS0000D667C0_12908/1-85,UGGCUCUGAGGUGGAGAUUAUGUCCCGACCACGCGCCCUUGUGGCUAAAAGAGAUGCAGGAUUAUAGGGACGCCUGCCAGAGCCA,20,17,27,21,85
7591,0,URS0000D6C911_1262756/1-85,AUUAUUUGAGGUGGUAAAAUUCGUUGCCAACCACGAACCCUAUGGGUUAAAAAAGACGCAGGAGUCGCGAUGCCUGCCAAAUAAU,28,20,20,17,85
7592,0,URS0000D6C911_12908/1-85,AUUAUUUGAGGUGGUAAAAUUCGUUGCCAACCACGAACCCUAUGGGUUAAAAAAGACGCAGGAGUCGCGAUGCCUGCCAAAUAAU,28,20,20,17,85
7593,0,URS0000D65D4F_657324/1-100,GAUUUUGGAGGUAGAAGAAUUCGUCCACGUCUACACGCCGAUGGUUUGACAGGAGAUAACUCCGAGAGAUGCGGGAGGUAUUGGACGCCCGCCCAAAAUC,27,21,30,22,100
7594,0,URS0000D69EAC_12908/1-84,GGCCCUUGAAGUGGAGAUUUCGUGUCAUCCAUACGCCCACGUGGUCAAAAGAGAUGCAGGGGAACGGCACGCCUGCCAAGGGCU,20,15,27,22,84
7595,0,URS0000D68D64_12908/1-85,GGUCUUCGAGGUGGUAGAUUUCGUGUCAACCACACGCCCCCGUGGCUAAAAGAGAUGCAGGGGAACGGCACGCCUGCCGAAGACC,20,14,27,24,85
7596,0,URS0000D6C56C_12908/1-85,GGAAUUUGAGGUGGACGAUUUUGCCUUCCACACACCUAGCAAUAGGUUUAAGAGAUGCAGGGACUUGGCAGACCUGCCAAAUUCC,23,21,22,19,85
7597,0,URS0000D67BC5_12908/1-85,GGCUCCUGAGGUGGUCAAUUUCGUAGCUACCACGCACCCUAUGGGUUAAAAGAGAUGCAGGGGAACGCCACGCCUGCCAGGAGCC,20,15,26,24,85
7598,0,URS0000D67CBB_12908/1-96,GACAUCUGAGGUGGUAAAUUUCGUGUCGACCACACGCUGAUGGCAUGACAGGGGAAACCCGAGAGAUGCAGGGGCAUGGCACGCCUGCCGGAUGUU,23,18,33,22,96
7599,0,URS0000D65C01_12908/1-90,GUAUUUUGAGGUGGUAAAUUUCGUGGAAACCACACACCAGUAAAAGCUGGUCAAAAGAGAUGUAGGAGAACGCCACGCCUACCAUAAUAC,32,19,21,18,90
7600,0,URS0000D6C0D4_12908/1-78,GGUACUAAAAGUAGAGAAUGUGCUGCUACGCACCCUAUGGGUCAAAAGAAAUGCUGGAUUGGCACACAGCUUAGUACC,25,17,20,16,78
7601,0,URS0000D67843_12908/1-86,GUCGCCCGAGGUGGUAAAUUUCGCAGCGACCACACGCCCUUGAGGUAAAAAAGAGAUGCAGGAGGAUGCUGCGCCUGCCGGGCGGC,20,13,30,23,86
7602,0,URS0000D69422_12908/1-78,UGGUUUAGAAGUAGAGAAUGUGCUGCUACGCACCCUUUGGGUCAAAAGAAAUGUGGAAUUGACACACCACCGUAACCA,25,18,19,16,78
7603,0,URS0000D67A22_12908/1-78,UGGUUUAGAAGUAGAGAAUGUGCUGCUACGCACCCUUUGGGUCAAAAGAAAUGUGGAAUUGGCGCACCACCGUAACCA,23,18,21,16,78
7604,0,URS0000D67A88_12908/1-106,ACUAUUUGAGGUGGAAAAUUUUGUUGCCUUCCACACGCCGAUGGUAUGACAAAGGCGGCAUUGCCGCUUUGAGAGAUGCAGGAGAAGUGUACGCCUGCCGAACAGC,27,25,31,23,106
7605,0,URS0000D66E9C_12908/1-99,GUUAUUCGAGGUGGAAGAUUUCGUCCCCGUCCACGCUCCGAUGGCUUGACAAAGGGAAACCUUGAGAGAUGCAGGAGAAUGGGACGCCUACCGAAUAAC,27,20,29,23,99
7606,0,URS0000D6A13A_12908/1-80,AAAUUAUGAGGUAGAGAAUGUGCUUCCGCGCACCCGUGUGGUCAAGAGAAAUGUGGGACACGGCACACCCACCAUAAUUU,24,17,21,18,80
7607,0,URS0000D66AB7_12908/1-97,GGGCUUUGAGGUGGUAAAAUUCGUUGCGACCACACGCCGAUGGUAUGACAGGGGGAAACCCCGAGAGAUGCGGGAGAUGCGACGCCCGCCAAAGCCC,24,14,34,25,97
7608,0,URS0000D67D9F_12908/1-98,GUUAUUUGAGGUGGACAAUUUCGUGGCAUCCACACGCCGACGGUAUGACAGAAGGAAACUUCGAGAGAUGCAGGAGUAAGCCACGCCUGCCAAAUAAC,30,19,27,22,98
7609,0,URS0000D698A9_12908/1-99,GUUAUUCGAGGUGGAAAAUUUCGUCCCCGUCCACACGCCGAUAGCUUGACAAAGGGAAACCUUGAGAAAUGCAGGAGAGUUGUACGCCUGCCGAAUAAC,29,21,26,23,99
7610,0,URS0000D66444_12908/1-85,UCUGUCUGAGGUGGUGGAUUUCGUAGCAACCACACGCCAUAUUGGCCAAAAGAGACGCAGGAGAAUGCUACGCCUGCCGGGCAGG,21,16,27,21,85
7611,0,URS0000D6C8C4_12908/1-97,GGGCUUUGAGGUGGAAAAUUUCGCACGAUCCACACGCCGCUGGUACUGACAGGGGAAACCCGAGAGAUGCAGGAGAAACGUGCGCCUGCCAAAGUCC,26,15,31,25,97
7612,0,URS0000D693B3_12908/1-97,AUUAUCUAAGGUGGAAGAUUUCGUGCGAUCCACACGCCGAUGGUAUAGACAGGGGAAACCUAAGAGAUGCAGGAGAAGCGCACGCCUGCUGGAUAAU,30,19,29,19,97
7613,0,URS0000D6C35D_12908/1-97,AUUCUUUGAGGUGGUAAAUUUCGUGUCAACCACACGCCGCCGGUAUGGACAGGGGAAAACCGAGAGAUGCAGGGGAAUGGCACGCCUACCCAAAAAU,29,18,28,22,97
7614,0,URS0000D69859_12908/1-98,ACUCUUUGAGGUGGAAGAUUUCGUGCGAUCCACACGCCGUUGGUACUGACAGGGGAAAUCCCGAGAGAUGCAGGAGAAGCGCACGCCUGCCAAAGAGU,26,18,31,23,98
7615,0,URS0000D679E7_12908/1-97,GUUCUUUGAGGUGGACAAUUUCGUGGCAUCCACACGCCGAUGGUAUUGACAGGGGAAACCCGAGAGAUGCAGGAGCACGCCACGCCUGCCAAAGAAC,26,17,29,25,97
7616,0,URS0000D65A4B_12908/1-86,GCCGCCCGAGGUGGUAAAUUUCGCAGCGACCACACGCCCUAGAGGUAAAAAAGAGAUGCAGGAGGAUGCUGCGCCUGCCGGGCGGC,21,11,30,24,86
7617,0,URS0000D65D62_12908/1-86,GCCGCCCGAGGUGGUAAAUUUCGCAGCGACCACACGCCCUUGAGGUAAAAAAGAGAUGCAGGAGGAUGCUGCGCCUGCCGGACAGC,22,12,28,24,86
7618,0,URS0000D6C1E1_12908/1-86,GCCGCCCGAGGUGGUAAAUUUCACAGCGACCACACGCCCUUGAGGUAAAAAAGAGAUGCAGGAGGAUGCUGCGCCUGCCGGACGGC,22,12,28,24,86
7619,0,URS0000D6ABCD_12908/1-86,GCCGCCCGAGGUGGUAAAUUUCGCAGCGACCACACGCCCUUGAGGUAAAAAAGAGAUGCAGGAGGAUGCUGCGCCUGCCGGGCGGC,20,12,30,24,86
7620,0,URS0000D65C3B_12908/1-86,GCCGCCCGAGGUGGUAAAUUUCGCAGCGACCACACGCCCUUGAGGUAAAAAAGAGAUGCAGGAGGAUGCUGCGCCUGCCGGACGGC,21,12,29,24,86
7621,0,URS0000D66C3A_12908/1-101,GGUAUUUGAGGUGGUCAAUUUCGUGGCAGCCACACGCCGAUGGUCCCGCCAAGGGCUUAGGCUCUGAGAGAUGCAGGAGAACGCCACGCCUGCCAAAUACC,23,19,31,28,101
7622,0,URS0000D69C31_12908/1-101,GGUAUUUGAGGUGGUAAAAUUCGUAGCGACCACACGCCGCCGGUAACGACAGGAACUUCGGUUCUGAGAGAUGCAGGAGAAUGCUACGCCUGCCAAAUACC,28,20,29,24,101
7623,0,URS0000D66488_12908/1-98,GUUAUUCGAGGUGGAAAAUUUCGUACAAUCCACACGCCGAUGGCUUGACAAAGGGAAACCUUGAGAGAUGCAGGAGAAUGGGACGCCUGCCGAAUAAC,31,19,28,20,98
7624,0,URS0000D6BBCB_12908/1-99,GUUAUUCGAGGUGGAAAAUUUCGUCCCCGUCCACACGCCGAUGGCUUGACAAAGGGAAACCUUGAGAGAUGCAGGAGAAUGGGACGCCUGCCGAAUAAC,28,19,29,23,99
7625,0,URS0000D67D79_12908/1-97,GUUAUUUGAGGUGGUAAAUUUCGUUGCGACCACACGCCGAUGGCUUGACAAAGGGAAACCUUGAGAGAUGCAGGAGAUGCGACGCCUGCCAAAUAAC,28,21,28,20,97
7626,0,URS0000D693F7_1263064/1-97,GUUAUCUGAGGUGGAAGAUUUCGUACCCGUCCACACGCCGAUGGUUUGACAGGGGAAACCCGAGAGAUGCAGGAGCAUGGUACGCCUGCCAGAUAAC,25,19,30,23,97
7627,0,URS0000D693F7_999405/1-97,GUUAUCUGAGGUGGAAGAUUUCGUACCCGUCCACACGCCGAUGGUUUGACAGGGGAAACCCGAGAGAUGCAGGAGCAUGGUACGCCUGCCAGAUAAC,25,19,30,23,97
7628,0,URS0000D6ADC1_12908/1-96,GUAAUUUGAGGUGGGAGAUUUCGUCCAGCCCACACGCCGAUGGUGAGACAGGGGAAACCCGAGAGAUGCAGGAGAAUUGGACGCCUGCCAAAUUAC,27,17,31,21,96
7629,0,URS0000D6B232_12908/1-96,ACUAUUUGAGGUGGUAAAUUUCGUUGCGACCACGCGCCGAUGGUAUGACAGGGGAAACCCGAGAGAUGCGGGAGAAAGCGACGCCCGCCAAAUUGU,26,18,31,21,96
7630,0,URS0000D6D281_12908/1-98,ACUCUUUGAGGUGGAAGAUUUCGUGCGAUCCACACGCCGUUGGUACUGACAGGGGAAAGCCCGAGAGAUGCAGGAGAAGCGCACGCCUGCCAAAGAGU,26,17,32,23,98
7631,0,URS0000D6CDD2_12908/1-97,ACUAUUUGAGGUGGAAGAAUUCGUACGAUCCACACGCCGAUGGUAAUGACAGGGGAAACCCGAGAGAUGCAGGAGAAGCGUACGCCUGCCAAAUAGU,31,17,29,20,97
7632,0,URS0000D6AB35_12908/1-101,GAUAUUUGAGGUGGUAAAUUUCGUAGCGACCACACGCCGAUGGUAACGACAGGGGCGUUUGCUCUGAGAGAUGCAGGAGAAUGCUACGCCUGCCAAAUAUC,27,23,30,21,101
7633,0,URS0000D6C485_12908/1-97,AUUAUUUGAGGUGGAAGAUUUCGUACCCAUCCACACGCCGCUGGUUUGACAGGGGAAACCCGAGAGAUGCAGGAGAAUGGUACGCCUGCCAAAUAAU,28,21,27,21,97
7634,0,URS0000D6AEDB_12908/1-97,GUUAUUUGAGGUGGAAGAAUUCGUACCCGUCCACACGCCGAUGGCUUGACAGGGGCAACCCGAGAGAUGCAGGAGAAUGGUACGCCUGCCAAAUAAC,27,18,29,23,97
7635,0,URS0000D67050_12908/1-96,GUUGUUUGAGGUGGAAAAAUUCGUCCGAUCCACACGCCGCUGGUAUGACAGGGGAAACCCGAGAGAUGCAGGAGAAACGGACGCCUGCCAAAUAAC,29,16,29,22,96
7636,0,URS0000D68043_12908/1-96,GUUAUUUGAGGUGGUAAACUUCGCAGCGACCACACGCCGAUGGCACGACAGGGGCGACCCGAGAGAUGCAGGAGAAUGCUGCGCCUGCCAAAUAAC,26,15,30,25,96
7637,0,URS0000D68043_1262963/1-96,GUUAUUUGAGGUGGUAAACUUCGCAGCGACCACACGCCGAUGGCACGACAGGGGCGACCCGAGAGAUGCAGGAGAAUGCUGCGCCUGCCAAAUAAC,26,15,30,25,96
7638,0,URS0000D699F2_12908/1-96,ACUAUUUGAGGUGGUAAAUUUCGUAGCGACCACACGCCGAUGGUACGACAGGGGCAACCCGAGAGAUGCAGGAGGAUGCUACGCCUGCCAAAUGGU,26,18,30,22,96
7639,0,URS0000D658F3_12908/1-101,GGCAUUUGAGGUGGUCAAUUUCGUGGCAACCACACGCCGAUGGUAACGACAAGGGCUUUCGCCCUGAGAGAUGCAGGAGAACGCUACGCCUGCCAAAUGCU,25,20,30,26,101
7640,0,URS0000D68551_12908/1-101,GGCAUUUGAGGUGGUCAAUUUCGUGGCAGCCACACGCCGAUGGUAACGACAAGGGCUUUCGCCCUGAGAGAUGCAGGAGAACGCCACGCCUGCCAAAUGCU,24,19,31,27,101
7641,0,URS0000D68551_718252/1-101,GGCAUUUGAGGUGGUCAAUUUCGUGGCAGCCACACGCCGAUGGUAACGACAAGGGCUUUCGCCCUGAGAGAUGCAGGAGAACGCCACGCCUGCCAAAUGCU,24,19,31,27,101
7642,0,URS0000D68A11_12908/1-101,AGCAUUUGAGGUGGUCAAUUUCGUGGCAGGCCCACGCCGAUGGUAACGACAAGGGUUUUCGCCCUGAGAGAUGCAGGAGAACGCCACGCCUGCCAAAUGCU,24,20,31,26,101
7643,0,URS0000D6C0F7_12908/1-97,GUUAUUUGAGGUGGACAAUUUCGUGGCAUCCACACGCCGAUGGUAACGACAGGGGUAACCCGAGAGAUGCAGGAGAACGCCACGCCUGCCAAAUAAC,28,17,28,24,97
7644,0,URS0000D6D2A2_12908/1-97,GUUAUUUGAGGUGGAAAAUUUCGUGCCAUCCACACGCCGCUGGUACCGACAGGGGAAACCCGAGAGAUGCAGGAGAACGCCACGCCUGCCAAAUAAC,28,16,27,26,97
7645,0,URS0000D67232_12908/1-101,GGUAUUUGAGGUGGUCAAUUUCGUGGCAGCCACAAGCCGAUGGUAACGACAAGGGCUUAGGCUCUGAGAGAUGCAGGAGAACGCCACGCCUGCCAAAUACC,27,19,31,24,101
7646,0,URS0000D6A99D_12908/1-101,GGUAUUUGAGGCGGUCAAUUUCGUGGCAGCCCCACGCCGAUGGUAACGACAAGGGCUUAGGCUCUGAGAGAUGCAGGAGAACGCCACGCCUGCCAAAUACC,25,18,31,27,101
7647,0,URS0000D6BAC3_12908/1-101,AGCAUUUGAGGUGGUCAAUUUUGUGGCAGCCACACGCCGAUGGUAACGACAAGGGCAUCUGCCCUGAGAGAUGCAGGAGAACGCCACGCCUGCCAAAUGCU,26,19,30,26,101
7648,0,URS0000D69C73_12908/1-101,GAUAUUUGAGGUGGUAAAUUUCGUAGCGACCACACGCCGAUGGUAACGACAAGGGCGUUUGCUCUGAGAGAUGCAGGAGAAUGCUACGCCUGCCAAAUAUC,28,23,29,21,101
7649,0,URS0000D68B9F_12908/1-101,GGUAUUUGAGGUGGUCAAUUUCGUGGCAGCCACACGCCGAUGGUAACGACAAGGGCUUGGGCUCUGAGAGAUGCAGGAGAACGCCACGCCUGCCAAAUACC,25,19,32,25,101
7650,0,URS0000D6A6EC_12908/1-101,GGUAUUUGAGGUGGUCAAUUUCGUGGCAGCCACACGCCGAUGGUAAAGACAAGGGCUUAGGCUCUGAGAGAUGCAGGAGAACGCCACGCCUGCCAAAUACC,27,19,31,24,101
7651,0,URS0000D6C9EB_12908/1-101,GGUAUUUGAGGUGGUCAAUUUCGUGGCAGCCACACGCCGAUGGUAACGACAAGGGCUUAGGCUCUGAGAGAUGCAGGAGAAUGCCACGCCUGCCAAAUACC,26,20,31,24,101
7652,0,URS0000D66977_12908/1-101,GGUAUUUGAGGUGGUCAAUUUCGUGGCAGCCACACGCCGAUGGUAACGACAAGGGCUUAGGCUCUGAGAGAUGCAGGAGAACGCCACGCCUGCCAAAUACC,26,19,31,25,101
7653,0,URS0000D66977_411483/1-101,GGUAUUUGAGGUGGUCAAUUUCGUGGCAGCCACACGCCGAUGGUAACGACAAGGGCUUAGGCUCUGAGAGAUGCAGGAGAACGCCACGCCUGCCAAAUACC,26,19,31,25,101
7654,0,URS0000D69CDA_12908/1-101,GGUAUUUGAGGUGGUCAAUUUCGUGGCAGCCACACGCCGAUGGUAACGACAAGGGCAACUGCCCUGAGAGAUGCAGGAGAACGCCACGCCUGCCAAAUACC,27,17,30,27,101
7655,0,URS0000D6829D_12908/1-101,GGCAUCUGAGGUGGUCAAUUUCGUGGCAGCCACACGCCGAUGGUAACGACAAGGGCUUUUGCUCUGAGAGAUGCAGGAGAACGCCACGCCUGCCGGAUGCC,22,19,33,27,101
7656,0,URS0000D6893F_12908/1-100,GGCAUUUGAGGUGGUCAAUUUCGUGGCAGCCACACGCCGCUGGUAACGACAAGGGCUUUGCCCUGAGAGAUGCAGGAGAACGCCACGCCUGCCAAAUGCC,23,18,31,28,100
7657,0,URS0000D67926_12908/1-101,GACAUUUGAGGUGGUCAAUUUCGUGGCAGCCACACGCCGAUGGUAACGACAAGGGCUUUCGCCCUGAGAGAUGCAGGAGAACGCCACGCCUGCCAAAUGCU,25,19,30,27,101
7658,0,URS0000D6A43D_12908/1-101,AGCAUUUGAGGUGGUCAAUUUCGUGGCAGCCACACGCCGAUGGUAACGACAAGGGCUUUCGCCCUGAGAGAUGCAGGAGAACGCCACGCCUGCCAAAUGCU,25,19,30,27,101
7659,0,URS0000D666E8_12908/1-100,AGCAUUUGAGGUGGUCAAUUUCGUGGCAGCCACACGCCGAUGGUAACGACAAGGGCCUCGCCCUGAGAGAUGCAGGAGAACGCCACGCCUGCCAAAUGCU,25,17,30,28,100
7660,0,URS0000D68D12_12908/1-101,AGCAUUUGAGGUGGUCAAUUUCGUGGCAGCCCCACGCCGAUGGUAACGACAAGGGCUUUCGCCCUGGGAGAUGCAGGAGAACGCCACGCCUGCCAAAUGCU,23,19,31,28,101
7661,0,URS0000D689E4_12908/1-101,AGCAUUUGAGGUGGUAAAUUUCGUAGCGACCACACGCCGAUGGUAACGACAAGGGCUUUUGCUCUGAGAGAUGCAGGAGAAUGCUACGCCUGCCAAAUGCU,27,23,29,22,101
7662,0,URS0000D698E9_12908/1-101,GACAUUUGAGGUGGUCAAUUUCGUGGCAGCCACACGCCGAUGGUAACGACAAGGGCUUUUGCUCUGAGAGAUGCAGGAGAAUGCUACGCCUGCCAAAUGCU,25,23,30,23,101
7663,0,URS0000D6713D_12908/1-101,GGCAUUUGAGGUGGUCAAUUUCGUGGCAGCCACACGCCGAUGGUAACGACAAGGGCUUUCGCUCUGAGAGAUGCAGGAGAAUGCUACGCCUGCCAAAUGCU,24,22,31,24,101
7664,0,URS0000D6BDEE_12908/1-101,AGCAUUUGAGGUGGUCAAUUUCGUGGCAGCCACACGCCGAUGGUAACGACAAGGGCUUUUGCUCUGAGAGAUGCAGGAGAAUGCUACGCCUGCCAAAUGCU,25,23,30,23,101
7665,0,URS0000D6AD57_12908/1-101,GGCAUUUGAGGUGGUAAAUUUCGUAGCGACCACACGCCGAUGGUAACGACAAGGGCUUUUGCCCUGAGAGAUGCAGGAGGAUGCUACGCCUGCCAAAUGCC,25,21,31,24,101
7666,0,URS0000D65B25_12908/1-100,GGCAUUUGAGGUGGUAGAUUUCGUACCGACCACACGCCGCUGGUAAUGACAAGGGCUGUGCCCUGAGAGAUGCAGGAGGAUGGUACGCCUGCCAAAUGCC,23,20,33,24,100
7667,0,URS0000D6C97B_12908/1-100,GACAUUUGAGGUGGUAGAUUUCGUACCGACCACACGCCGCUGGUAAUGACAAGGGCUGUGCCCUGAGAGAUGCAGGAGGAUGGUACGCCUGCCAAAUGCC,24,20,32,24,100
7668,0,URS0000D6BFF7_12908/1-100,GACAUUUGAGGUGGUAGAUUUCGUACCGACCACACGCCGCUGGUAAUGACAAGGGCUGUGCCCUGAGAGAUGCAGGAGGAUAGUACGCCUGCCAAAUGCC,25,20,31,24,100
7669,0,URS0000D68024_12908/1-100,GGCAUUUGAGGUGGUAGAUUUCGUACCGACCACACGCCGCUGGUAAUGACAAGGGCUUUGCCCUGAGAGAUGCAGGAGGAUGCUACGCCUGCCAAAUGCC,23,21,31,25,100
7670,0,URS0000D6A177_12908/1-100,GGCAUUUGAGGUGGUAGAUUUCGUACCGACCACACGCCGCUGGUAAUGACAAGGGCUUUGCCCUGAGAGAUGCAGGAGGAUGGUACGCCUGCCAAAUGCC,23,21,32,24,100
7671,0,URS0000D6D3B5_12908/1-101,GGUAUUUGAGGUGGUCAAUUUCGUGGUAGCCACACGCCGAUGGUAACGACAAGGGCUUAGGCUCUGAGAGAUGCAGGAGAACGCCACGCCUGCCAAAUACC,26,20,31,24,101
7672,0,URS0000D6CDFA_12908/1-101,GGUAUUUGAGGUGGUCAAUUUCGUGGCAGCCACACGCCGAUGGUAACGACAAGGGCUUAGGCUCUGAGAGAUGCAGGAGAACGCCAUGCCUGCCAAAUACC,26,20,31,24,101
7673,0,URS0000D6B383_12908/1-101,AGCAUUUGAGGUGGUCAAUUUCGUGGCAGCCACACGCCGAUGGUAACGACAAGGGCUUAGGCUCUGAGAGAUGCAGGAGAACGCCACGCCUGCCAAAUGCU,26,19,31,25,101
7674,0,URS0000D6B2D0_12908/1-98,GUUAUUCGAGGUGGACAAUUUCGUGGCAUCCACACGCCGCUGGUAUUGACAGGGGUAACCCCGAGAGAUGCAGGAGAACGCCACGCCUGCCGGAUAAC,24,18,30,26,98
7675,0,URS0000D663E0_12908/1-97,GUUAUGUGAGGUGGAAAAUGUCGUGGCACCCACACGCCGCUGGUACCGACAGGGGAAACCCGAGAGAUGCAGGAGAACGCCACGCCUGCCAGAUAAC,27,13,31,26,97
7676,0,URS0000D6AD01_12908/1-97,GUUAUUUGAGGUGGAAAAUUUCGUGGCAUCCACACGCCGCUGGUACCGACAGGGGAAACCCGAGAGAUGCAGGAGAACGCCACGCCUGCCAAAUAAC,28,16,28,25,97
7677,0,URS0000D6D0F2_1262959/1-97,GCUAUUUGAGGUGGACAAUUUCGUGGCAUCCAUACGCCGAUGGUAACGACAGGGGGAACCCGAGAGAUGCAGGAGAACGCCACGCCUGCCAAAUAGC,27,16,30,24,97
7678,0,URS0000D65A89_12908/1-97,GGUGUUUGAGGUGGUCAAUUUCGUGGCAGCCACACGCCGCUGGUACCGACAGGGGAAACCCGAGAGAUGCAGGAGAACGCCACGCCUGCCAAACACC,24,14,31,28,97
7679,0,URS0000D67A7C_12908/1-97,GUUAUUUGAGGUGGAAAAUUUCGUGGCAUCCACACGCCGCUGGUACCGACAGGGGAAACCCGAGAGAUGCAGGAGAACGCCACGCCUGCCAGAUAAC,27,16,29,25,97
7680,0,URS0000D67DBB_12908/1-97,ACUCUUUGAGGUGGUAAAUUUCGUGUCAACCACACGCCGCUGGUACGGACAGGGGAAACCCGAGAGAUGCAGGGGAACGGCACGCCUGCCAAAGAGU,26,16,31,24,97
7681,0,URS0000D6BECF_12908/1-97,AUUCUUUGAGGUGGUAAAUUUCGUGUCAACCACACGCCGCUGGUACGGACAGGGGAAACCUGAGAGAUGCAGGGGAAUGGCACGCCUGCCAAAGGAU,26,19,31,21,97
7682,0,URS0000D68A77_12908/1-97,AUUCUUUGAGGUGGUAAAUUUCGUGUCAACCACACGCCGCUGGUAUGGACAGGGGAAACCCGAGAGAUGCAGGGGAACGGCACGCCUGCCAAAGAAU,27,18,30,22,97
7683,0,URS0000D6AAA6_12908/1-97,AUUCUUUGAGGUGGUAAAUUUCGUGUCAACCACACGCCGCUGGUAUGGACAGGGGAAACCCGAGAGAUGCAGGGGAAUGGCACGCCUGCCAAAGAAU,27,19,30,21,97
7684,0,URS0000D6AAA6_888060/1-97,AUUCUUUGAGGUGGUAAAUUUCGUGUCAACCACACGCCGCUGGUAUGGACAGGGGAAACCCGAGAGAUGCAGGGGAAUGGCACGCCUGCCAAAGAAU,27,19,30,21,97
7685,0,URS0000D6BADD_12908/1-96,AUUAUUUGAGGUGGUAAAUUUCGUCCGAACCACACGCCGAUGGUAUGACAGGGGAAACCCGAGAGAUGCAGGAGAAUCGGACGCCUGCCAAAUAAU,30,19,27,20,96
7686,0,URS0000D674B9_12908/1-96,GCUGUUUGAGGUGGAAAAUUUCGUACGAUCCACACGCCGAUGGUAUGACAGGGGAAACCCGAGAGAUGCAGGAGCCACGUACGCCUGCCAAAUAGC,27,17,29,23,96
7687,0,URS0000D6B6CC_12908/1-95,GCUGUUUGAGGUGGAAAUUUCGUACGAUCCACACGCCGAUGGUAUGACAGGGGAAACCCGAGAGAUGCAGGAGCCACGUACGCCUGCCAAAUAGC,26,17,29,23,95
7688,0,URS0000D6AA39_12908/1-97,GUUAUUCGAGGUGGAAGAUUUCGUACAAUCCACACGCCGAUGGUACUGACAGGGGAAUCCCGAGAGAUGCAGGAGAUUUGUCCCCCUGCCGAAUAAC,26,21,27,23,97
7689,0,URS0000D6ADD4_12908/1-96,GCUGUUUGAGGUGGUAAAUUUCGUGGAGGCCACGCGCUGACGGUAUGACAGGGGAAACCCGAGAGAUGCAGGAGAACGCCACGCCUGCCGGACAGU,23,16,35,22,96
7690,0,URS0000D665B4_12908/1-98,GAUUGCCGAGGUGGUAGAUUUCGUCCCGACCACGCGCCGAUGGUAUGACAAGGGGAAACCCUGAGAGAUGCAGGAGAGGGGGACGCCUGCCGGCAAUC,23,15,36,24,98
7691,0,URS0000D69BD9_936381/1-96,GACAUCUGAGGUGGUAAAUUUCGUGUCGACCACACGCCGAUGGCAUGACAGGGGAAACCCGAGAGAUGCAGGGGCAUGGCACGCCUGCCGGAUGUU,23,17,33,23,96
7692,0,URS0000D6B7C4_12908/1-96,GACAUCUGAGGUGGUAAAUUUCGUGUCGACCACACGCUGAUGGCAUGAUAGGGGAAACCCGAGAGAUGCAGGGGCAUGGCACGCCUGCCGGAUGUU,23,19,33,21,96
7693,0,URS0000D6C85F_12908/1-101,AGCAUUUGAGGUGGUCAAUUUCGUGGCAGCCACACGCCGAUGGUAACGACAAGGGCAUCUGCCCUGAGAGAUGCAGGAGAACGCCACGCCUGCCAAAUGCU,26,18,30,27,101
7694,0,URS0000D6C868_12908/1-101,AGCAUUUGAGGUGGUCAAUUUCGUGGCAGCCACACGCCGAAGGGAACGACAAGGGCUUUCGCCCUGAGAGAUGCAGGAGAACGCCACGCCUGCCAAAUGCU,26,17,31,27,101
7695,0,URS0000D67AB6_12908/1-101,GGUAUUUGAGGUGGUCAAUUUCGUGGCAGCCACACGCCGACGGUAACGACAAGGGCAGCUGCCCUGAGAGAUGCAGGAGAACGCCACGCCUGCCAAAUACC,26,16,31,28,101
7696,0,URS0000D679D8_12908/1-101,GGUAUUUGAGGUGGUCAAUUUCGUGGCAGCCACACGCCGACGGUAACGACAAGGGCAGCUGCCCUGAGAGAUGCAGGAGAACGCCACGCCUGCCAAAUGCC,25,16,32,28,101
7697,0,URS0000D6CF6C_12908/1-96,GGCAUUUGAGGUGGUCAAUUUCGUGGCAGCCACACGCCGAUGGUUUGACAGGGGAGACCCAAGAGAUGCAGGAGAAUGCCACGCCUGCCAGAUGCC,23,17,32,24,96
7698,0,URS0000D6B5D7_12908/1-97,ACUGUCCGAGGUGGAAAAUUUCGUACCCGUCCACACGCCGCUGGCUUGACAGGGGAAACCCGAGAGAUGCAGGAGAAUGGUACGCCUGCCGAACAGU,25,16,30,26,97
7699,0,URS0000D6D1FF_12908/1-97,GUGCUUUGAGGUGGUCAAUUUCGUGGCAGCCACACGCCGACGGUAUUGAUAGGGGAAACCCGAGAGAUGCAGGGGAACGCCACGCCUGCCAAAGCGC,23,16,33,25,97
7700,0,URS0000D6C586_12908/1-99,AUUGUUUGAGGUGGAAAAUUUCGUCUCCGUCCACACGCCGAUGGUUUGACAGGGAGCAAUCCCGAGAGAUGCAGGAGAAAGGGACGCCUGCCAAACAAC,28,19,29,23,99
7701,0,URS0000D6BE98_12908/1-99,GUUAUUCGAGGUGGAAGAUUUCGUCCCCGUCCACACGCCGAUGGCUUGACAAAGGGAGACCUUGAGAGAUGCAGGAGAAUGGGACGCCUGCCGAAUAAC,26,19,31,23,99
7702,0,URS0000D66774_12908/1-99,GUUAUUCGAGGUGGAAGAUUUCGUCCCCGUCCACACGCUGAUGGCUUGACAAAGUGAAACCUUGAGAGAUGCAGGAGAAUGGGACGCCUGCCGAAUAAC,27,21,29,22,99
7703,0,URS0000D66B8B_12908/1-97,GGGCUUUGAGGUGGUAGAUUCCGUACCGACCACACGCCGACGGUAUUGACAGGGGCAACCCGAGAGAUGCAGGAGAAUGGUACGCCUGCCAAAGUCC,24,16,32,25,97
7704,0,URS0000D67653_12908/1-97,AUUCUUUGAGGUGGUAAAUUUCGCGUCUACCACACGCCGCCGGUACAGACAGGGGAAACCCGAGAGAUGCAGGGGAACGGCACGCCUGCCAAAGAAU,27,16,29,25,97
7705,0,URS0000D6CB19_12908/1-100,AACAUUUGUGGUGGUAAAUUUUCGUGUCAACCACACGCCGCUGGUACUGACAGGAGGAAACUCUGAGAGAUGCAGGAGAAUGGCACGCCUGCCAAAUGUU,28,23,28,21,100
7706,0,URS0000D66E34_12908/1-96,AGUAUUUGAGGUGGUAAAUUUCGUUGCGACCACACGCCGCUGGUAUGACAGGGGAAACCCGAGAGAUGCAGGAGUAAGCCACGCCUGCCGAAUAAC,27,18,29,22,96
7707,0,URS0000D6663F_12908/1-96,ACUGUUUGAGGUGGUAAAUUUCGUUGCGACCACACGCCGAUGGUAUGACAGGGGAAACCCGAGAGAUGCGGGGGAAAGCGACGCCCGCCAAAUUGU,25,18,32,21,96
7708,0,URS0000D65764_12908/1-97,GUUAUCUGAGGUGGAAGAUUUCGUGGCAUCCACACGCCGAUGGUACCGACAGGGGAAACCCGAGAGAUGCAGGAGUACGCCACGCCUGCCGGAUAAC,25,16,31,25,97
7709,0,URS0000D6B4AF_12908/1-97,GUUAUCUGAGGUGGAAGAUUUCGUGGCAUCCACACGCCGAUGGUACCGACAGGGGAAACCCGAGAGAUGCAGGAGUAAGCCACGCCUGCCGGAUAAC,26,16,31,24,97
7710,0,URS0000D6BDF6_12908/1-97,GUUAUUUGAGGUGGUAAAAUUCGUGGCGACCACACGCCGAUGGUAUCGACAGGGGAAACCCGAGAGAUGUAGGAGAAAGCCACGCCUACCAAAUAAC,31,17,28,21,97
7711,0,URS0000D6B1D2_12908/1-99,AUUAUUUGAGGUGGUAAAUUUCGUAGCGACCACACGCCGACGGUAUUGACAAGGGGAAACUCUGAGAGAUGCAGGAGAAUGCUACGCCUGCCAAAUAAU,31,22,27,19,99
7712,0,URS0000D657AB_12908/1-99,AUUAUUUGAGGUGGUAGAUUUCGUAGCGACCACACGCCGAAGGUAUUGACAAGGGGAAACCCUGAGAGAUGCAGGAGAGUGCUACGCCUGCCAAAUAAU,30,21,29,19,99
7713,0,URS0000D657AB_1262824/1-99,AUUAUUUGAGGUGGUAGAUUUCGUAGCGACCACACGCCGAAGGUAUUGACAAGGGGAAACCCUGAGAGAUGCAGGAGAGUGCUACGCCUGCCAAAUAAU,30,21,29,19,99
7714,0,URS0000D66899_12908/1-99,AUUAUUUGAGGUGGUAGAUUUCGUAGCGACCACACGCCGAAGGUAUUGACAAGGGGAAACCCUGAGAGAUGCAGGAGAGUGUUACGCCUGCCAAAUAAU,30,22,29,18,99
7715,0,URS0000D66F13_12908/1-97,ACUAUUUGAGGUGGUAGAUUUCGUAGCGACCACACGCCGUUGGUAUAGACAGGGGAGACCCGAGAGAUGCAGGAGGAUGCUACGCCUGCCAAAUAAU,27,20,30,20,97
7716,0,URS0000D6A1BA_12908/1-98,GCUAUUUGUGGUGGUAAAUUUUCGUGUUGACCACACGCCGAUGGUACUGACAGGGGAAACCCGAGAGAUGCGGGAGAAUGACACGCCUGCCAAAUAGC,26,21,30,21,98
7717,0,URS0000D676F9_12908/1-97,AUUAUCUAAGGUGGAAGAUUUCGUGCGAUCCACACGCCGAUGGUAUAGACAGGGGAAACCUGAGAGAUGCAGGAGAAGCGCACGCCUGCUGGAUAAU,29,19,30,19,97
7718,0,URS0000D676F9_470146/1-97,AUUAUCUAAGGUGGAAGAUUUCGUGCGAUCCACACGCCGAUGGUAUAGACAGGGGAAACCUGAGAGAUGCAGGAGAAGCGCACGCCUGCUGGAUAAU,29,19,30,19,97
7719,0,URS0000D676F9_1263070/1-97,AUUAUCUAAGGUGGAAGAUUUCGUGCGAUCCACACGCCGAUGGUAUAGACAGGGGAAACCUGAGAGAUGCAGGAGAAGCGCACGCCUGCUGGAUAAU,29,19,30,19,97
7720,0,URS0000D66BA1_12908/1-97,AUUAUCUAAGGUGGAAGAUUUCGUGCGAUCCACACGCCGAUGGUAUAGACAGGGGAAACCUGAGAGAUGCAGGAGAAGCGCACGCCUGCUGGAUAAA,30,18,30,19,97
7721,0,URS0000D68DB7_12908/1-97,AUUAUUUGAGGUGGAAAAUUUCGCACGAUCCACACGCCGCUGGUACAGACAAGGGAAACCUGAGAGAUGCAGGAGAAGCGUGCGCCUGCCAAAUAAU,31,18,27,21,97
7722,0,URS0000D68DB7_1262832/1-97,AUUAUUUGAGGUGGAAAAUUUCGCACGAUCCACACGCCGCUGGUACAGACAAGGGAAACCUGAGAGAUGCAGGAGAAGCGUGCGCCUGCCAAAUAAU,31,18,27,21,97
7723,0,URS0000D6B603_12908/1-98,GUUAUUCGAGGUGGAAGAUUUCGUCCACGUCCACACGCCGAUGGUACUGACAGGGGAAUCCCGAGAGAUGCAGGAGAAUGGGACGCCUGCCGAAUAAC,26,18,31,23,98
7724,0,URS0000D668E1_12908/1-97,GUUAUUCGAAGUGGAAGAUUUCGUACAAUCCACACGCCGAUGGUACUGACAGGGGAAUCCCGAGAGAUGCAGGAGAGUUGUACGCCUGCCGAAUAAC,28,20,28,21,97
7725,0,URS0000D68A29_12908/1-97,GUUAUUCGAGGUGGAAGAUUUCGUACAAUCCACACGCCGAUGGUACUGACAGGGGAAUCCCGAGAGAUGCAGGAGAGUUAUACGCCUGCCGAAUAAC,28,20,28,21,97
7726,0,URS0000D6D37C_12908/1-97,GUUAUUCGAGGUGGAAGAUUUCGUACAAUCCACACGCCGAUGGUACUGACAGGGAAAUCCCGAGAGAUGCAGGAGAGUUGUACGCCUGCCGAAUAAC,28,20,28,21,97
7727,0,URS0000D6BF01_12908/1-97,GUUAUUCGAGGUGGAAGAUUUUGUACAAUCCACACGCCGAUGGUACUGACAGGGGAAUCCCGAGAGAUGCAGGAGAGUUGUACGCCUGCCGAAUAAC,27,21,29,20,97
7728,0,URS0000D6BF7F_12908/1-97,GUUAUUCGAGGUGGAAGAUUUCGUACAAUCCACACGCCGAUGGUACUGACAGGGGAAUCCCGAGAGAUGCAGGAGAGUUGUACGCCUGCCGAAUAAC,27,20,29,21,97
7729,0,URS0000D6CAC2_12908/1-97,GUUAUUCGAGGUGGAAGAUUUCGUACGAUCCACACGCCGAUGGUACUGACAGGGGAAUCCCGAGAGAUGCAGGAGAAUUGUACGCCUGCCGAAUAGC,26,20,30,21,97
7730,0,URS0000D68DAA_12908/1-97,GUUAUUCGAGGUGGAAGAUUUCGUACGAUCCACACGCCGAUGGUACUGACAGGGGAAUCCCGAGAGAUGCAGGAGAGUUGUACGCCUGCCGAAUAGC,25,20,31,21,97
7731,0,URS0000D693F6_1235792/1-97,ACUCUUUGAGGUGGAAGAUUUCGUACGAUCCACACGCCGUUGGUACUGACAGGGGAGACCCGAGAGAUGCAGGAGAAGCGUACGCCUGCCAAAGAGU,26,18,31,22,97
7732,0,URS0000D67C06_12908/1-98,ACUAUUUGAGGUGGAAGAAUUCGUACGAUCCACACGCCGAUGGUAAUGACAGGGGGAAACCCGAGAGAUGCAGGAGGAGCGUACGCCUGCCAAAUAGU,30,17,31,20,98
7733,0,URS0000D66475_12908/1-98,ACUAUUUGAGGUGGAAGAAUUCGUACGAUCCACACGCCGAUGGUAAUGACAGGGGGAAACCCGAGAGAUGCAGGAGAAGCGUACGCCUGCCAAAUAGU,31,17,30,20,98
7734,0,URS0000D6C7AA_12908/1-97,GUAAUUUGAGGUGGGAGAUUUCGUCCAGCCCACGCGCCGAUGGUGUGACAGGGGAAACCCGAGUAGAUGCAGGAGAAUUGGACGCCUGCCAAAUUAC,25,19,32,21,97
7735,0,URS0000D69657_12908/1-97,GUAAUUUGAGGUGGGAAAUUUCGUCCAGCCCACGCGCCGAUGGUGUGACAGGGGAAACCCGAGUAGAUGCAGGAGAAUUGGACGCCUGCCAAAUUGC,25,19,32,21,97
7736,0,URS0000D69E7A_12908/1-97,GUAAUUUGAGGUGGGAAAUUUCGUCCAGCCCACGCGCCGAUGGUGUGACAGGGGAAACCCGAGUAGAUGCAGGAGAAUUGGACGCCUGCCAAAUUAC,26,19,31,21,97
7737,0,URS0000D675EE_12908/1-97,GUAAUUUGAGGUGGGAAAUUUCGCCCAGCCCACGCGCCGAUGGUGUGACAGGGGAAACCCGAGUAGAUGCAGGAGAAUUGGGCGCCUGCCAAAUUAC,25,18,32,22,97
7738,0,URS0000D6A7B7_12908/1-97,GUAAUUUGAGGUGGGAAAUUUCGCCCAGCCUACGCGCCGAUGGUGUGACAGGGGAAACCCGAGUAGAUGCAGGAGAAUUGGGCGCCUGCCAAAUUAC,25,19,32,21,97
7739,0,URS0000D6A3C7_888060/1-97,GUAAUUUGAGGUGGGAGAUUUCGUCCAGCCCACACGCCGAUGGCACGACAGGGGAAACCCGAGUAGAUGCAGGAGAACUGGACGCCUGCCAAAUUAC,27,16,30,24,97
7740,0,URS0000D68A3F_1262893/1-99,GUUAUCUGAGGUGGAAGAAUACGUCCACGUCCACACGCCGAUGGCUUGACAGGGGGGCACCCCGAGAGAUGCAGGAGAAUUGGACGCCUGCCAGAUGAC,25,16,33,25,99
7741,0,URS0000D686C8_12908/1-97,GCUGUUUGAGGUGGAAAAUUUCGUACGAUCCACACGCCGAUGGUAUGACAGGGGGAAACCCGAGAGAUGCAGGAGCCACGUACGCCUGCCAAAUAGC,27,17,30,23,97
7742,0,URS0000D68728_12908/1-98,GUUAUUCGAGGUGGAAGAUUUCGUACAAUCCACACGCCGAUGGCUUGACAAAGGGAAACCUUGAGAGAUGCAGGAGAAUGGGACGCCUGCCGAAUAAC,30,19,29,20,98
7743,0,URS0000D6ABB4_12908/1-99,GUUAUUCGAGGUGGAAGAUUUCGUCCCCGUCCACACGCCGAUGGCUUGACAAAGGGAAACCUUGAGAGAUGUAGGAGAAGGGGACGCCUGCCGAAUAAC,27,19,31,22,99
7744,0,URS0000D6AD9A_12908/1-99,GUUAUUCGAGGUGGAAGAUUUCGUCCCCGUCCACACGCCGAUGGCUUGACAAAGUGAAACCUUGAGAGAUGUAGGAGAAUGGGACGCCUGCCGAAUAAC,27,21,29,22,99
7745,0,URS0000D67865_12908/1-99,GUUGUUCGAGGUGGAAGAUUUCGUCCCCGUCCACACGCCGAUGGCUUGACAAAGGGAAACCUUGAGAGAUGCAGGAGAAUGGGACGCCUGCCGAAUAAC,26,19,31,23,99
7746,0,URS0000D6A4ED_12908/1-99,GUUAUUCGAGGUGGAAGAUUUCGUCCCCGUCCACACGCCGAUGGCUUGACAAAGGGAAACCUUGAGAGAUGUAGGAGAAUGGGACGCCUGCCGAAUAAC,27,20,30,22,99
7747,0,URS0000D68A32_12908/1-99,GUUAUUCGAGGUGGAAGAUUUCGUCCCCGUCCACACGCCGAUGGUUUGACAAAGGGAAACCUUGAGAGAUGCAGGAGAAUGGGACGCCUGCCGAAUAAC,27,20,30,22,99
7748,0,URS0000D6C2B0_12908/1-99,GUUAUUCGAGGUGGAAGAUUUCGUCCCCGUCCACACGCCGAUGGCUUGACAAAGGGAAACCUUGAGAGAUGCAGGAGAAUGGGACGCCUGCCGAAUAAC,27,19,30,23,99
7749,0,URS0000D6C2B0_657321/1-99,GUUAUUCGAGGUGGAAGAUUUCGUCCCCGUCCACACGCCGAUGGCUUGACAAAGGGAAACCUUGAGAGAUGCAGGAGAAUGGGACGCCUGCCGAAUAAC,27,19,30,23,99
7750,0,URS0000D65C0F_12908/1-99,GUUAUUCGAGGUGGAAGAUUUCGUCCCCGUUCACACGCCGAUGGCUUGACAAAGGGAAACCUUGAGAGAUGCAGGAGAAUGGGACGCCUGCCGAAUAAC,27,20,30,22,99
7751,0,URS0000D6CE8E_1262950/1-98,GUUAUUCGAGGUGGAAGAUUUCGUACAAUCCACACGCCGAUGGCUUGACAAAGGGAAACCUUGAGAGAUGCAGGAGAGUUAUACGCCUGCCGAAUAAC,30,21,27,20,98
7752,0,URS0000D6CE8E_12908/1-98,GUUAUUCGAGGUGGAAGAUUUCGUACAAUCCACACGCCGAUGGCUUGACAAAGGGAAACCUUGAGAGAUGCAGGAGAGUUAUACGCCUGCCGAAUAAC,30,21,27,20,98
7753,0,URS0000D6A109_12908/1-99,GUUAUUCGAGGUGGAAGAUUUCGUCCCCGUCCACACGCCGACGGCUUGACAAAGGGAAACCUUGAGAGAUGCAGGAGAGUUAUACGCCUGCCGAAUAAC,27,20,28,24,99
7754,0,URS0000D68298_12908/1-99,GUUAUUCGAGGUGGAAGAUUUCGUCCCCGUCCACACGCCGAUGGCUUGACAAAGGGAAACCUUGAGAGAUGCAGGAGAGUUAUACGCCUGCCGAAUAAC,27,21,28,23,99
7755,0,URS0000D6C14E_12908/1-99,AUUAUUCGAGGUGGAAGAUUUCGUCCCCGUCCACACGCCGAUGGCUUGACAAAAGGAAACCUUGAGAGAUGCAGGAGAGUUAUACGCCUGCCGAAUAAC,29,21,26,23,99
7756,0,URS0000D6A06D_742737/1-100,AUUGUUUGAGGUGGAAGAUUUCGUACCCGUCCACACGCCGAUGGCUUGACAGGGGGAAACCCCGAGAGAUGCAGGAGAUUUGGUACGCCUGCCAAACAAU,26,21,30,23,100
7757,0,URS0000D6B202_12908/1-97,ACUGUUCGAGGCGGAAAAUUUCGUACCCGUCCACACGCCGUUGGCUUGACAGGGGAAACCCGAGAGAUGCAGGAGAAUGGUACGCCUGCCGGACAGU,24,17,31,25,97
7758,0,URS0000D6B4FA_12908/1-97,ACUGUUCGAGGUGGAAAAUUUCGUACCCGUCCACACGCCGUUGGCUUGACAGGGGAAACCCGAGAGAUGCAGGAGAAUGGUACGCCUGCCGGACAGU,24,18,31,24,97
7759,0,URS0000D6763D_12908/1-97,ACUGUUCGAGGUGGAAAAUUUCGUACCCGUCCACACGCCGUUGGCUUGACAGGGGAAACCCGAGAGAUGCAGGAGAAUAGUACGCCUGCCGGACAGU,25,18,30,24,97
7760,0,URS0000D6B22B_12908/1-97,ACUGUUCGAGGUGGAAAAUUUCGUACCCGUUCACACGCCGCUGGCUUGACAGGGGAAACCCGAGAGAUGCAGGAGAAUGGUACGCCUGCCGGACAGU,24,18,31,24,97
7761,0,URS0000D68A90_12908/1-97,ACUGUUCGAGGUGGAAAAUUUCGUACCCGUCCACACGCCGCUGGCUUGACAGGGGAAACCCGAGAGAUGCAGGAGAAUGGUACGCCUGCCGAACAGU,25,17,30,25,97
7762,0,URS0000D6B59D_12908/1-97,ACUGUCCGAGGUGGAAAAUUUCGUACCCGUCCACACGCCGCUGGCUUGACAGGGGAAACCCGAGAGAUGCAGGAGAAUGGUACGCCUGCCGGACAGU,24,16,31,26,97
7763,0,URS0000D6D1C2_12908/1-97,GUCGUUUGAGGUGGAAGAUUUCGUACCCGUCCACACGCCGAUGGCUUGACAGGGGAAACCCGAGAGAUGCAGGAGAAUGGUACGCCUGCCGAACGAC,24,17,32,24,97
7764,0,URS0000D6D227_12908/1-99,GUUAUUUGAGGUGGAAGAUUUCGUCCCCAUCCACACGCCGAUGGUUUGACAGGGAGUAAUCCCGAGAGAUGCAGGAGAAUGGGACGCCUGCCAAAUAAC,27,21,29,22,99
7765,0,URS0000D675F9_12908/1-99,GUUGUUUGAGGUGGAAAAUUUCGUCCCCGUCCACACGCCGAUGGUUUGACAGGGAGCAAUCCCGAGAGAUGCAGGAGAAAGGGACGCCUGCCAAACAAC,27,18,30,24,99
7766,0,URS0000D6AAFE_12908/1-99,AUUGUUUGAGGUGGAAAAUUUCGUCCCCGUCCACACGCCGAUGGUUUGACAGGGAGCAAUCCCGAGAGAUGCAGGAGAAAUGGACGCCUGCCAAACAAC,28,19,28,24,99
7767,0,URS0000D6D1B7_12908/1-97,GUUAUCUGAGGUGGAAGAUUUCGUACCCGUCCACACGCCGAUGGUUUGACAGAGGAAACCCGAGAGAUGCAGGAGCAUGGUACGCCUGCCAGAUAAC,26,19,29,23,97
7768,0,URS0000D6B46B_592026/1-94,GCUAUUUGAGGUGGUAGAUUUCGUCCGGACCACACGCCGCCGGCAAGACAGGGAAACCGAGAGAUGCAGGAGAAGCGGACGCCUGCCGAAUAGC,25,13,32,24,94
7769,0,URS0000D6A4E5_12908/1-94,GCUAUUUGAGGUGGUAGAUUUCGUCCGGACCACACGCCGCCGGCAAGACAGGGAAACCGAGAGAUGCAGGAGAAGCGGACGCCUGCCGGAUAGC,24,13,33,24,94
7770,0,URS0000D69EEC_12908/1-94,GUUAUUUGAGGUGGUAGAUUUCGUCCGGACCACACGCCGAUGGCAAGACAGGGAAACCGAGAGAUGCAGGAGAAACGGACGCCUGCCAAAUAUC,28,16,29,21,94
7771,0,URS0000D69E00_12908/1-94,GUUAUUUGAGGUGGUAGAUUUCGUCCGGACCACACGCCGAUGGCAAGACAGGGAAACCGAGAGAUGCAGGAGAAACGGAUGCCUGCCAAAUAUC,28,17,29,20,94
7772,0,URS0000D6979F_12908/1-94,GUUAUUUGAGGUGGUAGACUUCGUCCGGACCACACGCCGAUGGCAAGACAGGGAAACCGAGAGAUGCAGGAGAAACGGACGCCUGCCAAAUAGC,28,14,30,22,94
7773,0,URS0000D6C65D_12908/1-94,GUUAUUUGAGGUGGUAGACUUCGUCCGGACCACACGCCGAUGGCAAGACAGGGAAACCGAGAGAUGCAGGAGAAACGGACGCCUGCCAAAUAUC,28,15,29,22,94
7774,0,URS0000D6A227_12908/1-94,GUUAUUUGAGGUGGUAGACUUCGUCCGGACCACACGCCGAUGGCAAGACAGGGAAACCGAGAGAUGCAGGAGAAACGGACGCCUGCCAAAUGAC,28,14,30,22,94
7775,0,URS0000D6756B_12908/1-94,GUUAUUUGAGGUGGUAGACUUCGUCCGGACCACACGCCGAUGGCAAGACAGGGAAACCGAGAGAUGCAGGAGAAACGGACGCCUGCCGAAUGAC,27,14,31,22,94
7776,0,URS0000D69C89_12908/1-94,GUUAUUUGAGGUGGUAGAUUUCGUCCGGACCACACGCCGAUGGCAAGACAGGGAAACCGAGAGAUGCAGGAGAAACGGACGCCUGCCGAAUGAC,27,15,31,21,94
7777,0,URS0000D693C9_12908/1-94,GUUAUUUGAGGUGGUAGAUUUCGUCUGGACCACACGCCGAUGGCAAGACAGGGAAACCGAGAGAUGCAGGAGAAACGGACACCUGCCAAAUGUC,28,17,29,20,94
7778,0,URS0000D69643_12908/1-96,GUUAUUUGAGGUGGUAAAUUUCGUCCGAACCACACGCCGCCGGUAUGACAGGGGAAACCCGAGAGAUGCAGGAGAAUCGGACGCCUGCCAAAUAAU,28,18,28,22,96
7779,0,URS0000D67752_12908/1-96,GUUAUUUGAGGUGGUAAAUUUCGUCCGAACCACACGCCGACGGUAUGACAGGGGAAACCCGAGAGAUGCAGGAGACUCGGACGCCUGCCGAAUAAU,27,18,29,22,96
7780,0,URS0000D689A4_12908/1-96,GUUAUUUGAGGUGGUAAAUUUCGUCCGAACCACACGCCGACGGUAUGACAGGGGAAACCCGAGAGAUGCAGGAGACGCGGACGCCUGCCAAAUAAU,28,17,29,22,96
7781,0,URS0000D697AE_12908/1-96,GUUAUUUGAGGUGGUAAAUUUCGUCCGAACCACACGCCGACGGUAUGACAGGGGAAACCCGAGAGAUGCAGGAGACGCGGACGCCUGCCGAAUAAU,27,17,30,22,96
7782,0,URS0000D68D25_12908/1-96,GUUGUUUGAGGUGGAAAAUUUCGUUGCGUCCACACGCCGACGGUACUGACAGGGGAAACCCGAGAGAUGCGGGAGCUGCGACGCCCGCCAAAUAGC,23,17,32,24,96
7783,0,URS0000D6AA97_12908/1-86,AAUCUUUGAGGUGGUAAAAUUCGCCGCGGCCACACACCCUACCCGGGUCAGAAGAGAUGCAGGAGAGGCGGCGCCUGCCGAAGGUU,21,14,28,23,86
7784,0,URS0000D6C4EE_12908/1-86,AAUCUUUGAGGUGGUAAAAUUCGCCGCGGCCACACACCCGACCCGGGUCAGAAGAGAUGCAGGAGAGGCGGCGCCUGCCGAAGGUU,21,13,29,23,86
7785,0,URS0000D6C4EE_1262869/1-86,AAUCUUUGAGGUGGUAAAAUUCGCCGCGGCCACACACCCGACCCGGGUCAGAAGAGAUGCAGGAGAGGCGGCGCCUGCCGAAGGUU,21,13,29,23,86
7786,0,URS0000D67D1A_12908/1-83,AGUAUUUGAGGUAGAAAUUGUGCUACUAUGCACCUUUAUACAAGGUUUAAGAGAUGUGGGGAGGGGCACACCCACCAAAUACU,26,22,21,14,83
7787,0,URS0000D6CCD0_12908/1-83,AGUAUUUGAGGUAGAAAUUGUGCUACUAUACACCUUUAUACAAGGUUUAAGAGAUGUGGGGAAGGGCACUCCCACCAAAUACU,27,23,19,14,83
7788,0,URS0000D6BD73_12908/1-84,AGUAUUUGAGGUAGAAAUUUGUGCUACUAUACACCUUGAUACAAGGUUUAAGAGAUGUGGGGAGGGGCACUCCCACCAAAUACU,26,23,21,14,84
7789,0,URS0000D6969E_12908/1-83,GGUAUUUGAGGUAGAAAUUGUGCUACUAUACACCUUGAUACAAGGUUUAAGAGAUGUGGGGAGGGGCACACCCACCAAAUACU,26,21,22,14,83
7790,0,URS0000D681F7_12908/1-83,AGUAUUUGAGGUAGAAAUUGUGCUACUAUACACCUUGAUACAAGGUUUAAGAGAUGUGGGGAGGGGCACUCCCACCAAAUACU,26,22,21,14,83
7791,0,URS0000D6620E_12908/1-83,AGUAUUUGAGGUAGAAAUUGUGCUACUAUACACCUUGAUACAAGGUUUAAGAGAUGUGGGGAGGGGCACUCCCACCAAAUGCU,25,22,22,14,83
7792,0,URS0000D66719_12908/1-83,AGUAUUUGAGGUAGAAAUUGUGCUACUAUACACCUUGAUACAAGGUUUAAGAGAUGUGGGGAAGGGCACUCCCACCAAAUACU,27,22,20,14,83
7793,0,URS0000D672C3_12908/1-84,AGUAUUUGAGGUAGAAAUUUGUGCUACUAUACACCUUGAUACAAGGUUUAAGAGAUGUGGGGAGGGGCACACCCACCAAAUACU,27,22,21,14,84
7794,0,URS0000D65B32_12908/1-83,AGUAUUUGAGGUAGAAAUUGUGCUACUAUACACCUUGAUACAAGGUUUAAGAGAUGUGGGGAGGGGCACACCCACCAAAUACU,27,21,21,14,83
7795,0,URS0000D67388_12908/1-83,AGUAUUUGAGGUAAAAAUUGUGCUACUAUACACCUUUAUGAAAGGUUUAAGAGAUGUGGGGAGGGGCACUCCCACCAAAUACU,27,23,20,13,83
7796,0,URS0000D686A5_12908/1-83,AGUAUUUGAGGUAGAAAUUGUGCUACUAUACACCUUGAUACAAGGUUUAAGAGAUGUGGGGAGGGGCACUCUCACCAAAUACU,26,23,21,13,83
7797,0,URS0000D6BA68_12908/1-83,AGUAUUUGAGGUAGAAAUUGUGCUACUAUACACCUUUAUAAAAGGUUUAAGAGAUGUGGGGAAGGGCACUCCCACCAAAUACU,28,23,19,13,83
7798,0,URS0000D6B411_12908/1-83,AGGCAUUGAAGUGGAGAAUGUGCUACCACGCACCUAGAAAUAGGUCAAAAGAAAUGUAGGAAAGGGCACACCUACCAAUUACC,32,14,20,17,83
7799,0,URS0000D68041_12908/1-83,AGGAAUUGAAGUGGAGAUAGUGCUUCCACGCACCUAGAAAUAGGUCAAAAGAAAUGUAGGAAGGGGCACACCUACCAAUUACC,31,15,21,16,83
7800,0,URS0000D68041_1262812/1-83,AGGAAUUGAAGUGGAGAUAGUGCUUCCACGCACCUAGAAAUAGGUCAAAAGAAAUGUAGGAAGGGGCACACCUACCAAUUACC,31,15,21,16,83
7801,0,URS0000D677F4_12908/1-81,AGGGAUUGAAGUGGAGAUAGUGCUGCCACGCACCUUAUGGGUCAAAAAGAAAUGUAGGAAAGGGCACACCUACCAAUACCU,28,15,22,16,81
7802,0,URS0000D66280_12908/1-80,AGGGAUUGAAGUGGAGAUAGUGCUGCCACGCACCUUAUGGGUCAAAAGAAAUGUAGGAAAGGGCACACCUACCAAUACCU,27,15,22,16,80
7803,0,URS0000D6D2B6_12908/1-81,AGGGAUUGAAGUGGAGAUAAGUGCUGCCACGCACCUUAUAGGUCAAAAGAAAUGCAGGAAAGGGCACCCCUGCCAAUAACC,28,13,22,18,81
7804,0,URS0000D6C9C6_12908/1-81,AGGAAUUGAAGUGGAGAUAAGUGCUACCACGCACCUUAUAGGUCAAAAGAAAUGCAGGAAGGGGCACACCUGCCAAUAGCC,29,13,22,17,81
7805,0,URS0000D673E1_12908/1-107,ACAUUUUGAAGUAGAGAAUGUGCUGCUACACCCCGUAAAGGUUUCGUUUUAGAAAUCUUUUUAAACGGACAAAAGAAAUGCAGGACAGGGCACACCUGCCGAAGUGU,35,27,25,20,107
7806,0,URS0000D68742_12908/1-78,AAUAUCUGAAGUAGAGAAUGUGCUGCUACGCACCGUAAGGUCAAAAGAAAUGCAAGAUUGGCACACUUGCCUGAUAUU,27,19,18,14,78
7807,0,URS0000D67279_12908/1-83,GAUAUUUGAAGUAGAGAUUGUGCUGCUACACACCUAUUAAUAGGUCAAAAGAAAUGCAGGAAAGGGCACACCUGCCAAAUAUC,31,19,18,15,83
7808,0,URS0000D6A9D9_12908/1-79,GAUAUUUGAAGUAGAGAUUGUGCUGCUACACACCCUAGGGUCAAAAGAAAUGCGGGGAGGGGCACUCCCGCCAAAUAUC,24,16,22,17,79
7809,0,URS0000D6A9E4_12908/1-80,GUGCUUUGAAGUAGAGAUUGUGCUGCUACACGCCUUCUGGGCCAAAAGAAAUGCGGGAAGGGGCACACCCGCCAAAGCAC,22,14,24,20,80
7810,0,URS0000D69553_12908/1-80,AAUUAUUGAAGUAGAGAUAGUGCUGCUACGCGCCUAGUGGGCCAAAAGAAAUGUGGGAAGGGGCACACCCACCAAUAAUU,27,16,22,15,80
7811,0,URS0000D65B3D_1262995/1-80,GAUUAUUGAAGUAGAGAUUGUGCUGCUACGCACCUACCGGGUCAAAAGAAAUGCGGGAAAGGGCACACCCGCCAAUAAUC,26,15,21,18,80
7812,0,URS0000D68A61_12908/1-80,GAUUAUUGAAGUAGAGAUUGUGCUGCUACGCACCUACUGGGUCAAAAGAAAUGCGGGAAAGGGCACACCCGCCAAUAAUC,26,16,21,17,80
7813,0,URS0000D6C113_12908/1-79,GAUUAUUGAAGUAGAGACUGUGCUGUUACACACCCUUGGGUCAAAAGAAAUGUGGGAAAGGGCACGCCUACCAAUAAUU,26,19,20,14,79
7814,0,URS0000D6D147_12908/1-80,GAUUAUUGAAGUAGAGACUGUGUUGUUACACACCCCUUGGGUCAAAAGAAAUGUGGGAAAGGGCACACCUACCAAUAAUU,27,20,19,14,80
7815,0,URS0000D6C720_12908/1-80,GAUUAUUGAAGUAGAGACUGUGUUGUUACACACCCCUUGGGCCAAAAGAAAUGUGGGAAAGGGCACACCUACCAAUAAUU,27,19,19,15,80
7816,0,URS0000D6751A_12908/1-80,GAUUAUUGAAGUAGAGACUGUGCUGUUACACACCCCUUGGGUCAAAAGAAAUGUGGGAAAGGGCACACCUACCGAUAAUU,26,19,20,15,80
7817,0,URS0000D68E8D_12908/1-80,GAUUAUUGAAGUAGAGACUGUGCUGUUACACACCCCUUGGGUCAAAAGAAAUGUUGGAAAGGGCACACCUACCAAUAAUU,27,20,18,15,80
7818,0,URS0000D69E46_12908/1-80,GAUUAUUGAAGUAGAGACUGUGCUGUUACACACCCCUUGGGUCAAAAGAAAUGUGGGAAAGGGCACACCUGCCAAUAAUU,26,19,20,15,80
7819,0,URS0000D6C413_12908/1-80,GAUUAUUGAAGUAGAGACUGUGCUGUUACACACCCCUUGGGUCAAAAGAAAUGUGGGAAAGGGCACGCCUACCAAUAAUU,26,19,20,15,80
7820,0,URS0000D67D55_12908/1-80,GAUUAUUGAAGUAGAGACUGUGCUGUUACACACCCCUUGGGUCAAAAGAAAUGUGGGACAGGGCACACCUACCAAUAAUU,26,19,19,16,80
7821,0,URS0000D68B1D_12908/1-80,GAUUAUUGAAGUAGAGACUGUGCUGUUACACACCCCUUGGGUCAAAAGAAAUGUGGGAAAGGGCACACCUACCAAUAAUU,27,19,19,15,80
7822,0,URS0000D68B1D_457412/1-80,GAUUAUUGAAGUAGAGACUGUGCUGUUACACACCCCUUGGGUCAAAAGAAAUGUGGGAAAGGGCACACCUACCAAUAAUU,27,19,19,15,80
7823,0,URS0000D685EE_12908/1-80,GAUUAUUGAAGUAGAGACUGUGCUGUUACACACCCCUUGGGUCAAAAGAAAUGUGGGAAAGGGCACAUCUACCAAUAAUU,27,20,19,14,80
7824,0,URS0000D67E39_742737/1-80,GAUUAUUGAAGUAGAGAAUGUGCUGCUACGCACCUUAUGGGUCAAAAGAAAUGUGGGAAGGGGUACACCCACCAAUAAUC,27,18,21,14,80
7825,0,URS0000D680F0_12908/1-80,AAUUAUUGAAGUAGAGAUUGUGCUGCUACACACCCUCGCGGUCAAAAGAAAUGUGGGAAAGGGCACACCCACCAAUAAUU,28,17,18,17,80
7826,0,URS0000D6BADE_12908/1-80,AAUUAUUGAAGUAGAGAUUGUGCUGCUACACACCCUAUGGGUCAAAAGAAAUGUGGGAAGGGGCACACCCACCAAUAAUU,28,18,19,15,80
7827,0,URS0000D6B1B3_657314/1-80,AAUUAUUGAAGUAGAGAAUGUGCUGCUACACACCCUAUGGGUCAAAAGAAAUGUAGGAAGGGGCACACCCGCCAAUAAUU,29,17,19,15,80
7828,0,URS0000D6C1D9_1235798/1-80,AAUUAUUGAAGUAGAGAAUGUGCUGCUACGCACCCUUUGAGUCAAAAGAAAUGUGGGAAGAGGCACAUCCGCCAAUAAUU,28,19,19,14,80
7829,0,URS0000D691AF_12908/1-80,AAUUAUUGAAGUAGAGAUUGUGCUGCUACACACCCACAGGGUUAAAAGAAAUGCGGGAUAGGGCACACCCGCCAAUAAUU,28,17,19,16,80
7830,0,URS0000D65FB9_12908/1-79,AAUAUUUGAAGUAGAGAUUGUGCUGCUACGCACCUUCGGGUCAAAAGAAAUGUGGGACGGGGCACACCCACCAAAUAUU,25,18,20,16,79
7831,0,URS0000D6A90E_12908/1-80,GAUAUUUGAAGUAGAGAUUGUGCUGCUACGCACCCAUUGGGUCAAAAGAAAUGUGGGAGAGGGCACACCCACCAAAUAUC,26,17,21,16,80
7832,0,URS0000D66314_12908/1-80,GGCAAUUGAAGUAGAGAUUGUGCUGCUACGCACCCUCUGAGUCAAAAGAAAUGCGGGAAGGGGCACACCCGCCAAUUGCC,23,14,23,20,80
7833,0,URS0000D68A8C_877414/1-80,GACGUUUGAAGUAGAGAUUGUGCUGCUACGCACCCUUUGGGUCAAAAGAAAUGCGGGAAGGGGCACACCCGCCAAAUGUC,22,16,24,18,80
7834,0,URS0000D67476_12908/1-80,AGCGUUUGAAGUAGAGAAUGUGCUGCUACACGCCCCUUGGGCCAAAAGAAAUGCGGGAAAGGGCACACCCGCCAAAUGCU,24,13,23,20,80
7835,0,URS0000D69542_12908/1-80,GGCAUUUGAAGUAGAGAUUGUGCUGCUACACGCCCAUUGGGCCAAAAGAAAUGCGGGAAAGGGCACACCCGCCAAGUGCG,23,13,25,19,80
7836,0,URS0000D678FB_12908/1-80,UGCAUUUGAAGUAGAGAAUGUGCUGCUACACGCCCAUUGGGCCAAAAGAAAUGUGGGAAGGGGCACACCCACCAAAUGCC,25,14,22,19,80
7837,0,URS0000D67B9F_12908/1-80,UGCAUUUGAAGUAGAGAAUGUGCUGCUACACGCCUAUCGGGCCAAAAGAAAUGUGGGAAGGGGCACACCCACCAAAUGCC,25,14,22,19,80
7838,0,URS0000D66E75_12908/1-80,UGCAUUUGAAGUAGAGAAUGUGCUGCUACACGCCCAUCGGGCCAAAAGAAAUGUGGGAAGGGGCACACCCACCAAAUGCC,25,13,22,20,80
7839,0,URS0000D68C6F_12908/1-80,UGCAUUUGAAGUAGAGAUUGUGCUGCUACACGCCCACUGGGCCAAAAGAAAUGCGGGAAGGGGCACACCCGCCAAAUGCC,23,13,23,21,80
7840,0,URS0000D6A216_12908/1-80,UGCAUUUGAAGUAGAGAUUGUGCUGCUACGCGCCCACUGGGCCAAAAGAAAUGCGGGAAGGGGCACACCCGCCAAAUGCC,22,13,24,21,80
7841,0,URS0000D67EB8_12908/1-80,UGCAUUUGAAGUAGAGAUUGUGCUGCUACGCGCCCAUUGGGCCAAAAGAAAUGCGGGAAGGGGCACACCCGCCAAAUGCC,22,14,24,20,80
7842,0,URS0000D66842_12908/1-80,UGCAUUUGAAGUAGAGAAUGUGCUGCUACACACCCACUGGGUCAAAAGAAAUGCGGGAACGGGCACACCCGCCAGAUGCA,25,13,22,20,80
7843,0,URS0000D6BDE4_12908/1-80,UGCAUUUGAAGUAGAGAGCGUGCUGCUACACACCCACUGGGUCAAAAGAAAUGCGGGAACGGGCACACCCGCCAGAUGCA,24,12,23,21,80
7844,0,URS0000D6966B_12908/1-80,UGCAUCAGAAGUAGAGAUUGUGCUGCUACACACCCUUUGGGCCAAAAGAGAUGCGGGAAGGGGCACACCCGCCUGAUGAA,23,14,24,19,80
7845,0,URS0000D67185_12908/1-80,UGUAUCAGAAGUAGAGAUUGUGCUGCUACACACCCUUUGGGUCAAAAGAGAUGCGGGAAGGGGCACACCCGCCUGAUGCA,22,16,24,18,80
7846,0,URS0000D6CA94_12908/1-80,UGCAUCAGAAGUAGAGAUUGUGCUGCUACACACCCUUUGGGUCAAAAGAGAUGCGGGAAGGGGCACACCCGCCUGAUGCA,22,15,24,19,80
7847,0,URS0000D68526_12908/1-80,AGCAUUUGAAGUAGAGAUUGUGCUGCUACACACCCUCUGGGUCAAAAGAAAUGCGGGAAGGGGCACACCCGCCUGAUGCA,23,15,23,19,80
7848,0,URS0000D68C10_12908/1-80,AGCAUUUGAAGUAGAGAUUGUGCUGCUACACACCCUCUGGGUCAAAAGAAAUGCGGGAAGGGGCACACCCGCCGGAUGCA,23,14,24,19,80
7849,0,URS0000D6AFAD_12908/1-80,GCAUUUUGAAGUAGAGAAUGUGCUGCUACACACCCUUGUGGUCAAAAGAAAUGUGGGAAAGGGCACACCCACCAAAAUGC,27,16,20,17,80
7850,0,URS0000D675A4_12908/1-79,GUAUUUUCAAGUAGAGAUAAGCUGCUACGCACCCUCUGGGUCAAAAGAAAUGUGGGAAAGGGCACACCCACCAAAAUAC,28,15,18,18,79
7851,0,URS0000D66721_12908/1-80,GUAUUUUGAAGUAGAGAUUGUGCUGCUACGCACCUUUUAGGUCAAAAGAAAUGUGGGAAAGGGCACACCCACCAAAAUAC,27,19,19,15,80
7852,0,URS0000D67A54_12908/1-80,GUAUUUUGAAGUAGAGAUUGUGCUGCUACGCACCCUUUGGGUCAAAAGAAAUGUGGGAAGGGGCACACCCACCAAAAUAU,25,19,21,15,80
7853,0,URS0000D6C36E_12908/1-80,GUGUUUUGAAGUAGAGAUUGUGCUGCUACGCACCCUAUGGGUCAAAAGAAAUGUGGGAAAGGGCACCCCCACCAAAAUAC,25,17,21,17,80
7854,0,URS0000D69D29_12908/1-80,GUGUUUUGAAGUAGAGAUUGUGCUGCUACGCACCCUAUGGGUCAAAAGAAAUGUGGGAAAGGGCACACCCACCAAAAUAC,26,17,21,16,80
7855,0,URS0000D69D29_1262816/1-80,GUGUUUUGAAGUAGAGAUUGUGCUGCUACGCACCCUAUGGGUCAAAAGAAAUGUGGGAAAGGGCACACCCACCAAAAUAC,26,17,21,16,80
7856,0,URS0000D6914D_12908/1-80,GUAUUUUGAAGUAGAGAUUGUGCUGCUACACACCCUCCGGGUCAAAAGAAAUGUGGGAAAGGGCACACCCACCAAAAUAC,27,16,19,18,80
7857,0,URS0000D6D354_12908/1-80,GUAUUUUGAAGUAGAGAUUGUGCUGCUACGCACCCUCUGGGUCAAAAGAAAUGUGGGAAAGGGCACACCCACCAAAAUAC,26,17,20,17,80
7858,0,URS0000D68646_12908/1-80,GUAUUUUGAAGUAGAGAAUGUGCUGCUACGCACCCUAUGGGUCAAAAGAAAUGUGGGAAAGGGCACACCCACCGAAAUAC,27,16,21,16,80
7859,0,URS0000D6A1D2_12908/1-80,GUAUUUUGAAGUAGAGAAUGUGCUGCUACGCACCCUUGUGGUUAAAAGAGAUGUGGGAAUGGGCACACCCACCAAAAUAC,25,19,21,15,80
7860,0,URS0000D67C98_12908/1-80,GUGUUUUGAAGUAGAGAUCGUGCUGCUACACACCCUUGUGGUCAAAAGAAAUGUGGGAAGGGGCACACCCACCAAAAUGC,24,17,22,17,80
7861,0,URS0000D67AEE_12908/1-80,GUGUUUUGAAGUAGAGAUCGUGCUGCUACACACCCUCGUGGUCAAAAGAAAUGUGGGAAGGGGCACACCCACCAAAAUGC,24,16,22,18,80
7862,0,URS0000D662EA_12908/1-80,GUAUUUUGAAGUAGAGAUUGUGCUGCUACGCACCCUUGUGGUCAAAAGAAAUGUGGGAAGGGGCACACCCACCAAAAUAC,25,18,21,16,80
7863,0,URS0000D6976C_12908/1-80,GCAUUUUGAAGUAGAGAUUGUGCUGCUACGCACCCUCGGGGUCAAAAGAAAUGUGGGAAGGGGCACACCCGCCAAAAUGC,23,15,24,18,80
7864,0,URS0000D6A7C5_12908/1-79,GUAUUUUGAAGUAGAGAUUGUGCUGCUACGCACCUUAAUGGUUAAAAGAAAUGUGGGAAAGGGCACACCCACCAAAUAC,27,19,19,14,79
7865,0,URS0000D6818B_12908/1-78,GGUAUUUGAAGUAGAGAAUGUGCUGCUACGCACCAUAAGGUCAAAAGAAAUGUGGAAUUGGCACUUCCACCAAAUACC,27,18,18,15,78
7866,0,URS0000D6B252_1034346/1-78,GGUAUUUGAAGUAGAGAAUGUGCUGCUACGCACCGUAAGGUCAAAAGAAAUGUGGAAUUGGCACUUCCACCAAAUACC,26,18,19,15,78
7867,0,URS0000D688EE_12908/1-79,UGGUUUAGAAGUAGAGAAUGUGCUGCUACACACCCUUUGGGUCAAAAGAAAUGUGGGGUUGGCACUCCCACCGUAACCA,22,19,21,17,79
7868,0,URS0000D68E07_12908/1-78,UGGUUUAGAAGUAGAGAAUGUGCUGCUACGCACCCUUUGGGUCAAAAGAAAUGUGGAAUUGGCACACCACCGUAACCA,24,18,20,16,78
7869,0,URS0000D69ACF_12908/1-78,UGGUUUGGAAGUAGAGAAUGUGCUGCUACGCACCCUUUGGGUCAAAAGAAAUGUGGAAUUGGCACACCACCGUAACCA,23,18,21,16,78
7870,0,URS0000D65BC0_12908/1-80,UUUAUUUGAAGUAGAGAUUGUGCUGCUACGCACCCGCCGGGUCAAAAGAAAUGCAGGAAGGGGCACCCCUGCCAAAUAAA,25,16,21,18,80
7871,0,URS0000D67DA1_12908/1-84,AUUAUUUGAGGUAGACAAUUGUGCCAUCUACACACCUUUUAAAGGUCAAAAGAGAUACAGGAUGUGGCACACCUGUCAAAUAAU,30,23,16,15,84
7872,0,URS0000D6A5A3_12908/1-85,GCUAUUUGAAGUGGACAAUUGUGCCAUCCACACACCUAGAAAUAGGUCAAAAGAGAUGCAGGAAGUGGUACACCUGCCAGAUAAC,30,17,20,18,85
7873,0,URS0000D65BE0_12908/1-82,GUUAUUUGAGGUGGACAAUAGUGCCAUCCACGCACCUAAAUGGUCAAAAGAGAUGCAGGAAACGGCACACCUGCCAAAUAAA,30,15,19,18,82
7874,0,URS0000D65832_12908/1-82,GUUAUUUGAGGUGGACAAUAGUGCCAUCCACGCACCUAAAUGGUCAAAAGAGAUGCAGGAAACGGCACACCUGCCAAAUAAC,29,15,19,19,82
7875,0,URS0000D6CC8D_12908/1-89,GUUGUUUGAAGUGGACAAUUGUGCCCUCCACACACCUACUAAUAAAUAGGUCAAAAGAGAUGUAGGAUUUGGCACACCUACCAAAUAGC,30,22,18,19,89
7876,0,URS0000D68A4B_12908/1-89,GUUAUUUGAAGUGGACAAUUGUGCCCUCCACACACCUACUAAUAAAUAGGUCAAAAGAGAUGUAGGAUUUGGCACACCUACCAAAUAGC,31,22,17,19,89
7877,0,URS0000D6CC3C_12908/1-82,GUUAUUUGAAGUGGACAAUAGUGCCAUCCACACACCAUAGUGGUCAAAAGAGAUGCAGGAUUUGGCACACCUGCCAAAUAAC,28,18,18,18,82
7878,0,URS0000D6576D_12908/1-82,GUUAUUUGAAGUGGACAAUAGUGCCAUCCACACACCAUAGUGGUCAAAAGAGAUGCAGGAUUUGGCAUACCUGCCAAAUAAC,28,19,18,17,82
7879,0,URS0000D6C545_1262801/1-82,GUUAUUUGAAGUGGACAAUAGUGCCAUCCACACACCCUAGUGGUCAAAAGAGAUGCAGGACUUGGUACACCUGCCGGAUAAC,25,18,20,19,82
7880,0,URS0000D65AF8_12908/1-82,GUUAUUUGAAGUGGACAAUAGUGCCAUCCACACACCCUAGUGGUCAAAAGAGAUGCAGGAUUUGGCACACCUGCCAAAUAAC,27,18,18,19,82
7881,0,URS0000D65AF8_1262812/1-82,GUUAUUUGAAGUGGACAAUAGUGCCAUCCACACACCCUAGUGGUCAAAAGAGAUGCAGGAUUUGGCACACCUGCCAAAUAAC,27,18,18,19,82
7882,0,URS0000D69998_12908/1-84,GUUAUUUGAAGUGGACAAUAGUGCCAUCCACACACAUUUAAAAGGGUAAAAGAGAUGCAGGACUUGGCACACCUGCCAAAUAUC,30,19,18,17,84
7883,0,URS0000D66C01_12908/1-80,ACUAUUUGAAGUGGAGAUUGUGCUUCCACGCACCCUAGUGGUCAAAAGAGAUGCAGGAUUUGGCACACCUGCCAAAUAAC,24,19,19,18,80
7884,0,URS0000D6BCDE_12908/1-84,GUUAUUUGAGGUAGACAAUAGUGCCAUCCACACACCUUUAAAAUGUCAAAAGAAAUGCAGGACUUGGUACACCUGCCAAAUAGC,30,20,16,18,84
7885,0,URS0000D69A02_12908/1-84,UAGCUUUGAGGUGGUAAACUUCGUUGCAACCACGCGCCCUAGUGGCUAAAAGAGAUGCAGGAGCCGCGACGCCUGCCGAGGUCA,20,16,26,22,84
7886,0,URS0000D67219_12908/1-84,AACCUUUGAGGUGGUAAACUUCGUUGCAACCACGCGCCCUUGUGGCUAAAAGAGAUGCAGGAGUCGCGACGCCUGCCAAGGGAA,22,16,25,21,84
7887,0,URS0000D6D228_12908/1-84,CGGCUUUGAGGUGGUAAAUUCCGUUGCAACCACGCGCCCUUGUGGCUAAAAGAGAUGCAGGAGCCGCGACGCCUGCCAAAGCCG,19,15,26,24,84
7888,0,URS0000D6C6DC_12908/1-83,GGUCUUUGAGGUGGUAAAGUUCGUUGCUACCACGCGCCUUCGGGCUAAAAGAGAUGCAGGAGAGGCGACGCCUGCCAAAGACC,20,16,27,20,83
7889,0,URS0000D677EB_12908/1-83,GGCCUUUGAGGUGGUAAAGUUCGUUGCUACCACGCGCCUUCGGGCUAAAAGAGAUGCAGGAGAGGCGACGCCUGCCAAAGACC,20,15,27,21,83
7890,0,URS0000D6BD52_12908/1-83,GGUCUUUGAGGUGGUAAAGUUCGUUGCUACCACGCGCCUUCGGGCUAAAAGAGAUGCAGGAGAGGCGACGCCUGCCGGAUGGU,17,18,30,18,83
7891,0,URS0000D67333_12908/1-84,GAUAUUUGAGGUGGUAAAUUUCGUUGCAACCACACACCCAUUGGGUCAAAAGAGAUGCUAUAGAGGCGACGGUAGCCAAAUAUC,27,20,21,16,84
7892,0,URS0000D68E36_12908/1-82,GUUAUUUGAGGUAAUAAAUUGUGUCAACUACGCACUCUAUGAGACAAAAGAGAUGCAAGAAAUGAUACACCUACCAAAUAAC,34,20,14,14,82
7893,0,URS0000D6AA61_12908/1-82,GUUAUUUGAGGUGGUAAAUUGUGUCAACCACACACCUUAUAGGUCAAAAGAGAUGUAGGAAAUGAUACACCUACCAAAUAAC,31,21,16,14,82
7894,0,URS0000D6A8F0_12908/1-82,GUUAUUUGAGGUGGUAAAAUGUUGCAACCACACACCCUAGAGGUCAAAAGAGAUGUAGGAACGGCGACUCCUACCAAAUAAC,29,17,19,17,82
7895,0,URS0000D6B66F_12908/1-84,AUCGUUAGAGGUGGCAAAUUUCGUUGCAACCACGCACCCUAUAGGUUAAAAGAGAUGCAAGAGAUGUGACGCUUGCCUAACGGU,25,20,22,17,84
7896,0,URS0000D6CDE8_12908/1-93,AUCGUUAGAGGUGGUAAAUUUCGUUGCAACCACGCACCCUAUAGGUUAAAAGAGAUGCAAGAGAUGCAAGAGAUGUGACGCUUGCCUAACGGU,29,22,25,17,93
7897,0,URS0000D68CCF_12908/1-84,AUCGUUAGAGGUGGCAAAUUUCGUUGCAACCACGCACCCUAUGGGUUAAAAGAGAUGCAAGAGAUGUGACGCUUGCCUAACGGU,24,20,23,17,84
7898,0,URS0000D6B336_12908/1-84,AUCGUUAGAGGUGGUAAAUUUCGUUGCAACCACGCACCCUAUGGGUUAAAAGAGAUGCAAGAGAUGUGACGCUUGCCUAACGGU,24,21,23,16,84
7899,0,URS0000D6AE39_12908/1-84,AUCGUUAGAGGUGGUAAAUUUCGUUGCAACCACGCACACUAUGGGUUAAAAGAGAUGCAAGAGAUGUGACGCUUGCCUAACGGU,25,21,23,15,84
7900,0,URS0000D67EEA_12908/1-83,AUCCCUCGAGGUGGUAAAUUUCGUUGCAACCACGCACCUUCGCGGUCAAAGAGAUGCAGGAGAGGCGACGCCUGCCGAGGGAU,20,15,26,22,83
7901,0,URS0000D65840_12908/1-83,AUCCCUCGAGGUGGUAAAUUCGUUGCAACCACGCACCUUCGCGGUCAAAAGAGAUGCAGGAGAGGCGACGCCUGCCGAGGGAU,21,14,26,22,83
7902,0,URS0000D6B005_12908/1-84,AUCCCUCGAGGUGGUAAAUUUCGUUGCAACCACGCACCUUCGCGGUCAAAAGAGAUGCAGGAGAGGCGACGCCUGCCGAGGGAU,21,15,26,22,84
7903,0,URS0000D6AF1F_12908/1-86,AUCCCUCGAGGUGGUAAAAUUUCGUUGCAACCACGCACCUUCGCGGUCAAAAAGAGAUGCAGGAGAGGCGACGCCUGCCGAGGGAU,23,15,26,22,86
7904,0,URS0000D698D9_12908/1-85,AUCCCUCGAGGUGGUAAAUUUCGUUGCAACCACGCACCUUCGCGGUCAAAAAGAGAUGCAGGAGAGGCGACGCCUGCCGAGGGAU,22,15,26,22,85
7905,0,URS0000D65F2E_12908/1-84,AUCCCUCGAGGUGGUAAAUUCCGUUGCAACCACACACCUUUACGGUCAAAAGAGAUGCAGGAGAGGCGACGCCUGCCGAGGGAU,23,15,24,22,84
7906,0,URS0000D6B9D4_12908/1-85,AUUGUUUGAGGUGGUAAAUUCCGCUGCAACCACGCGCCCUUUGGGCUAAAAGAGAUGUAGGAGACGGCAGCGCCUACCAAACAAU,24,18,23,20,85
7907,0,URS0000D69F5E_12908/1-84,AUUGCUUGAGGUGGUAAAAUUCGUUGCAACCAUGCGCCCUUUGGGCUAAAAGAGAUGUAGGAGAGGCGACGCCUACCAAGCAAU,24,19,24,17,84
7908,0,URS0000D68BA3_12908/1-84,AUUGUUUGAGGUGGUAAAUUCCGCUGCAACCACGCGCCCUUUGGGCUAAAAGAGAUGUAGGAGAGGCGACGCCUACCAAGCAAU,23,18,24,19,84
7909,0,URS0000D6C83F_478749/1-84,GUUAUCUGAGGUGGUAAAUUUCGUUGCAACCACGCGCCCACUGGGCUAAAAGAGAUGCAGGAGCGGCGACGCCUGCCGGAUAGC,20,16,27,21,84
7910,0,URS0000D6A1A2_12908/1-84,GUUAUUCGAGGUGGUAAAAUUCGUUGCAACCACACACCCUAGUGGUCAAAAGAGAUGCAGGAGAGGCGACGCCUGCCGGAUAAC,25,16,24,19,84
7911,0,URS0000D6CD37_12908/1-84,GUUAUUUGAGGUGGUAAAAUUCGUUGCAACCAUGCACCCUAUGGGUUAAAAGAGAUGUAGGAGAGGCGACGCCUACCAAAUAAC,27,20,22,15,84
7912,0,URS0000D66D58_12908/1-84,GUUAUUUGAGGUGGUAAAAUUCGUUGCAACCACGCACCCUAUGGGUUAAAAGAGAUGUAGGAGAGGCGACGCCUACCAAAUAAC,27,19,22,16,84
7913,0,URS0000D66C96_12908/1-84,AUUAUUUGAGGUAGCAAAUUUCGUUGCAACCACGCACCCGAUGGGUUAAAAGAGAUGCAGGGGCUGCGACGCCUGCCAAAUAAU,25,19,22,18,84
7914,0,URS0000D6B0E2_12908/1-84,GUUAUUUGAGGUGGUAAAAUACGUUGCAACCACGCACCCUAUGGGUUAAAAGAGAUGCAGGAGCCGCGACGCCUGCCAAAUAAC,26,17,22,19,84
7915,0,URS0000D6B944_658656/1-84,AUUAUUUGAGGUGGUAAAUUUCGUUGCAACCACGCACCCUAUGGGUUAAAAGAGAUGCAGGAUCCGCGACGCCUGCCAAAUAAU,25,21,20,18,84
7916,0,URS0000D69218_12908/1-84,AUUAUUUGAGGUGGUAAAUUUCGUUGCAACCACGCACUCUAUGGGUUAAAAGAGAUGCAGGAGCCGUGACGCCUGCCAAAUAAU,25,22,21,16,84
7917,0,URS0000D6CBEC_12908/1-84,AUUAUUUGAGGUGGUAAAUUUCGUUGCAACCACGCACCCUAUGGGUUAAAAGAGAUGCAGGAGCCGCGAUGCCUGCCAAAUAAU,25,21,21,17,84
7918,0,URS0000D69F61_12908/1-84,AUUAUUUGAGGUGGUAAAUUUCGUUGCAACCACGCACCCUAUGGGUUAAAAGAGAUGCAGGGGCCGCGACGCCUGCCAAAUAAU,24,20,22,18,84
7919,0,URS0000D6CF5E_12908/1-84,AUUAUUUGAGGUGGUAAAUUUCGUUGCAACCACGCACUCUAUGGGUUAAAAGAGAUGCAGGAGCCGCGACGCCUGCCAAAUAAU,25,21,21,17,84
7920,0,URS0000D69FAE_12908/1-84,AUUAUUUGAGGUGGUAAAUUUCGUUGCAACCACGCACCCUAUGGGUUAAAAGAGAUGCAGGAGCCGCGACGCCUGCCAAAUAAU,25,20,21,18,84
7921,0,URS0000D69FAE_1262842/1-84,AUUAUUUGAGGUGGUAAAUUUCGUUGCAACCACGCACCCUAUGGGUUAAAAGAGAUGCAGGAGCCGCGACGCCUGCCAAAUAAU,25,20,21,18,84
7922,0,URS0000D65F38_12908/1-84,AUUAUUUGAGGUGGUAAAUUUCGUUGCAACCACGCACUCUAUGGGUUAAAAGAGACGCAGGAGCCGCGACGCCUGCCAAAUAAU,25,20,21,18,84
7923,0,URS0000D6C95B_12908/1-84,AUUAUUUGAGGUGGUAAAUUUCGUUGCACCCACGCCCCCUAUGGGUUAAAAGAGAUGCAGGAGCCGCGACGCCUGCCAAAUAAU,23,20,21,20,84
7924,0,URS0000D6B9FD_12908/1-84,AUUAUUUGAGGUGGUAAAUUUCGUUGCAACCACACACCCUAUGGAUUAAAAGAGAUGCAGGAGCCGCGACGCCUGCCAAAUAAU,27,20,19,18,84
7925,0,URS0000D6CEDD_12908/1-84,GUUGUUUGAGGCGGUAAAUUCCGUUGCAACCACGCACCCUAUGGGUUAAAAGAGAUGCAGGAGCCGCGACACCUGCCAAAUAAC,24,17,22,21,84
7926,0,URS0000D6A7AC_12908/1-84,ACUAUCCGAGGUGGUAAAUUUCGUUGCAACCACGCACCCUAUGGGUCAAAAGAGAUGCAGGAGAGGCGACGCCUGCCAAAGACC,25,14,23,22,84
7927,0,URS0000D681A2_12908/1-84,ACUGUUUGAGGUGGUAAAAUACGUUGCAACCACGCACCCUAUGGGUCAAAAGAGAUGCAGGAGAGGUGACUCCUGCCAGAUAGU,25,18,24,17,84
7928,0,URS0000D67743_12908/1-84,ACUGUUUGAGGUGGUAAAAUACGUUGCAACCACGCACCCUAUGGGUCAAAAGAGAUGCAGGAGAGGUGACGCCUGCCAGAUAGU,25,17,25,17,84
7929,0,URS0000D66802_12908/1-83,ACUAUCCGAGGUGGUAAAUUUCGUUGCAACCACGCCCCUAUGGGUCAAAAGAGAUGCAGGAGAGGCGACGCCUGCCGGAUGGU,21,16,26,20,83
7930,0,URS0000D6970D_12908/1-84,ACUAUCUGAGGUGGUAAAAUUCGUUGCAACCACGCACCCUAUGGGUCAAAAGAGAUGCAGGAGAGGCGACGCCUGCCAGAUGGU,24,16,25,19,84
7931,0,URS0000D664EA_12908/1-84,ACUAUCUGAGGUGGUAAAUUUCGUUGCAACCACGCACCCUAUGGGUCAAAAGAGAUGCAGGAGAGGCGACGCCUGCCGGAUAGU,23,17,25,19,84
7932,0,URS0000D6A028_12908/1-84,ACUAUCCGAGGUGGUAAAUUUCGUUGCAACCACGCACCCUAUGGGUCAAAAGAGAUGCAGGAGAGGCGACGCCUGCCGGAUGGU,22,16,26,20,84
7933,0,URS0000D6A028_1262845/1-84,ACUAUCCGAGGUGGUAAAUUUCGUUGCAACCACGCACCCUAUGGGUCAAAAGAGAUGCAGGAGAGGCGACGCCUGCCGGAUGGU,22,16,26,20,84
7934,0,URS0000D6751D_12908/1-84,ACUAUCCGAGGUGGUAAAUUUCGUUGCAGCCACGCACCCUAUGGGUCAAAAGAGAUGCAGGAGAGGCGACGCCUGCCGGAUGGU,21,16,27,20,84
7935,0,URS0000D65B27_12908/1-84,UUUAUCUGAGGUGGUAAAUUUCGUUGCAACCACGCACCCUAUGGGUCAAAAGAGAUGCAGGAGAGGCGACGCCUGACGGAUAGU,23,19,25,17,84
7936,0,URS0000D65B27_1262816/1-84,UUUAUCUGAGGUGGUAAAUUUCGUUGCAACCACGCACCCUAUGGGUCAAAAGAGAUGCAGGAGAGGCGACGCCUGACGGAUAGU,23,19,25,17,84
7937,0,URS0000D6B33B_12908/1-84,UUUAUCUGAGAUGGUAAAUUUCGUUGCAACCACGCACCCUAUGGGUCAAAAGAGAUGCAGGAGAAGCGACGCCUGCCGGAUAGU,24,19,23,18,84
7938,0,URS0000D6C9FA_742737/1-84,AUUAUCUGAGGUGGUAAAUUUCGUUGCAACCACGCACCCUCUGGGUCAAAAGAAAUGCAGGAGAGGCGACGCCUGCCAGAUAAU,25,18,22,19,84
7939,0,URS0000D68C8D_1262824/1-84,GUUAUCUGAGGUGGUAAAUUUCGUUGCAACCACGCACCCUAGCGGUCAAAAGAGAUGCAGGAGAGGCGACGCCUGCCGGAUAAC,23,16,25,20,84
7940,0,URS0000D6B55A_12908/1-84,GUUAUUCGAGGUGGUAAAAUUCGUUGCAACCACGCACCCAAGUGGUCAAAAGAGAUGCAGGAGAGGCGACGCCUGCCGGAUAAC,25,15,25,19,84
7941,0,URS0000D6C2A2_12908/1-84,GUUAUUCGAGGUGGUAAAUUUCGUUGCAACCACGCACCCUUUGGGUCAAAAGAGAUGCAGGAGAGGCGAUGCCUGCCGAAUAAC,23,19,24,18,84
7942,0,URS0000D68D9D_12908/1-84,GUUAUUCGAGGUGGUAAAUUUCGUUGCAACCACGCACCCUUUGGGUCAAAAGAGAUGCAGGAGAAGCGACGCCUGCCGGAUAAC,23,18,24,19,84
7943,0,URS0000D691E6_12908/1-84,GUUAUUCGAGGUGGUAAAUUUCGUUGCAACCACGCACCCUUUGGGUCAAAAGAGAUGCAGGAGAUGCGACGCCUGCCGAAUAAC,23,19,23,19,84
7944,0,URS0000D699D5_12908/1-84,GUUGUUCGAGGUGGUAAAAUUCGUUGCAACCACGCACCCAUUGGGUCAAAAGAGAUGCAGGAGAGGCGACGCCUGCCGAGUAAC,23,16,26,19,84
7945,0,URS0000D68B6C_12908/1-85,ACUAUUUGAGGUGGUAAAUUUCGCUGCAACUACACACCCUACGGAUUAAAAAGAGAUGCAGGAGCCGCGGCACCUGCCAAAUACU,27,18,19,21,85
7946,0,URS0000D67A86_12908/1-81,AAUAUUUGAAGUAGAGAAUGUGCUUCUACGUACAUUUUAAGGUCAUAAGAGAUACAGGAAAGGGUACACCUGUCAAAUAAC,31,22,17,11,81
7947,0,URS0000D6CEC7_12908/1-80,AAUUAUCGAAGGAGAGAUUGUGCUGCUACACACCCCUUGGGUCAAAAGAAAUGUGGGAAAGGGCACACCCACUGAUAAUU,27,17,20,16,80
7948,0,URS0000D6A61E_12908/1-83,AAUAUUUGAAGUGGAGAAUGUGCUUCCACACACCUGGAGACAGGUCAAAAGAAAUGUAGGAAAGGGUACACCUACCUUAUAUU,30,20,19,14,83
7949,0,URS0000D6A919_12908/1-83,AAACCAUGAGGUGGUAAAUUUCGUUGCUGCCACACGCCUACACGGCCAAAGAGAUGCAGGAGAGGCGACGCCUGCCGUGGUUC,21,15,25,22,83
7950,0,URS0000D6CE33_12908/1-83,GAACCAUGAGGUGGUCAAUUUCGUCGUUGCCACGCGCCUAAACGGCCAAAGAGAUGCAGGAGAGGCGACGCCUGCCAUGGUUU,20,16,26,21,83
7951,0,URS0000D6B6DC_12908/1-87,UGCAUCAGAAGUAGAAAUUGUGCCGCUACGCGCCUCCUUGGAGGUUACAAAAUGAAGUGCGGGACGCUGGCACACCCGCCUGAUGAA,23,17,25,22,87
7952,0,URS0000D684E5_12908/1-87,UGCAUCAGAAGUAGAAAUUGUGCCGCUACGCGCCUCCUUGGAGGUUACAAAAUGAAGUGCGGGACGCUGGCACACCCGCCUGAUGCA,22,17,25,23,87
7953,0,URS0000D6AE03_12908/1-88,GUUCUUUGAGGUGGAGAUUUAGUGUCGCCACACACCUCCGCAAGGAGGUUAGCAAGAGAUGCAGGGACAGGCACACCUGCCAAAGGAC,24,16,27,21,88
7954,0,URS0000D66120_12908/1-86,AUAUUUUGAAGUGGAGAACGUGCUGCCAUACACCUGCGUAUGCGGGUUAUAAAGAGAUGCGGGAGAAGGCACACCCGCCGAAAUAU,26,18,25,17,86
7955,0,URS0000D6CA5E_12908/1-82,GGUUCCCAAGGUGGUAAAGUGUGGCAACCACGCGCCUUUCGGGCUAAAAGAGAUGCAGGGACAGCCACUCCUGCUGGGAACU,20,15,26,21,82
7956,0,URS0000D6B8F4_12908/1-96,AUUCUUUGAGGUGGUAAAUUUCGCGUCAACCACACGCCGCCGGUACAGACAGGGAAAUCUGAGAGAUGCAGGGGAACGGCACGCCUGCCAAAGAAU,28,17,28,23,96
7957,0,URS0000D68203_12908/1-88,GCUACAUGAGGUAGAGAUAGACUGCUUCUACGCGCCUGCUUUGCAGGUCAAAAGAGAUGCGGGAUCCGGCGCAGGCCCGCCAUGUACA,21,17,27,23,88
7958,0,URS0000D6B6E9_12908/1-123,GCAGGUUGAGGAUAGAACGGGCAGCUAUCACCCCUGCCAAGAGUUGAUCGUACUGUAGAGUUCUAUGAGAACUACAGUCCAGGGCUUGGAAAGAGAUGCGGGGGUGCCGACCCGCCAACCUGC,31,23,39,30,123
7959,0,URS0000D6B5FE_12908/1-85,GGCUUUAGAGGGUGGAACAGGCAGCCGCCGCACCUGUAAAAAGCAGGUCUAAAGAGAUCCGGGAUACGCCUCCCCGGCUAAGGUC,22,13,27,23,85
7960,0,URS0000D65C90_12908/1-72,CAUUUGUGAGGAUAGAACGGGCAUCUAUCGUCCUUAGUUUGAAGAUGUAGGGUUGUCAACCUACCAUAAGUG,19,22,19,12,72
7961,0,URS0000D6CA47_12908/1-82,GGUUAUUGAGGAAUAGGCAAGGCAACUAUUACGCCAGAAAUGGUAGCAAAGGUAUCUGGGAUACGCCGCCCCACCAGUAACC,26,15,22,19,82
7962,0,URS0000D6C0B1_12908/1-76,CAAACAUGAAGGUGGAACAGGUAUCCACCACCUAGUGAAAACUAUAGGAGAUGCAGAUUACCACCUGCCAUGUUUA,27,16,16,17,76
7963,0,URS0000D682D8_12908/1-70,AACCGCAGAGGCGGAACAGGCAUCCGCCACCCGUGUUGGAGAUGCGGGAAAAGCCAACCCGCCUGCGGAA,19,6,23,22,70
7964,0,URS0000D6B031_12908/1-72,AACCGCAGAGGACGGAACAGGCAGCCGUCGCCCGUGUUGGAGAUGCGGGAAUAAGCCGGCCCGCCUGCGGCC,15,7,27,23,72
7965,0,URS0000D67497_12908/1-75,AGUAACUGAGGUCGGAACAGGUAGCCGACACCACGCAUAAGCGGUAGGAGAUGCAGAUUACCACCUGCCUUUACU,22,14,20,19,75
7966,0,URS0000D65B9B_877414/1-76,AGUAACUGAGGUCGGAACAGGUAGCCGACACCACGCAUAAGCGGUAGGAGAUGCAGAUUACCACCUGCCCUUUACU,22,14,20,20,76
7967,0,URS0000D65DFC_12908/1-79,CUGCUGGGAGGAUAGAACAGGCAUCUAUCACACCCUUGUGGUAUAAAGAGAUGCAGGAUAUGCCACCCUGCCUCAGCAG,22,16,21,20,79
7968,0,URS0000D67D7F_12908/1-80,CUCUAUUGAGGAUAGAACAGGCAGCUAUCACACCUAAGUGGUCUUUUGAGAGAUGCAGGAGUGCCGACCUGCCAAUAGAG,23,18,22,17,80
7969,0,URS0000D6C307_12908/1-81,ACUCAACGAGGGCGGAACAGGCGGCCGCCACGCCAGAGAUGGUCUUUUAAGAGAUGCGUGAGUGCCAACACGCCGUUGAGU,20,13,27,21,81
7970,0,URS0000D6A45B_12908/1-78,AGCCACUGAGGACGGAACGGGCUACCGUCACCACGCUGAAAGCGGCGGAGAUGUGGGAUACGCCAACCCACCUUGGUU,19,11,25,23,78
7971,0,URS0000D6B97D_12908/1-81,UAGCCACUGAGGACGGAACGGGCGACCGUCACCACGCGUUUAAGCGGCGGAGAUGUGGGAAAUGCCACCCCACCUUGGUUA,19,13,26,23,81
7972,0,URS0000D6B565_12908/1-71,AAGAGAAGAGGACAGAACAGGCAUCUGUCGCCCAUUGUGGAGAUGUAGGGUACGCCUUCCUACCUUCUCUU,18,17,19,17,71
7973,0,URS0000D68ECE_12908/1-71,AUAUCAAGAGGACAGAACAGGCAUCUGUCACCCUUUGUGGAGAUGUAGGGUACGCCGACCUACCUUGAUAU,20,17,18,16,71
7974,0,URS0000D6A31A_12908/1-76,UAGCAAUAAGGGCGGAAUAGGUAGCCGCCACCACGUUUUUACGGUAGGAGAUGAAGAUUACCACCUUCUAUUGCUU,21,20,19,16,76
7975,0,URS0000D6906E_12908/1-77,UAGCAAUAAGGGCGGAAUAGGUAGCCGCCACCACGUUUUUUACGGUAGGAGAUGAAGAUUACCACCUUCUAUUGCUU,21,21,19,16,77
7976,0,URS0000D6A69F_12908/1-79,GAAAUUUAAGGGCGGAACAGGCAGCCGCCGCCACGUGUUUUACACGGUAGGAGAUGCAGAUUGCCACCUGCUAAAUUUC,21,17,22,19,79
7977,0,URS0000D69533_12908/1-79,AUCAUCUGAGGUCGGAACAGGCAACCGACACACCCAAGCGGUCUUUAAAGAGAUGCAGGAGUGCCAACCUGCCUAUGAU,24,14,20,21,79
7978,0,URS0000D6AE0C_1151292/1-84,UAGAUUUGAGGUUGGAAAAGGCACCCAAUACGCUACUAUGGAGUAGUUAAUAGAGAUGCAGGAUACGCCGCCCUGCCAAAUCUA,27,19,21,17,84
7979,0,URS0000D6722E_1151426/1-84,UAGAUUUGAGGUUGGAAAAGGCACCCAAUACGCUACUAUAGAGUAGUUAAUAGAGAUGCAGGAUACGCCGCCCUGCCAAAUCUA,28,19,20,17,84
7980,0,URS0000D6722E_1151381/1-84,UAGAUUUGAGGUUGGAAAAGGCACCCAAUACGCUACUAUAGAGUAGUUAAUAGAGAUGCAGGAUACGCCGCCCUGCCAAAUCUA,28,19,20,17,84
7981,0,URS0000D6722E_1151384/1-84,UAGAUUUGAGGUUGGAAAAGGCACCCAAUACGCUACUAUAGAGUAGUUAAUAGAGAUGCAGGAUACGCCGCCCUGCCAAAUCUA,28,19,20,17,84
7982,0,URS0000D6722E_1151377/1-84,UAGAUUUGAGGUUGGAAAAGGCACCCAAUACGCUACUAUAGAGUAGUUAAUAGAGAUGCAGGAUACGCCGCCCUGCCAAAUCUA,28,19,20,17,84
7983,0,URS0000D6722E_1151380/1-84,UAGAUUUGAGGUUGGAAAAGGCACCCAAUACGCUACUAUAGAGUAGUUAAUAGAGAUGCAGGAUACGCCGCCCUGCCAAAUCUA,28,19,20,17,84
7984,0,URS0000D6722E_1151359/1-84,UAGAUUUGAGGUUGGAAAAGGCACCCAAUACGCUACUAUAGAGUAGUUAAUAGAGAUGCAGGAUACGCCGCCCUGCCAAAUCUA,28,19,20,17,84
7985,0,URS0000D6722E_1151361/1-84,UAGAUUUGAGGUUGGAAAAGGCACCCAAUACGCUACUAUAGAGUAGUUAAUAGAGAUGCAGGAUACGCCGCCCUGCCAAAUCUA,28,19,20,17,84
7986,0,URS0000D6722E_1151367/1-84,UAGAUUUGAGGUUGGAAAAGGCACCCAAUACGCUACUAUAGAGUAGUUAAUAGAGAUGCAGGAUACGCCGCCCUGCCAAAUCUA,28,19,20,17,84
7987,0,URS0000D6722E_1151284/1-84,UAGAUUUGAGGUUGGAAAAGGCACCCAAUACGCUACUAUAGAGUAGUUAAUAGAGAUGCAGGAUACGCCGCCCUGCCAAAUCUA,28,19,20,17,84
7988,0,URS0000D6722E_1151285/1-84,UAGAUUUGAGGUUGGAAAAGGCACCCAAUACGCUACUAUAGAGUAGUUAAUAGAGAUGCAGGAUACGCCGCCCUGCCAAAUCUA,28,19,20,17,84
7989,0,URS0000D6722E_1151296/1-84,UAGAUUUGAGGUUGGAAAAGGCACCCAAUACGCUACUAUAGAGUAGUUAAUAGAGAUGCAGGAUACGCCGCCCUGCCAAAUCUA,28,19,20,17,84
7990,0,URS0000D6722E_1151252/1-84,UAGAUUUGAGGUUGGAAAAGGCACCCAAUACGCUACUAUAGAGUAGUUAAUAGAGAUGCAGGAUACGCCGCCCUGCCAAAUCUA,28,19,20,17,84
7991,0,URS0000D6722E_1151256/1-84,UAGAUUUGAGGUUGGAAAAGGCACCCAAUACGCUACUAUAGAGUAGUUAAUAGAGAUGCAGGAUACGCCGCCCUGCCAAAUCUA,28,19,20,17,84
7992,0,URS0000D6722E_1215069/1-84,UAGAUUUGAGGUUGGAAAAGGCACCCAAUACGCUACUAUAGAGUAGUUAAUAGAGAUGCAGGAUACGCCGCCCUGCCAAAUCUA,28,19,20,17,84
7993,0,URS0000D6722E_1215070/1-84,UAGAUUUGAGGUUGGAAAAGGCACCCAAUACGCUACUAUAGAGUAGUUAAUAGAGAUGCAGGAUACGCCGCCCUGCCAAAUCUA,28,19,20,17,84
7994,0,URS0000D6722E_525258/1-84,UAGAUUUGAGGUUGGAAAAGGCACCCAAUACGCUACUAUAGAGUAGUUAAUAGAGAUGCAGGAUACGCCGCCCUGCCAAAUCUA,28,19,20,17,84
7995,0,URS0000D6722E_997827/1-84,UAGAUUUGAGGUUGGAAAAGGCACCCAAUACGCUACUAUAGAGUAGUUAAUAGAGAUGCAGGAUACGCCGCCCUGCCAAAUCUA,28,19,20,17,84
7996,0,URS0000D6722E_479831/1-84,UAGAUUUGAGGUUGGAAAAGGCACCCAAUACGCUACUAUAGAGUAGUUAAUAGAGAUGCAGGAUACGCCGCCCUGCCAAAUCUA,28,19,20,17,84
7997,0,URS0000D6722E_367459/1-84,UAGAUUUGAGGUUGGAAAAGGCACCCAAUACGCUACUAUAGAGUAGUUAAUAGAGAUGCAGGAUACGCCGCCCUGCCAAAUCUA,28,19,20,17,84
7998,0,URS0000D6722E_455631/1-84,UAGAUUUGAGGUUGGAAAAGGCACCCAAUACGCUACUAUAGAGUAGUUAAUAGAGAUGCAGGAUACGCCGCCCUGCCAAAUCUA,28,19,20,17,84
7999,0,URS0000D6722E_499175/1-84,UAGAUUUGAGGUUGGAAAAGGCACCCAAUACGCUACUAUAGAGUAGUUAAUAGAGAUGCAGGAUACGCCGCCCUGCCAAAUCUA,28,19,20,17,84
8000,0,URS0000D6722E_1215068/1-84,UAGAUUUGAGGUUGGAAAAGGCACCCAAUACGCUACUAUAGAGUAGUUAAUAGAGAUGCAGGAUACGCCGCCCUGCCAAAUCUA,28,19,20,17,84
8001,0,URS0000D6722E_1215061/1-84,UAGAUUUGAGGUUGGAAAAGGCACCCAAUACGCUACUAUAGAGUAGUUAAUAGAGAUGCAGGAUACGCCGCCCUGCCAAAUCUA,28,19,20,17,84
8002,0,URS0000D6722E_1215066/1-84,UAGAUUUGAGGUUGGAAAAGGCACCCAAUACGCUACUAUAGAGUAGUUAAUAGAGAUGCAGGAUACGCCGCCCUGCCAAAUCUA,28,19,20,17,84
8003,0,URS0000D6722E_1215082/1-84,UAGAUUUGAGGUUGGAAAAGGCACCCAAUACGCUACUAUAGAGUAGUUAAUAGAGAUGCAGGAUACGCCGCCCUGCCAAAUCUA,28,19,20,17,84
8004,0,URS0000D6722E_1151260/1-84,UAGAUUUGAGGUUGGAAAAGGCACCCAAUACGCUACUAUAGAGUAGUUAAUAGAGAUGCAGGAUACGCCGCCCUGCCAAAUCUA,28,19,20,17,84
8005,0,URS0000D6722E_1151257/1-84,UAGAUUUGAGGUUGGAAAAGGCACCCAAUACGCUACUAUAGAGUAGUUAAUAGAGAUGCAGGAUACGCCGCCCUGCCAAAUCUA,28,19,20,17,84
8006,0,URS0000D6722E_1151259/1-84,UAGAUUUGAGGUUGGAAAAGGCACCCAAUACGCUACUAUAGAGUAGUUAAUAGAGAUGCAGGAUACGCCGCCCUGCCAAAUCUA,28,19,20,17,84
8007,0,URS0000D6722E_1151274/1-84,UAGAUUUGAGGUUGGAAAAGGCACCCAAUACGCUACUAUAGAGUAGUUAAUAGAGAUGCAGGAUACGCCGCCCUGCCAAAUCUA,28,19,20,17,84
8008,0,URS0000D6722E_1151279/1-84,UAGAUUUGAGGUUGGAAAAGGCACCCAAUACGCUACUAUAGAGUAGUUAAUAGAGAUGCAGGAUACGCCGCCCUGCCAAAUCUA,28,19,20,17,84
8009,0,URS0000D6722E_1151263/1-84,UAGAUUUGAGGUUGGAAAAGGCACCCAAUACGCUACUAUAGAGUAGUUAAUAGAGAUGCAGGAUACGCCGCCCUGCCAAAUCUA,28,19,20,17,84
8010,0,URS0000D6722E_1151272/1-84,UAGAUUUGAGGUUGGAAAAGGCACCCAAUACGCUACUAUAGAGUAGUUAAUAGAGAUGCAGGAUACGCCGCCCUGCCAAAUCUA,28,19,20,17,84
8011,0,URS0000D6722E_1151277/1-84,UAGAUUUGAGGUUGGAAAAGGCACCCAAUACGCUACUAUAGAGUAGUUAAUAGAGAUGCAGGAUACGCCGCCCUGCCAAAUCUA,28,19,20,17,84
8012,0,URS0000D6722E_1151282/1-84,UAGAUUUGAGGUUGGAAAAGGCACCCAAUACGCUACUAUAGAGUAGUUAAUAGAGAUGCAGGAUACGCCGCCCUGCCAAAUCUA,28,19,20,17,84
8013,0,URS0000D6722E_1151283/1-84,UAGAUUUGAGGUUGGAAAAGGCACCCAAUACGCUACUAUAGAGUAGUUAAUAGAGAUGCAGGAUACGCCGCCCUGCCAAAUCUA,28,19,20,17,84
8014,0,URS0000D6722E_1151291/1-84,UAGAUUUGAGGUUGGAAAAGGCACCCAAUACGCUACUAUAGAGUAGUUAAUAGAGAUGCAGGAUACGCCGCCCUGCCAAAUCUA,28,19,20,17,84
8015,0,URS0000D6722E_1151314/1-84,UAGAUUUGAGGUUGGAAAAGGCACCCAAUACGCUACUAUAGAGUAGUUAAUAGAGAUGCAGGAUACGCCGCCCUGCCAAAUCUA,28,19,20,17,84
8016,0,URS0000D6722E_1151330/1-84,UAGAUUUGAGGUUGGAAAAGGCACCCAAUACGCUACUAUAGAGUAGUUAAUAGAGAUGCAGGAUACGCCGCCCUGCCAAAUCUA,28,19,20,17,84
8017,0,URS0000D6722E_1151297/1-84,UAGAUUUGAGGUUGGAAAAGGCACCCAAUACGCUACUAUAGAGUAGUUAAUAGAGAUGCAGGAUACGCCGCCCUGCCAAAUCUA,28,19,20,17,84
8018,0,URS0000D6722E_1151308/1-84,UAGAUUUGAGGUUGGAAAAGGCACCCAAUACGCUACUAUAGAGUAGUUAAUAGAGAUGCAGGAUACGCCGCCCUGCCAAAUCUA,28,19,20,17,84
8019,0,URS0000D6722E_1151318/1-84,UAGAUUUGAGGUUGGAAAAGGCACCCAAUACGCUACUAUAGAGUAGUUAAUAGAGAUGCAGGAUACGCCGCCCUGCCAAAUCUA,28,19,20,17,84
8020,0,URS0000D6722E_1151334/1-84,UAGAUUUGAGGUUGGAAAAGGCACCCAAUACGCUACUAUAGAGUAGUUAAUAGAGAUGCAGGAUACGCCGCCCUGCCAAAUCUA,28,19,20,17,84
8021,0,URS0000D6722E_1151349/1-84,UAGAUUUGAGGUUGGAAAAGGCACCCAAUACGCUACUAUAGAGUAGUUAAUAGAGAUGCAGGAUACGCCGCCCUGCCAAAUCUA,28,19,20,17,84
8022,0,URS0000D6722E_1151350/1-84,UAGAUUUGAGGUUGGAAAAGGCACCCAAUACGCUACUAUAGAGUAGUUAAUAGAGAUGCAGGAUACGCCGCCCUGCCAAAUCUA,28,19,20,17,84
8023,0,URS0000D6722E_1151362/1-84,UAGAUUUGAGGUUGGAAAAGGCACCCAAUACGCUACUAUAGAGUAGUUAAUAGAGAUGCAGGAUACGCCGCCCUGCCAAAUCUA,28,19,20,17,84
8024,0,URS0000D6722E_1151392/1-84,UAGAUUUGAGGUUGGAAAAGGCACCCAAUACGCUACUAUAGAGUAGUUAAUAGAGAUGCAGGAUACGCCGCCCUGCCAAAUCUA,28,19,20,17,84
8025,0,URS0000D6D264_910310/1-84,UGAAUUUGAAGUUGGAAAUGGCACCCAAAGCGCUACUUUAAAGUAGUAACUAGAGAUGUAGGAUACGCCGCCCUACCAAGUUUA,28,21,19,16,84
8026,0,URS0000D6D264_12908/1-84,UGAAUUUGAAGUUGGAAAUGGCACCCAAAGCGCUACUUUAAAGUAGUAACUAGAGAUGUAGGAUACGCCGCCCUACCAAGUUUA,28,21,19,16,84
8027,0,URS0000D6D264_702450/1-84,UGAAUUUGAAGUUGGAAAUGGCACCCAAAGCGCUACUUUAAAGUAGUAACUAGAGAUGUAGGAUACGCCGCCCUACCAAGUUUA,28,21,19,16,84
8028,0,URS0000D690EA_12908/1-79,AUAAUUAGAAGUAGAAAGUGGCUCUCUACACACUCGAAAGAAUACCUGAGAUGCAGGAUACGCCACCCUGCCUAAUUAU,28,18,15,18,79
8029,0,URS0000D68026_12908/1-93,GGUCAUUGAAGGCAGAAAGGCUCCUGUCACACCUCUCCCGCUAGCCCAUAGAGAGGUACCUGAGAUGUUGGGUACGCCGUCCAACCAUUGACC,22,19,24,28,93
8030,0,URS0000D69E5B_12908/1-91,CGUCAUUGAGGGCAAAAAGGCUCUUGUCACACCUCUCUAUAGCCCAUAGAGAGGUAUCUGAGAUGUUGGGUACGCCGUCCAACCAUUGACC,23,22,22,24,91
8031,0,URS0000D65C52_12908/1-86,UGGAUUUGAAGUCGGAAAUGGCUCCCGACACGCUACCUGCAAAGGCAGUUACCAGAGAUACAGGACACGCCGCCCUGUCAAAACCA,26,14,21,25,86
8032,0,URS0000D698F1_977905/1-82,UUAUUUUGAGGGGGAAAGGUUCCCCACGCGCUUACCCCUUGGGUAAGUUACCAGAGAUCAGGAUUACCGCCCUGCAAAAUAA,22,20,20,20,82
8033,0,URS0000D6BB8D_12908/1-82,GGUUUUUGAGGUGGGAAAGGUACCCCACGCGCUACAGUUAGCUGUAGUUACCAGAGAUCAGGAUUGCCGCCCUGCUUUAACC,18,21,23,20,82
8034,0,URS0000D684F5_12908/1-81,AUUUUGUGAAGUAGAAAAGGCUCUCUACACACCUGCUUGUCAGGUACCUGAGAUGGUGGGUACGCCGUCCACCCAUAAAAU,22,21,19,19,81
8035,0,URS0000D682E7_12908/1-81,AUUUUAUGAAGUAGAAAAGGCUCUCUACACACCUGCUUGUCAGGUACCUGAGAUGGUGGGUACGCCGUCCACCCAUAAAAU,23,21,18,19,81
8036,0,URS0000D6686B_12908/1-81,AUUUUAUGAAGUAGAAAAGGCUCUCUACACACCUGCUUAACAGGUACCUGAGAUGGUGGGUACGCCGUCCACCCAUAAAAU,25,20,17,19,81
8037,0,URS0000D6686B_864565/1-81,AUUUUAUGAAGUAGAAAAGGCUCUCUACACACCUGCUUAACAGGUACCUGAGAUGGUGGGUACGCCGUCCACCCAUAAAAU,25,20,17,19,81
8038,0,URS0000D69A87_936556/1-81,AUUUUAUGAAGUAGAAAAGGCUCUCUACACACCUGCUUAACAGGUACCUGAGAUGGUGGGUACGCCGUCCACCCAUGAAAU,24,20,18,19,81
8039,0,URS0000D67A89_12908/1-81,AUUUUAUGAAGUAGAAAAGGCUCUCUACACACCUGCUUGACAGGUACCUGAGAUGGUGGGUACGCCGUCCACCCAUAAAAU,24,20,18,19,81
8040,0,URS0000D675D7_12908/1-146,UAGCACUGAGGUCGGAAAUGGCUCCCGACCCUCCUUUGUAUGAGAAUGGUACAAGCGUCUGCCUAUGAGGCUAUAUAGAUAAUGCAUGAGUUCCGACAAUCCGCAAGGUAACCUGAUAUGCAGGAUACGUCGCCCUGUCAGUAAAU,40,36,36,34,146
8041,0,URS0000D6C24D_12908/1-80,GGUUAUUAAGGUGGGAAAGGUUCCCCACGCGCUCACGAUGAGUUAUCAGAGAUCCUGGAUACGCCGCCCAGGUAAUAACC,21,17,22,20,80
8042,0,URS0000D6BB03_1185653/1-80,GGUUAUUAAGGUGGGAAAGGUUCCCCACGCGCUCACGAUGAGUUACCAGAGAUCCUGGAUACGCCGCCCAGGUAAUAACC,21,16,22,21,80
8043,0,URS0000D6A3D1_1132442/1-81,GUUAUUUGAGGUGGGAAAGGUUCCCCACGCGCUAUCCAAUGGGUAGUUACCAGAGAUCAGGAGUGCCGCCCUGCUAAUAAC,20,19,23,19,81
8044,0,URS0000D681DA_12908/1-94,GUUAUUUGAGGUGGGAAAGGUUCCCCACGCGCUGCCUUUGCAAUUAUUAUUGCUCGGGUAGUUACCAGAGAUCAGGAGUGCCGCCCUGCUUAAC,19,27,26,22,94
8045,0,URS0000D657D1_545697/1-86,GAUUGUUGAGGUGAGAAAAGGCUCCUCAUGCGCUAGUAUUAAUGUAGUAAACAGAGAUGCAGGAUAAUGUCGACCUGCCGAUAAUC,27,22,23,14,86
8046,0,URS0000D67B02_12908/1-79,AUUUUUUGAGGUGAGAAAUGGCUCCUCACACGCUAAAUUUAGUAAAUAGAGAUGCAGGAUACCCGACCUGCCAAAAACU,27,20,16,16,79
8047,0,URS0000D6963D_12908/1-83,AAUUGUUGAGGUGAGAAAAGGCUCCUCACGCGCUAAGGCUUCUAGUAAAAAGAGAUGUAGGAUACGCCGCCCUACCAACAAUU,27,18,20,18,83
8048,0,URS0000D693DD_12908/1-82,GUUUUUUGAGGUGAGCAAAGGCUCCUCAUGCGCUAAUUUUUUAGUAACCAGAGAUGCAGGAUACGCCGACCUGCCAAAAGAU,23,22,20,17,82
8049,0,URS0000D6AC3A_641107/1-80,AUUUUUUGAGGUGAGAAAAGGCUCCUCAUGCGCUAUUUUUAGUAACCAGAGAUGCAGGAUACGCCGACCUGCCAAAAAAU,25,21,18,16,80
8050,0,URS0000D6810C_997898/1-81,AUUUUUUGAGGUGAGAAAAGGCUCCUCACGCGCUAUUGUUUAGUAAUCAGAGAUGCAGGAUACGCCGACCUGCCAAAAAAG,25,20,20,16,81
8051,0,URS0000D6810C_632245/1-81,AUUUUUUGAGGUGAGAAAAGGCUCCUCACGCGCUAUUGUUUAGUAAUCAGAGAUGCAGGAUACGCCGACCUGCCAAAAAAG,25,20,20,16,81
8052,0,URS0000D6C987_1200349/1-80,AUUUUUUGAGGUGAGAAAAGGCUCCUCACGCGCUAGUCUUAGUAAUCAGAGAUGCAGGAUACGCCGACCUGCCAAAAAAU,25,19,19,17,80
8053,0,URS0000D674A0_12908/1-80,GUUUUUUGAGGUGAGAAAAGGCUCCUCACGCGCUAGUCUUAGUAAUCAGAGAUGCAGGAUACGCCGACCUGCCAAAAAAU,24,19,20,17,80
8054,0,URS0000D674A0_290402/1-80,GUUUUUUGAGGUGAGAAAAGGCUCCUCACGCGCUAGUCUUAGUAAUCAGAGAUGCAGGAUACGCCGACCUGCCAAAAAAU,24,19,20,17,80
8055,0,URS0000D6A508_1428454/1-80,GUUUUUUGAGGUGAGAAAAGGCUCCUCACGCGCUAAUCUUAGUAAUCAGAGAUGCAGGAUACGCCGACCUGCCAAAAAAU,25,19,19,17,80
8056,0,URS0000D6B47A_12908/1-80,AUUUUUUGAGGUGAGAAAAGGCUCCUCACGCGCUAAUGUUAGUAAUCAGAGAUGCAGGAUACGCCGACCUGCCAAAAAAU,26,19,19,16,80
8057,0,URS0000D6BE15_1196322/1-81,AUUUUUUGAGGUGAGAAAAGGCUCCUCAUGCGCUAAUAUUUAGUAAUCAGAGAUGCAGGAUACGCCGACCUGCCAAAAAAU,27,21,18,15,81
8058,0,URS0000D6AE79_931276/1-80,AUUUUUUGAGGUGAGAAAAGGCUCCUCAUGCGCUAAUAUUAGUAAUCAGAGAUGCAGGAUACGCCGACCUGCCAAAAAAU,27,20,18,15,80
8059,0,URS0000D69EF2_1345695/1-83,AUUUUUUGAGGUGAGAAAAGGCUCCUCACGCGCUAUAUAACUUAGUAAUCAGAGAUGCAGGAUACGCCGACCUGCCAAAAAUA,28,20,18,17,83
8060,0,URS0000D6C7D5_1202534/1-81,GAUUAUUGAGGUGAGAAAGGGCUCCUCAUACGCUGAAUUUCAGUAAUAAGAGAUGUAGGAUACGCCGACCUACCAAUAAUC,27,20,19,15,81
8061,0,URS0000D6A55F_457396/1-81,GGUUAUUGAGGUGAGAAAUGGCUCCUCAUGCGCUGGAUUUCAGUAAUAAGAGAUGUAGGAUACGCCGACCUACCAAUAAUC,24,21,21,15,81
8062,0,URS0000D65F15_12908/1-82,GAUUAUUGAGGUGAGAAAUGGCUACUCAUACGCUAAAUAUUUAGUAAAUAGAGAUGUAGGAUAUGUCGACCUACCAAUAACA,31,23,17,11,82
8063,0,URS0000D6B761_12908/1-82,GAUUAUUGAGGUGAGAAAUGUCUCCUCAUAGGCUAAAUAUUUAGUAAAUAGAGAUGUAGGAUAUGUCGACCUACCAAUAACA,30,24,17,11,82
8064,0,URS0000D6D39C_1351755/1-80,GAUUAUUGAGGUGAGAAAUGGCUCCUCAUACGCUGCUUGCAGUAAACAGAGAUGCAGGAUACGCCGCCCUGCCUGUAAUC,21,19,21,19,80
8065,0,URS0000D6C0FE_12908/1-81,GGUUGUUGAAGUGAGAAAUGGCUCCUCAUGCGCUGAUAAUCAGUAAAUAGAGAUGCAGGGUACGCCGACCUGCCAAUAAUC,24,19,22,16,81
8066,0,URS0000D668D6_1262780/1-92,GAUUUUUGAGGUGAGAAAUGGCUCCUCAUACGCUGAUGUGAUGUAUUCUAUCAGUAAAUAGAGAUGCAGGACAAGCCGACCUGCCAAUAAUC,28,25,22,17,92
8067,0,URS0000D66026_1262787/1-92,GAUUUUUGAGGUGAGAAAUGGCUCCUCAUACGCUGAUAUAAUGAAUUCUAUCAGUAAACAGAGAUGCAGGACAAGCCGACCUGCCAAUAAUC,31,23,20,18,92
8068,0,URS0000D6BE57_12908/1-80,GGUUUUUGAAGUGAGAAAGGGCUCCUCACACGCUGAAAACAGUAAACAGAGAUGCAGGAUACGCCGCCCUGCCAAAAACC,27,13,20,20,80
8069,0,URS0000D6AC33_12908/1-82,GCUAUUUGAGGUGGGAAAGGUUCCCCAUGCGCUACUUUUAGUAGUUAACAGAGAUGCAGGAUAAGCCGACCUGCCGAAUAGC,22,20,23,17,82
8070,0,URS0000D695F7_12908/1-80,GCUAUUCGAGGUGAGAAAGGUUCCUCACACGCUACAUUAGUAGUCAAUAGAGAUGCAGGAUUGCCGACCUGCCGAAUAGC,23,18,21,18,80
8071,0,URS0000D6A0E5_1036171/1-82,AGCCAAUGAAGUGGGAAAGGUUCCCGGCGCGCUUGCUUAUAGCAAGUUACCAGAAAUCAGGAUACGCCGCCCUGCAUUGACU,22,17,22,21,82
8072,0,URS0000D6C440_1206781/1-83,GAUCAUUGAGGUGGGAAAGGUUCCCCACGCGCUUGCUGAAAAGCAAGUUACCAGAGAUCAGGAUACGCCGCCCUGCUAUGAUC,22,17,23,21,83
8073,0,URS0000D6CD26_527022/1-116,GAUCUAUGAGGUGGGAAAGGUUCCCCACGCGCUUAUCUAACCACUGUUCGCGAUCAAUCAUUUGAAUGGUUAGGUAAGUUACCAGAGAUGUAGGAUACGCCGCCCUACCAUCGAUC,30,30,28,28,116
8074,0,URS0000D6C613_718223/1-116,GAUCUUUGAGGUGGGAAAGGUUCCCCACGCGCUUAUCUAGCCGCCGUUCUUGAUCAAACAUUUGAUUGGUUAGGUAAGUUACCAGAGAUGUAGGAUACGCCGCCCUACCAUCGAUC,27,32,29,28,116
8075,0,URS0000D69965_12908/1-83,GGAUUUUGAGGUGGGAAAGGUUCCCCACGCGCUUGCUUUGGCAAGUUACCAGAGAUGCAGGAUACGCCGACCUGCCAAAGUUC,19,19,25,20,83
8076,0,URS0000D6D3A0_1053195/1-115,GAUCUAUGAGGUGAGAAAGGUUCCUCACGCGCUUAUCUAACUUCGUUCUUGAUCAAUUAUUUGGUCCGUUAGGUAAGUUACCAGAGAUGUAGGAUACGCCGCCCUGCCAUCGAUC,27,35,27,26,115
8077,0,URS0000D6D3A0_637380/1-115,GAUCUAUGAGGUGAGAAAGGUUCCUCACGCGCUUAUCUAACUUCGUUCUUGAUCAAUUAUUUGGUCCGUUAGGUAAGUUACCAGAGAUGUAGGAUACGCCGCCCUGCCAUCGAUC,27,35,27,26,115
8078,0,URS0000D6B575_12908/1-89,UGUAAGUAAGGGUAGAAAGGUCCCUACCGCACCUCUUACCCGCUGUAAGAGGUAUCUGAGAUGUUGGAUACACCGCCCAACUGCUUACA,24,21,21,23,89
8079,0,URS0000D657E6_12908/1-79,AUAAAUUGACGAGCAGGAAAGGCACCCUGCGCUCCCAUUCGGGAACCUGAUAUGAUGGAUACGCCGCCCAUCCAAUUAU,23,16,18,22,79
8080,0,URS0000D65740_12908/1-81,AAUAGUUGACGAGCAGGAAAGGCACCCUGCGCUCCCUGUAAGGGAACCUGAUAUGAUGGAUACGCCGCCCAUCCAAUUAUU,23,17,20,21,81
8081,0,URS0000D66EB4_877420/1-81,AAUAGUUGACGAGCAGGAAAGGCACCCUGCGCUCCUUUUUUAGGAACCUGAUAUGAUGGAUACGCCGCCCAUCCAAUUCUU,21,21,18,21,81
8082,0,URS0000D68A3C_12908/1-78,AUCAUUUGAGAAGCAAGAAAGGCAUCCUGCGCUCCUUCGGGAACCUGAUAUGAUGGAUACGCCGCCCAUCCAAGUGUU,21,18,19,20,78
8083,0,URS0000D68893_12908/1-78,AUCAUUUGAGAAGCAGGAAAGGCACCCUGCGCUCCUUAGGGAACCUGAUAUGAUGGAUACGCCGCCCAUCCAAGUGUU,21,17,20,20,78
8084,0,URS0000D68893_657313/1-78,AUCAUUUGAGAAGCAGGAAAGGCACCCUGCGCUCCUUAGGGAACCUGAUAUGAUGGAUACGCCGCCCAUCCAAGUGUU,21,17,20,20,78
8085,0,URS0000D6C9DC_12908/1-78,AUCAUUUGAGAGGCAGGAAAGGCACCCUACGCUCCUUAGGGAACCUGAUAUGAUGGAUGCGCCGCCCAUCCAAGUGUU,20,17,21,20,78
8086,0,URS0000D66529_12908/1-85,AUCAUUUGAGAAGCAGGAAAGGGGAAAGGCACCCUGCGCUCCUUAGGGAACCUGAUAUGAUGGAUACGCCGCCCAUCCAAGUGUU,24,17,24,20,85
8087,0,URS0000D6B95A_12908/1-78,AUCAUUUGAGAAGCAGGAAAGGCACCCUGCGCUCCUUAGGGAACCUGAUAUGAUGGAUACGCCGCCCAUCCAAAUGUA,23,16,19,20,78
8088,0,URS0000D6C15C_12908/1-78,AUCAUUUGAGAAGCAGGAAAGGCACCCUGCGCCCAUUAGGGAACCUGAUAUGAUGGAUACGCCGCCCAUCCAAGUGUU,22,16,20,20,78
8089,0,URS0000D6903D_12908/1-80,GAAAUUUGACGAGCAGGAAAGGCACCCUGCGCUCCCGAAAGGGAACCUGAUAUGAUGGAUACGCCGCCCAUCCAAAUUUU,24,15,20,21,80
8090,0,URS0000D6903D_907348/1-80,GAAAUUUGACGAGCAGGAAAGGCACCCUGCGCUCCCGAAAGGGAACCUGAUAUGAUGGAUACGCCGCCCAUCCAAAUUUU,24,15,20,21,80
8091,0,URS0000D67C95_12908/1-80,GAAAUUUGACGAGCAGGAAAGGCACCCUGCGCUCCCGAAAGGGAACCUGAUAUGAUGGAUACGCCGCCCAUCCGAAUUUC,23,14,21,22,80
8092,0,URS0000D66533_12908/1-80,GAAAAUUGACGAGCAGGAAAGGCACCCUGCGCUCCCGAAAGGGAACCUGAUAUGAUGGAUACGCCGCCCAUCCAAUUUUU,24,15,20,21,80
8093,0,URS0000D65D82_12908/1-79,AUAAAUUGACAAGCAGGAAUGGCACCCUGCGCUCCUAUAUGAAACCUGAUAUGAUGGAUACGCCGCCCAUCCAAUUUUA,25,19,15,20,79
8094,0,URS0000D68A06_12908/1-80,AUAAAUUGACGAGCAGGAAAGGCACCCUGCGCUCCUAUAUGGAACCUGAUAUGAUGGAUACGCCGCCCAUCCAAUUUUAU,24,19,17,20,80
8095,0,URS0000D67425_12908/1-79,AUAAAUUGACGAGCAGGAAAGGCGCCCUGCGCUCCUAUAUGGAACCUGAUAUGAUGGAUACGCCGCCCAUCCAAUUUUA,23,18,18,20,79
8096,0,URS0000D68982_12908/1-82,AUAAAUUGACAAGCAGGAAAGGCACCCUGCGCUCCUGUUAUAAGGAACCUGAUAUGAUGGAUACGCCGCCCAUCCAAUUUUA,26,19,17,20,82
8097,0,URS0000D68414_12908/1-78,UACAUUUGACAAGCAGGAAAGGCACCCUGCGCUCCCUCGGGAACCUGAUAUGAUGGAUACGCCGCCCAUCCAAAUGUA,22,15,18,23,78
8098,0,URS0000D68414_1262862/1-78,UACAUUUGACAAGCAGGAAAGGCACCCUGCGCUCCCUCGGGAACCUGAUAUGAUGGAUACGCCGCCCAUCCAAAUGUA,22,15,18,23,78
8099,0,URS0000D6ABB3_12908/1-78,UACAUUUGACAAGCAGGAAAGGCACCCUGCGCUCCCACGGGAACCUGAUAUGAUGGAUACGCCGCCCAUCCAAAUGUA,23,14,18,23,78
8100,0,URS0000D68D95_12908/1-78,UACAUUUGACGAGCAGGAAAGGCACCCUGCGCUCCCACGGGAACCUGAUAUGAUGGAUACGCCGCCCAUCCAAAUGUA,22,14,19,23,78
8101,0,URS0000D68D95_411474/1-78,UACAUUUGACGAGCAGGAAAGGCACCCUGCGCUCCCACGGGAACCUGAUAUGAUGGAUACGCCGCCCAUCCAAAUGUA,22,14,19,23,78
8102,0,URS0000D66F4C_12908/1-80,ACCAAUUGACAAGCAGGAAAGGCACCCUGCACUCCCAUACGGGAACCUGAUAUGAUGGAUACGCCGCCCAUCCAAUGAAU,26,13,17,24,80
8103,0,URS0000D69DFC_12908/1-79,AGAUAUUGAGGUCGGAAAUGGCUCCCAGCACUCCCGCAGGGGAGUUUGAGAUGCAGGAUACGCCGUUCUGCUGAUGUCA,18,18,25,18,79
8104,0,URS0000D6B887_12908/1-80,UGUUAUCGAGGUUGGAAAGGCUCCCGACGCUCCUCUUAUGAGGAACCUGAGAUGCAGGAUACGCCGCCCUGCCGACAACA,19,16,22,23,80
8105,0,URS0000D6B6D7_12908/1-77,GACGGGCGAGGUCGGAAAGGCUCCCGACGCUCCCGCGAGGGAAUCUGAGAUGCAGGAUACGCCUCCCUGCCGUUGCU,14,12,27,24,77
8106,0,URS0000D6B058_12908/1-81,UCUUAUUGAAGUAGAAAAGGCUCUCUACACACUCUUUUAUAGAGCACCUGAGAUGAUGGGUACGCCGUCUAUCCUUUAAGA,23,25,16,17,81
8107,0,URS0000D6B2C9_12908/1-81,UCUUAUAGAAGCAGAAAAGGCUCUCUACACACUCUUUUAUAGAGUAUCUGAGAUGAUGGGUACGCCGUCCAUCCUUUAAGA,24,24,16,17,81
8108,0,URS0000D69427_12908/1-81,UCUUAUUGAAGUAGAAAAGGCUCUCUACACACUCUUUUAUAGAGUACCUGAGAUGAUGGGUACGCCGUUUAUCCUUUAAGA,23,27,16,15,81
8109,0,URS0000D6A71D_12908/1-81,UCUUAUAGAAGUAGAAAAGGCUCUCUACACACUCUUUUAUAGAGUACCUGAGAUGAUGGGUACGCCGUCCAUCCUUUAAGA,24,24,16,17,81
8110,0,URS0000D65B23_12908/1-81,UCUUAUUGAAGUAGAAAAGGCUCUCUACACACUCUUUUAUAGAGUAUCUGAGAUGAUGGGUACGCCGUCCAUCCUUUAAGA,23,26,16,16,81
8111,0,URS0000D6710E_12908/1-81,UCUUAUUGAAGUAGAAAAGGCUCUCUACAUACUCUUUUAUAGAGUACCUGAGAUGAUGGGUACGCCGUCCAUCCUUUAAGA,23,26,16,16,81
8112,0,URS0000D6C9F6_12908/1-81,UCUUAUUGAAGUAGAAAAGGCUCUCUACACACUCUUUUAUAGAGUACCUGAGAUGAUGGGUACGCCGUCCAUCCUUUAAGA,23,25,16,17,81
8113,0,URS0000D67EED_12908/1-81,UCUUAUUGAAGUAGAAAAGGCUCUCUACACACUCUUUUAUAGAGUACCUGAGAUGAUGGGUACGCCGUCUAUCCUUUAAGA,23,26,16,16,81
8114,0,URS0000D67EED_562981/1-81,UCUUAUUGAAGUAGAAAAGGCUCUCUACACACUCUUUUAUAGAGUACCUGAGAUGAUGGGUACGCCGUCUAUCCUUUAAGA,23,26,16,16,81
8115,0,URS0000D660D1_12908/1-81,UCCUAUUGAAGUAGAAAAGGCUCUCUACACACUCUUUUAUAGAGUACCUGAGAUGAUGGGUACGCCGUCCAUCCUUUAAGA,23,24,16,18,81
8116,0,URS0000D6581D_12908/1-78,UUCAUUCAAGGUCGGAAAGGCUCCCGACACUCCCGCAAGGGAACUUGAGAUGAUGGAUACGCCGCCCAUCUGAAUGAC,21,15,20,22,78
8117,0,URS0000D6873E_12908/1-80,AAACACUGAGGUCGGAAAGGCUCCCGACGCUCCUCUUAUAGGGAAUCUGAGAUGCAGGAUACGCCGCCCUGCCAGUGUUU,19,17,22,22,80
8118,0,URS0000D670A4_12908/1-79,GGACGUUGAGGUCGGAAAUGGCUCCCGACACUCCCGAAAGGGAACCUGAGAUGCAGGAUACGCCGCCCUGCCGAUGUCC,18,12,25,24,79
8119,0,URS0000D68205_12908/1-79,GGACAUUGAGGUCGGAAAUGGCUCCCGACACUCCCGAAAGGGAACCUGAGAUGCAGGAUACGCCGCCCUGCCGAUGUCC,19,12,24,24,79
8120,0,URS0000D6CCFE_12908/1-79,AGUAUACGAUGUCAGAAAUGGUUCCUGGCGCGCUCUUCGAAGUACCUGAGAUGCCGGAUACACCGCCUGGCCGUAUGCU,17,19,22,21,79
8121,0,URS0000D67651_12908/1-79,AGCAUACGAGGUCAGAAAUGGUUCCUGACGCACUCUCCGGAGUACCUGAGAUGCCGGAUACACCGCCCGGCCGUAUGCC,18,14,22,25,79
8122,0,URS0000D69851_12908/1-80,AAUUGUUGAGUCGGGAAUGGCUCCCGACACUUCCUGAUAAGGGAACCUGAGAAGCAAGAUACGCCUCCCUGUCAGCAAUC,22,17,20,21,80
8123,0,URS0000D6628D_12908/1-79,AACAGGCGAGGUCGGAAAUGGUUCCCGACACACCCGAAAGGGUACCUGAGAUGCAGGAUACACCGCCCUGCCGCUUGUU,20,13,23,23,79
8124,0,URS0000D6BF85_12908/1-79,AGUCAGUGAGGUCGGAAAUGGUUCCCGACACACGCGAAAGCGUACCUGAGAUGCAGGGGACACCGCCCUGCCACUGAUC,20,12,24,23,79
8125,0,URS0000D6D179_12908/1-79,AGUCAGUGAGGUCGGAAAUGGUUCCCGACACACGCGAAAGCAUACCUGAGAUGCAGGGGACACCGCCCUGCAUCUGAUC,21,13,23,22,79
8126,0,URS0000D69EDA_12908/1-83,AAUUAUUGACGACCGGAAAUGGUUCCCGGCACACUUGUUUUACAAGUAUCUGGCAUGAUGGAUACACCGCCCAUUCAAUAAUU,24,24,16,19,83
8127,0,URS0000D6BDC6_12908/1-79,UUAUCUAUAGGUAGAAAAUGGUUCUCUACACACUCUUCGGAGUACCUGAGAUGAUGGAUACACCGCCCAUCAUAGAUAA,25,22,15,17,79
8128,0,URS0000D6D1D6_12908/1-78,UUAUCUAUAAGUAGAAAAGGCUCUCUACACACUCUUCGGAGUACCUGAGAUGAUGUAUACGCCGCCCAUCAUAGAUAA,25,21,14,18,78
8129,0,URS0000D686C3_478749/1-84,UUAUUUUGAGGUCGGAAAUGGUUCCCGAUACACUCCAUUUGAAGUACCUGAGAUGCUGGAUGAACCGCCCAGCCCCCAAUAUAU,22,23,18,21,84
8130,0,URS0000D683ED_12908/1-141,GGUAUUUGAGGUCGGAAAUGGCUCCCGACACUCCCUUGUAUGAGGACGGAAGAAGCAGCCGUCGCCCUAGUUGGAGAUGCGUGAGUGCUGACACGCCGCAAGGGAACCUGAGAUGCAGGAUACGCCGCCCUGCCAAAUAUC,34,26,44,37,141
8131,0,URS0000D692B6_12908/1-135,AUUUGAGGUUGGAAAUGGCUCCCGACACUCCCUUGUAUGAGGACGGAACGGGCAGCCGUCGCCCUAGUUGGAGAUGCGUGAGUGCUGACACGCCGCAAGGGAACCUGAGAUGCAGGAUACGCCGCCCUGCCAAAU,31,25,43,36,135
8132,0,URS0000D6C574_12908/1-141,GGUAUUUGAGGUUGGAAAUGGCUCCCGACACUCCCUUGUAUGAGGACGGAACGGGCAGCCGUCGCCCUAGUUGGAGAUGCGUGAGUGCUGACACGCCGCAAGAGAACCUGAGAUGCAGGAUACGCCGCCCUGCCAAAUAUC,33,27,44,37,141
8133,0,URS0000D69E2A_12908/1-85,GUUAUUUAAGGCUCGGAAAGGCUCCCGACACUCCUUCUUUUCGGAAGGAACCUGAGAUGAUGGAUACGCCGCCCAUCUAAAUAAC,23,21,19,22,85
8134,0,URS0000D6778C_12908/1-78,GAUAUUUAAGGUCGGAAAGGCUCCCGACACUCCUGAAUAGGAACCUGAGAUGAUGGAUACGCCGCCCAUCUAAAUAUU,24,18,18,18,78
8135,0,URS0000D6BEBF_12908/1-78,GAUAUUUAAGGUCGGAAAGGCUCCCGACACUCCUGAAUAGGAACCUGAGAUGAUGGAUACGCCGCCCAUCUAAAUAUC,24,17,18,19,78
8136,0,URS0000D6CE8C_12908/1-79,GGUUGUUGAGGUCGGAAAUGGUUCCCGACACACCCUUUGGGGUACCUGAGAUGUAGGAUACACCGCCCUACCAAUAACC,19,18,21,21,79
8137,0,URS0000D678C2_12908/1-81,GGUUGUUGAGGUCGGAAAGGGUUCCCGACACACCUUAUAUAAGGUACCUGAGAUGUAGGAUACACCGCCCUACCAAUAACC,23,18,20,20,81
8138,0,URS0000D660BA_12908/1-141,GGGUGUUGAGGUCGGAAAUGGCUCCCGACACUCCCUUGUAUGAGGAUAGAACGGGCAUCUAUCACCUAUAUGGGUAAUGCGUGAGUGCCGACACGCCGCAAGGGAACCUGAGAUGUAGGAUACGCCGCCCUACCAACAUCC,35,28,41,37,141
8139,0,URS0000D6BCB8_12908/1-83,GAUAAAUGAGGUCGGAAAUGGUUCCCGACACACUCGCAUAGACGAGUACCUGAGAUGCUGGAUACACCGCCCAGCCAUUUGCC,23,16,21,23,83
8140,0,URS0000D6B7A9_12908/1-83,GGCAAAUGAGGUCGGAAAUGGUUCCCGACACACUCGCAUAGACGAGUACCUGAGAUGCUGGAUACACCGCCCAGCCAUUUGCC,22,15,22,24,83
8141,0,URS0000D697DE_12908/1-81,GUUAUAUGAGGUCGGAAAUGGUUCCCGACACACUCCAUCUGGAGUACCUGAGAUGCUGGAUACACCGCCCAGCCAUAUGAU,21,19,20,21,81
8142,0,URS0000D672EB_12908/1-81,AUCAUAUGAGGUCGGAAACGGUUCCCGACACACUCCAUCUGGAGUACCUGAGAUGCUGGAUACACCGCCCAGUCAUAUGAU,22,18,19,22,81
8143,0,URS0000D65C89_12908/1-81,AUCAUAUGAGGUCGGAAACGGUUCCCGACACACUCCAUCUGGAGUACCUGAGAUGCUGGAUACACCGCCCAGCCAUAUGAU,22,17,19,23,81
8144,0,URS0000D67D57_12908/1-79,CAUUGCAGAGGUCGGAAAUGGUUCCCGACGCACUCGAAAGAGUACCUGAGAUGCAGGAUACACCGCCCUGCCUGCACGU,20,14,22,23,79
8145,0,URS0000D669F1_12908/1-81,UAUUGUUGAGGUCGGAAAUGGUUCCCGACGCACCUUGAAAGAGGUACCUGAGAUGCAGGAUACACCGCCCUGCCAGCAACC,21,16,22,22,81
8146,0,URS0000D66277_12908/1-81,GAUUGUUGAGGUCGGAAAUGGUUCCCGACACUCCUCGAAAGAGGAACCUGAGAUGCAGGAUACACCGCCCUGCCUUCAAUC,21,17,21,22,81
8147,0,URS0000D67469_12908/1-81,UGAAAAUGAGGUCGGAAAUGGUUCCCGACGCACUCUGCAAAGAGUACCUGAGAUGAUGGUUACGCCGCCCAUCCAUUUUUA,22,20,20,19,81
8148,0,URS0000D6BE03_12908/1-81,UAAAAAUGAGGUUGGAAAUGGUUCCCGACGCACUCUGCAAAGAGUACCUGAGAUGAUGGAUACGCCGCCCAUCCAUUUUUA,24,20,19,18,81
8149,0,URS0000D6C7B6_12908/1-105,AAUUGCUGAGGUCGGAAAGGUUCCCGGCACACUCCGUUGCAUUGCGUUUGCGCAUAUAUGCGACUGAGUACCUGAGAUGCAGGAUACACCGCCCUGCCAUCAAUU,24,26,27,28,105
8150,0,URS0000D6824A_12908/1-105,AAUUGCUGAGGUCGGAAAGGUUCCCGACACACUCCGUUGCAUUGCGUUUGCGCAUAUAUGCGACUGAGUACCUGAGAUGCAGGAUACACCGCCCUGCCAUCAAUU,25,26,26,28,105
8151,0,URS0000D6A16B_12908/1-84,GAUUGUUGAGGUCGGAAAGGUUCCCGACACACUCCGCAUAUGUGGAGUACCUGAGAUGCAGGAUACACCGCCCUGCCAUCAAUC,21,18,22,23,84
8152,0,URS0000D6ADC9_12908/1-80,GAUUAUUAAGGUCGGAAAGGCUCCCGACACUCUCUGUAAAGAGAACCUGAGAUGCAGGAUACGCCGCCCUGCUAAUAGUC,23,17,20,20,80
8153,0,URS0000D69EA3_12908/1-79,GAUGAUUGAGGUCGGAAAUGGCUCCCGACACACUCGAAAGAGUACCUGAGAUGCAGGAUACGCCACCCUGCCAAUUAUC,23,15,20,21,79
8154,0,URS0000D6C44E_12908/1-81,AAUUGCCAAGGUCGGAAAUGGUUCCCGACACACUCCGAAAAGAGUAUCUGAGAUGAUGGAUACACCGCCCAUCUGGUGAUU,24,18,20,19,81
8155,0,URS0000D6864A_12908/1-78,AGUAGCAAAGGUCGGAAAGGCCCCCGACACACUCGUAAGAGUACCUGAGAUGAUGGAUACGCCGCCCAUCUUGUUGCU,21,15,21,21,78
8156,0,URS0000D687E0_12908/1-78,AGUAGCAAAGGUCGGAAAGGCUCCCGACACACUCACAAGAGUACCUGAGAUGAUGGAUACGCCGCCCAUCUUGUUACU,23,15,19,21,78
8157,0,URS0000D6945F_12908/1-78,GAUUGCAAAGGUCGGAAAGGCUCCCGACACACUCGCAAGAGUACCUGAGAUGAUGGAUACGCCUCCCAUCUUGCAAUU,22,16,19,21,78
8158,0,URS0000D6874A_12908/1-78,AAUCACAAAGGUCGGAAAGGCUCCCGACACACUCGCAAGAGUAUCUGAGAUGAUGGAUACGCCGCCCAUCUUGUGAUU,23,16,19,20,78
8159,0,URS0000D6BA2D_12908/1-78,AAUUAUAAAGGUCGUAAAGGCUCCCGACACACUCGAAAGAGUACCUGAGAUGAUGGAUACGCCGCCCAUCUUAUAAUU,26,18,16,18,78
8160,0,URS0000D6671B_1262880/1-78,AAUUAUAAAGGUCGGAAAGGCUCCCGACACACUCGAAAGAGUACCUGAGAUGAUGGAUACGCCGCCCAUCUUAUAAUU,26,17,17,18,78
8161,0,URS0000D66CA5_12908/1-78,AAUUGCAAAGGUCGGAAAGGCUCCCGACACACUCGAAAGAGUACCUGAGAUGCUGGAUACGCCGCCCAGCUUGUAAUU,23,15,20,20,78
8162,0,URS0000D68096_12908/1-78,AAUUACAAAGGUCGGAAAGGCUCCCGACACACUCGUAAGAGUACCUGAGAUGCUGGAUACGCCGCCCAGCUUGUAAUU,23,16,19,20,78
8163,0,URS0000D68096_537007/1-78,AAUUACAAAGGUCGGAAAGGCUCCCGACACACUCGUAAGAGUACCUGAGAUGCUGGAUACGCCGCCCAGCUUGUAAUU,23,16,19,20,78
8164,0,URS0000D6D1BC_658082/1-78,AAUUGCAAAGGUCGGAAAGGCUCCCGACACACUCGCAAGAGUACCUGAGAUGCUGGAUACGCCGCCCAGCUUGUGAUU,21,15,21,21,78
8165,0,URS0000D65B62_12908/1-78,AACCGCAAAGGUCGGAAAGGCUCCCGACACCCUCAAAAGAGUACCUGAGAUGCUGGAUACGCCGCCCAGCUUGUGAUU,22,13,20,23,78
8166,0,URS0000D67D5F_12908/1-78,AACCGCAAAGGUCGGAAAGGCUCCCGACACACUCGCAAGAGUACCUGAGAUGCUGGAUACGCCGCCCAGCUUGUGAUU,21,13,21,23,78
8167,0,URS0000D6A5F6_12908/1-78,AACCGCAAAGGUCGGAAAGGCUCCCGACACACUCGAAAGAGUACCUGAGAUGCUGGAUACGCCGCCCAGCUUGUGAUU,22,13,21,22,78
8168,0,URS0000D68155_12908/1-78,AACUACAAAGGUCGGAAAGGCUCCCGACACACUCAAAAGAGUACCUGAGAUGAUGGAUACGCCGCCCAUCUUGUAAUU,26,15,17,20,78
8169,0,URS0000D68445_742737/1-78,AAUUACAAAGGUCGGAAAGGCUCCCGACACACUCGCAAGAGUACCUGAGAUGAUGGAUACGCCGCCCAUCUUGUAAUU,24,16,18,20,78
8170,0,URS0000D6971C_12908/1-79,GACAGCAAAGGUCGGAAAGGCUCCCGACGCACUCGCAAAGACUACCUGAGGUGAUGGAUACGCCGCCCAUCUUGCUGUU,20,14,22,23,79
8171,0,URS0000D68F5E_97139/1-82,UUAUUUAGAGGUCGGAAAAGGUUCCCGACACACUCUUAAGAAGAGUACCUGAGAUGCUGGAUACACCGCCCAGCCUAAAUAA,27,18,18,19,82
8172,0,URS0000D69BA9_12908/1-81,UUGUUCUGAGGUCGGAAAUGGUUCCCGACACACUCUGAAAGGAGUACCUGAGAUGAUGGAUACACCGCCCAUCCUUAACAG,22,19,20,20,81
8173,0,URS0000D69134_748727/1-79,GAUUAUUGAGGUCGGAAAUGGUUCCCGACACACUCGAAAGAGUACCUGAGAUGAUGGAUACACCGCCCAUCCGAUAAUC,24,17,19,19,79
8174,0,URS0000D69134_1341692/1-79,GAUUAUUGAGGUCGGAAAUGGUUCCCGACACACUCGAAAGAGUACCUGAGAUGAUGGAUACACCGCCCAUCCGAUAAUC,24,17,19,19,79
8175,0,URS0000D69D52_768710/1-79,GAUUAUCGAGGUCGGAAAUGGUUCCCGACACACUCGAAAGAGUACCUGAGAUGAUGGAUACACCGCCCAUCCGAUAAUC,24,16,19,20,79
8176,0,URS0000D65B11_12908/1-80,GAUUAUUGAGUGUCGGAAAUGGUUCCCGACGCACCCGCAAGGGUACCUGAGAUGAUGGAUACACCGCCCAUCCAAUAAUC,22,17,20,21,80
8177,0,URS0000D6B6F3_12908/1-79,UUAUUUUGAGGUCGGAAAUGGUUCCCGACAUACUCUUUUGAGUACCUGAGAUGAUGGAUACACCGCCCAUCCAAAGUAG,21,23,18,17,79
8178,0,URS0000D68F40_12908/1-79,UUAUUUUGAGGUCGGAAAUGGUUCCCGACAUACUCUUUUGAGUACAUGAGAUGAUGGAUACACCGCCCAUCCAAAGUAG,22,23,18,16,79
8179,0,URS0000D660A8_12908/1-81,UUAUUUUGAGGUCGGAAAUGGUUCCCGACACACUCCAUAAGGAGUACCUGAGAUGAUGGAUACACCGCCCAUCCAAAGUGA,24,19,19,19,81
8180,0,URS0000D660A8_411469/1-81,UUAUUUUGAGGUCGGAAAUGGUUCCCGACACACUCCAUAAGGAGUACCUGAGAUGAUGGAUACACCGCCCAUCCAAAGUGA,24,19,19,19,81
8181,0,URS0000D660A8_1263078/1-81,UUAUUUUGAGGUCGGAAAUGGUUCCCGACACACUCCAUAAGGAGUACCUGAGAUGAUGGAUACACCGCCCAUCCAAAGUGA,24,19,19,19,81
8182,0,URS0000D6BC0B_12908/1-81,CUAUUUUGAGGUCGGAAAAGGUUCCCGACGCACUCUGAUAAGAGUACCUGAGAUGAUGGAUACACCACCCAUCCAAAAUAG,26,18,18,19,81
8183,0,URS0000D6AAC3_12908/1-85,UGUUUUUGAGGUCGGAAAUGGUUCCCGACACACUCUAUGUAUGUAGAGUACCUGAGAUGAUGGAUACACCGCCCAUCCAAAAAUA,25,23,19,18,85
8184,0,URS0000D65B75_12908/1-81,UGUUUUUGAGGUCGGAAAUGGUUCCCGACACACUCUGUAAAGAGUACCUGAGAUGAUGGAUACACCGCCCAUCCAGAGAUA,23,20,20,18,81
8185,0,URS0000D6C33F_1235793/1-79,UAUUUUUGAGGUCGGAAAUGGUUCCCGACACACUCGUAAGAGUACCUGAGAUGCUGGAUACACCGCCCAGCCAAAAAUA,24,18,18,19,79
8186,0,URS0000D6938B_12908/1-79,UAUUUUUGAGGUCGGAAAUGGUUCCCGACACACUCGUAAGAGUACCUGAGAUGCUGGAUACACCGCCCAGCCAAAAAUG,23,18,19,19,79
8187,0,URS0000D68E37_658082/1-81,UGUUUUUGAGGUCGGAAAAGGUUCCCGACACACUCUGAAAAGAGUACCUGAGAUGCUGGAUACACCGCCCAGCCAAAAAUA,26,17,19,19,81
8188,0,URS0000D68E37_12908/1-81,UGUUUUUGAGGUCGGAAAAGGUUCCCGACACACUCUGAAAAGAGUACCUGAGAUGCUGGAUACACCGCCCAGCCAAAAAUA,26,17,19,19,81
8189,0,URS0000D663E9_12908/1-81,UUAUUUUGAGGUCGGAAAAGGUUCCCGACACACUCUGAAAGGAGUACCUGAGAUGAUGGAUACACCGCCCAUCCAAGAUAA,26,18,19,18,81
8190,0,URS0000D6A1E8_411462/1-81,UAUUUUUGAGGUCGGAAAUGGUUCCCGACGCACUCUGAAAAGAGUACCUGAGAUGAUGGAUACACCGCCCAUCCAAAAGUA,25,19,19,18,81
8191,0,URS0000D6A1E8_1263074/1-81,UAUUUUUGAGGUCGGAAAUGGUUCCCGACGCACUCUGAAAAGAGUACCUGAGAUGAUGGAUACACCGCCCAUCCAAAAGUA,25,19,19,18,81
8192,0,URS0000D6A1E8_12908/1-81,UAUUUUUGAGGUCGGAAAUGGUUCCCGACGCACUCUGAAAAGAGUACCUGAGAUGAUGGAUACACCGCCCAUCCAAAAGUA,25,19,19,18,81
8193,0,URS0000D6BFAE_12908/1-81,UAUUUUUGAGGUCAGAAAAGGUUCCUGACGCACUCAGAAAAGAGUACCUGAGAUGAUGGAUACACCGCCCAUCCAAAAAUA,29,18,17,17,81
8194,0,URS0000D6CEEE_12908/1-81,UAUUUUUGAGGUCAGAAAAGGUUCCUGACGCACUUUGAAAAGAGUACCUGAGAUGAUGGAUACACCGCCCAUCCAAAAAUA,28,20,17,16,81
8195,0,URS0000D6A3A1_12908/1-81,UAUUUUUGAGGUCAGAAAAGGUUCCUGACGCACUCUGAAAAGAGUACCUGAGAUGAUGGAUACACCGCCCAUCCAAAAAUA,28,19,17,17,81
8196,0,URS0000D6A3A1_1095771/1-81,UAUUUUUGAGGUCAGAAAAGGUUCCUGACGCACUCUGAAAAGAGUACCUGAGAUGAUGGAUACACCGCCCAUCCAAAAAUA,28,19,17,17,81
8197,0,URS0000D6A3A1_457412/1-81,UAUUUUUGAGGUCAGAAAAGGUUCCUGACGCACUCUGAAAAGAGUACCUGAGAUGAUGGAUACACCGCCCAUCCAAAAAUA,28,19,17,17,81
8198,0,URS0000D6AB50_742737/1-81,UUAUUUUGAGGUCGGAAAUGGUUCCCGACGCACUCUGAAAAGAGUACCUGAGAUGAUGGAUACACCGCCCAUCCAGAAUAA,25,19,19,18,81
8199,0,URS0000D69294_12908/1-79,UAUUUUUGAGGUCGGAAAUGGUUCCUGACACACUCUUCGGAGUACCUGAGAUGAUGGAUACACCGCCCAUCCAAAAGUA,22,21,18,18,79
8200,0,URS0000D6584E_12908/1-79,UAUUAUUGAGGCCGUAAAUGGUUCCUGACACACUCCUCGGAGUACCUGAGAUGAUGGAUACACAGCCCAUCCAAUAAUA,24,20,16,19,79
8201,0,URS0000D67ADD_12908/1-79,UAUUAUUGAGGUCGGAAAUGGUUCCUGACACACUCCUCGGAGUACUUGAGAUGAUGGAUACACCGCCCAUCCAAUAAUA,23,21,17,18,79
8202,0,URS0000D6657B_12908/1-79,UAUUAUUGAGGUCGGAAAUGGUUCCUGACACACUCCUCGGAGUACCUGAGAUGAUGGAUACACCGCCCAUCCAAUAAUC,22,20,17,20,79
8203,0,URS0000D6AE3B_12908/1-79,UAUUAUUGAGGUCGGAAAUGGUUCCUGACACACUCCUCGGAGUACCUGAGAUGAUGGAUACACCGCCCAUCCAAAAAUA,24,19,17,19,79
8204,0,URS0000D6B627_12908/1-79,UAUUAUUGAGGUCGUAAAUGGUUCCUGACACACUCCUCGGAGUACCUGAGAUGAUGGAUACACCGCCCAUCCAAUAAUA,23,21,16,19,79
8205,0,URS0000D6CECA_12908/1-79,UAUUAUUGAGGUCGGAAAUGGUUCCUGACACACUCCUCGGAGUACCUGAGAUGAUGGAUACACCGCCCAUCCAAUAAUA,23,20,17,19,79
8206,0,URS0000D6CECA_1263077/1-79,UAUUAUUGAGGUCGGAAAUGGUUCCUGACACACUCCUCGGAGUACCUGAGAUGAUGGAUACACCGCCCAUCCAAUAAUA,23,20,17,19,79
8207,0,URS0000D68702_12908/1-79,UAUUAUUGAGGUCGGAAAUGGUUCCCGACACACUCUUCGGAGUACCUGAGAUGAUGGAUACACCGCCCAUCCAAUAAUA,23,20,17,19,79
8208,0,URS0000D68702_515620/1-79,UAUUAUUGAGGUCGGAAAUGGUUCCCGACACACUCUUCGGAGUACCUGAGAUGAUGGAUACACCGCCCAUCCAAUAAUA,23,20,17,19,79
8209,0,URS0000D65821_12908/1-79,UAUUAUUGAGGUCGGAAAUGGUUCCUGACACACUCUUCGGAGUACCUGAGAUGAUGGAUACACCGCUCAUCCAAUAAUA,23,22,17,17,79
8210,0,URS0000D68496_12908/1-80,UAUUAUUGAGGUCGGAAAUGGUUCCUGACACACUCUUCGUGAGUACCUGAGAUGAUGGAUACACCGCUCAUCCAAUAAUA,23,23,17,17,80
8211,0,URS0000D66E50_12908/1-79,UGUUUUUGAGGUCGGAAAUGGUUCCCGACGCACUUUUCGGAGUACCUGAGAUGAUGGAUACACCGCCCAUCCAAAAAUA,21,21,19,18,79
8212,0,URS0000D6801A_12908/1-82,GAUUGUUGAGUGUCGGAAAUGGUUCCCGACGCACCUGUUUACAGGUACCUGAGAUGAUGGAUACACCGCCCAUCCAAUAAUC,21,21,20,20,82
8213,0,URS0000D681F6_12908/1-141,GGUAUUUGAGGUCGGAAAUGGCUCCCGACACUCCCUUGUAUGAGGACGGAAGAAGCGGCCGUCGCCCUAGUUGGAGAUGCGUGAGUGCUGACACGCUGCAAGGGAACCUGAGAUGCAGGAUACGCCGCCUUGCCAAAUAUC,33,28,45,35,141
8214,0,URS0000D6B376_12908/1-78,AAUUAUUGAGGUCGGAAAUGGCUCCCGACGCACCUUUACGGUAUUUGAGAUGUAGGAUACGCCGCCCUACCUAUAAUU,20,22,18,18,78
8215,0,URS0000D65860_996306/1-78,UGAUAACGAGGUCAGAAAGGCUCCUGACGCACUCGAGAGAGUACCUGAGAUGUUGGAUACGCCGCCCAACCGCUAUCA,22,14,21,21,78
8216,0,URS0000D65860_1005041/1-78,UGAUAACGAGGUCAGAAAGGCUCCUGACGCACUCGAGAGAGUACCUGAGAUGUUGGAUACGCCGCCCAACCGCUAUCA,22,14,21,21,78
8217,0,URS0000D6CC89_12908/1-80,UAACAACGAGGUCAGAAAGGCCCCUGACGCACCUCUUAGAGGUAACUGAGAUGUUGGAUACGCCGCCCAACCGUUUGUUA,22,17,20,21,80
8218,0,URS0000D684FA_12908/1-78,AACAACGAGGUCAGAAAGGCACCUGACGCACCUCUUUGAGGUAACUGAGAUGUUGGAUACGCCGCCCAACCGUUUGUU,21,17,20,20,78
8219,0,URS0000D6CC5F_12908/1-78,AACAACGAGGUCAGAAAGGCACCUGACGCACCUCCUAGAGGUAACUGAGAUGUUGGAUACGCCGCCCAACCGUUUGUU,22,15,20,21,78
8220,0,URS0000D6CC5F_592010/1-78,AACAACGAGGUCAGAAAGGCACCUGACGCACCUCCUAGAGGUAACUGAGAUGUUGGAUACGCCGCCCAACCGUUUGUU,22,15,20,21,78
8221,0,URS0000D6C5D9_12908/1-80,UAACAACGAGGUCAGAAAGGCACCUGACGCACCUCUUAGAGGUAACUGAGAUGUUGGAUACGCCGCCCAAUCGUUUGUUA,23,18,20,19,80
8222,0,URS0000D66D66_12908/1-80,UAACAACGAGGUCAGAAAGGCACCUGACGCACCUCUUAGAGGUAACUGAGAUGUUGGAUACGCCGCCCAACCGUUUGUUA,23,17,20,20,80
8223,0,URS0000D6A79F_12908/1-81,CUCUAUUGAGGUCGGAAAUGGCACCCGACACACUCUGAAAAGAGUACCUGAGAUGCAACGAGUGCCGCCUUGCCAAUAGUA,24,16,20,21,81
8224,0,URS0000D65745_12908/1-80,CUCUAUUGAGGUCGGAAAUGGCACCCGACACACUCUGAAAAGAGUACCUGAGAUGCAAGAGUGCCGCCUUGCCAAUAGUG,23,16,21,20,80
8225,0,URS0000D65745_1263068/1-80,CUCUAUUGAGGUCGGAAAUGGCACCCGACACACUCUGAAAAGAGUACCUGAGAUGCAAGAGUGCCGCCUUGCCAAUAGUG,23,16,21,20,80
8226,0,URS0000D6C589_12908/1-80,CUCUAUUGAGGUCGGAAAUGGCACCCGACACACUCUGAAAAGAGUACCUGAGAUGCAAGAGUGCCGCCUUGCCAAUAGUA,24,16,20,20,80
8227,0,URS0000D66A34_12908/1-78,ACUAUUUGAGGGCAGAAAGGUUCCUGCCGCACCCGAAAGGGUACCUGAGAUGACGAGGUUACUGAACGUCCAAAUAGG,23,15,23,17,78
8228,0,URS0000D6A232_12908/1-78,ACUAUUUGAGGGCAGAAAGGUUCCUGCCGCACCCGAGAGGGUACCUGAGAUGACGAGGUUACUGAACGUCCAAAUAGG,22,15,24,17,78
8229,0,URS0000D6B234_12908/1-78,ACUAUUUGAGGGCAGAAAGGUUCCUGUCGCACCUGAAAGGGUACCUGAUAUGACGAGGUUACUGAACGUUCAAAUAGG,23,19,22,14,78
8230,0,URS0000D65BAE_12908/1-78,ACUAUUUGAGGGCAGAAAGGUUCCUGCCGCACCUGAAAGGGUACCUGAUAUGACGAGGUUACUGAACGUUCAAAUAGG,23,18,22,15,78
8231,0,URS0000D699EA_12908/1-98,AUGAAUUGAGGGUAGAAAGGUUCCUACCGCACCUCAAAAGGUAUAUCCUACCAAAAAGAGGUACCUGAGAUGACGAGGUUACUGAACGUCCAAUUGAU,34,22,23,19,98
8232,0,URS0000D6856B_12908/1-79,AUGAAUUGAGGGUAGAAAGGUUCCUACCGCACCUCAUAGAGGUACCUGAGAUGACGAGGUUACUGAACGUCCAAUUUAU,24,20,20,15,79
8233,0,URS0000D67255_12908/1-80,GUCCAAUGANGGCAGAAAGGUUCCUGCCGCACCUCUUAGGAGGUACCUGAGAUGACGAGGUUACUGAACGUCCAUUGAAU,21,18,22,18,80
8234,0,URS0000D6C418_12908/1-81,GUUCAUUGAGGGCAGAAAGGUUCCUGCCGCACCUCAAAGAGAGGUACCUGAGAUGACGAGCUUACUGAACGUCCAAUGAAU,24,17,22,18,81
8235,0,URS0000D6A7A0_12908/1-81,AUUCAUUGAGGGCAGAAAGGUUCCUGCCGCACCUCAAAGAGAGGUACCUGAGAUGACGAGCUUACUGAACGUCCAAUGAAU,25,17,21,18,81
8236,0,URS0000D6C559_12908/1-81,GUUCAUUGAGGGCAGAAAGGUUCCUGCCGCACCUCAAAGAGAGGUACCUGAGAUGACGAGGUUACUGAACGUCCAAUGAAU,24,17,23,17,81
8237,0,URS0000D6631B_12908/1-81,AUUCAUUGAGGGCAGAAAGGUUCCUGCCGCACCUCAAAGAGAGGUACCUGAGAUGACGAGGUUACUGAACGUCCAAUGAAA,26,16,22,17,81
8238,0,URS0000D69886_12908/1-81,AUUCAUUGAGGGCAGAAAGGUUCCUGCCGCACCUCAAAGAGAGGUACCUGAGAUGACGAGGUUACUGAACGUCCAAUGAAU,25,17,22,17,81
8239,0,URS0000D6B7D4_12908/1-80,AUUCAUUGAGGGCAGAAAGGUUCCUGCCGCACCUCUUAGGAGGUACCUGAGAUGACGAGGUUACUGAACGUCCAAUGAAU,22,19,22,17,80
8240,0,URS0000D6BEDA_12908/1-80,AUUCAUUGAGGGCAGAAAGGUUCCUGCCGCACCUCUUAGGAGGUACCUGAGAUGACGAGGUUACUGAACGUCCAAUGAAA,23,18,22,17,80
8241,0,URS0000D667D9_12908/1-80,GUUCAUUGAGGGCAGAAAGGUUCCUGCCGCACCUCUUGGGAGGUACCUGAGAUGACGAGGUUACUGAACGUCCAAUGAAU,20,19,24,17,80
8242,0,URS0000D69BA7_12908/1-80,GUUCAUUGAGGGCAGAAAGGUUCCUGCCGCACCUCUUAGGAGGUACCUGAGAUGACGAGGUUACUGAACGUCCAAUGAAA,22,18,23,17,80
8243,0,URS0000D66AAF_12908/1-80,GUUCAUUGAGGGCAGAAAGGUUCCUGCCGCACCUCUUAGGAGGUACCUGAGAUGACGAGGUUACUGAACGUCCAAUGAAU,21,19,23,17,80
8244,0,URS0000D699C7_764298/1-79,GGAAGUCGAGGGCAGAAAAGGUUCCUGCCGCACCUGAGAAGGUAUCUGAGAUGCUGGGUACGCCGACCAGCCGUCUUCC,18,14,26,21,79
8245,0,URS0000D699C7_857105/1-79,GGAAGUCGAGGGCAGAAAAGGUUCCUGCCGCACCUGAGAAGGUAUCUGAGAUGCUGGGUACGCCGACCAGCCGUCUUCC,18,14,26,21,79
8246,0,URS0000D699C7_857139/1-79,GGAAGUCGAGGGCAGAAAAGGUUCCUGCCGCACCUGAGAAGGUAUCUGAGAUGCUGGGUACGCCGACCAGCCGUCUUCC,18,14,26,21,79
8247,0,URS0000D699C7_857138/1-79,GGAAGUCGAGGGCAGAAAAGGUUCCUGCCGCACCUGAGAAGGUAUCUGAGAUGCUGGGUACGCCGACCAGCCGUCUUCC,18,14,26,21,79
8248,0,URS0000D67ED5_12908/1-80,AUUAGUCGAGGGUAGAAAGGUUCCUACCGCACCUUGUAAAAGGUAUCUGAGAUGCUCCAUACACCGCGGAGCCGAUUAAU,23,19,20,18,80
8249,0,URS0000D6A7EE_12908/1-78,AAUAAUUGAGGGUAGAAAGGUUCCUACCGCACCUGAAAAGGUAUCUGAGAUGCUGGAUACACCGACCAGCCAAUUAUU,26,18,18,16,78
8250,0,URS0000D68315_12908/1-80,GACAUUUGAGGGCAGAAAGGUUCCUGCCGCACCUUGAAAAAGGUAUCUGAGAUGCUAGCUACACCGAUCAGCCAAGUGUC,23,17,21,19,80
8251,0,URS0000D65C96_365659/1-80,GACACUUGAGGGCAGAAAGGUUCCUGCCGCACCUUGAAAAAGGUAUCUAAGAUGCUGGAUACACCGACCAGCCAAGUGUC,24,15,21,20,80
8252,0,URS0000D67E6F_12908/1-80,GAUAUUUGAGAGCAGAAAGGUUCCUGCCUCACCUUGAAAAAGGUAUCUGAGAUGCUGGGUACACCGACCAGCCAAAUGUC,24,18,20,18,80
8253,0,URS0000D69312_12908/1-80,GAUAUUUGAGGGCAGAAAGGUUCCUGCCUCACCUUGAAAAAGGUAUCUGAGAUGCUGGGUACACCGACCAGCCAAAUGUC,23,18,21,18,80
8254,0,URS0000D6C9A3_1340484/1-81,GAUAUUUGAGGGCAGAAAGGUUCCUGCCUCACCUUGAAAAAAGGUAUCUGAGAUGCUGGGUACACCGACCAGCCAAAUGUC,24,18,21,18,81
8255,0,URS0000D6BFBC_12908/1-80,GACAUUUGAGGGCAGAAAGGUUCCUGCCGCACCUUGAAAAAGGUACCUGAGAUGCUGGGGACACCGACCAGCCAAGUGUC,22,14,24,20,80
8256,0,URS0000D6899B_585203/1-80,GACAUUUGAGGGUAGAAAGGUUCCCGCCGCACCUUGAAAAAGGUAUCUGAGAUGCUGGGUACACCGACCAGCCAAAUGUC,23,16,22,19,80
8257,0,URS0000D69D40_12908/1-80,GACAUUUGAGGGCAGAAAGGUUCCUGCCGCACCUUGAAAAAGGUAUCUGAGAUGCGGGGUACACCGCCCAGCCAAGUGUC,21,15,24,20,80
8258,0,URS0000D66350_12908/1-80,GACAUUUGAGGGCAGAAAGGUUCCUGCCACACCUUGAAAAAGGUAUCUGAGAUGCUGGGUACACCGACCAGCCAAGUGUC,23,16,22,19,80
8259,0,URS0000D6C8B3_12908/1-80,GACAUUUGAGGGCAGAAAGGUUCCUGCUGCACCUUGAAAAAGGUAUCUGAGAUGCUGGGUACACCGACCAGCCAAGUGUC,22,17,23,18,80
8260,0,URS0000D6874B_12908/1-80,GACAUUUGAGGGCAGAAAGGUUCCUGCCGCACCUUGAAGAAGGUAUCUGAGAUGCUGGGUACACCGACCAGCCAAGUGUC,21,16,24,19,80
8261,0,URS0000D666F5_1008452/1-80,GACAUUUGAGGGCAGAAAGGUUCCUGCCGCACCUUGAAGAAGGUAUCUGAGAUGCUGGGUACACCGACCAGCCAAAUGUC,22,16,23,19,80
8262,0,URS0000D666F5_1415766/1-80,GACAUUUGAGGGCAGAAAGGUUCCUGCCGCACCUUGAAGAAGGUAUCUGAGAUGCUGGGUACACCGACCAGCCAAAUGUC,22,16,23,19,80
8263,0,URS0000D666F5_246201/1-80,GACAUUUGAGGGCAGAAAGGUUCCUGCCGCACCUUGAAGAAGGUAUCUGAGAUGCUGGGUACACCGACCAGCCAAAUGUC,22,16,23,19,80
8264,0,URS0000D6B788_585202/1-80,GACAUUUGAGGGCAGAAAGGUUCCUGCCGCACCUUGAAUAAGGUAUCUGAGAUGCUGGGUACACCGACCAGCCAAGUGUC,21,17,23,19,80
8265,0,URS0000D6CD49_12908/1-80,GAUAUUUGAGGGCAGAAAGGUUCCUGCCGCACCUUGAAAAAGGUAUCUGAGAUGCUGGGUACACCGACCAGCCAAGUGUC,22,17,23,18,80
8266,0,URS0000D6B5ED_12908/1-80,GACAUUUGAGGGCAGAAAGGUUCCUGUCGCACCUUGAAAAAGGUAUCUGAGAUGCUGGGUACACCGACCAGCCAAAUGUC,23,17,22,18,80
8267,0,URS0000D66CE8_12908/1-80,GACAUUUGAGGGCAGAAAGGUUCCUGCCGCACCUUGAAAAAGGUAUCUGAGAUGCUGGGUACACCGACCAGCCAAAUGUN,23,16,22,18,80
8268,0,URS0000D69792_1095736/1-80,GACAUUUGAGGGCAGAAAGGUUCCUGCCGCACCUUGAAAAAGGUAUCUGAGAUGCUGGGUACACCGACCAGCCAAAUGUC,23,16,22,19,80
8269,0,URS0000D69792_1239792/1-80,GACAUUUGAGGGCAGAAAGGUUCCUGCCGCACCUUGAAAAAGGUAUCUGAGAUGCUGGGUACACCGACCAGCCAAAUGUC,23,16,22,19,80
8270,0,URS0000D69792_12908/1-80,GACAUUUGAGGGCAGAAAGGUUCCUGCCGCACCUUGAAAAAGGUAUCUGAGAUGCUGGGUACACCGACCAGCCAAAUGUC,23,16,22,19,80
8271,0,URS0000D6745B_585204/1-80,GACAUUUGAGGGCAGAAAGGUUCCUGCCGCACCUUGGAAAAGGUAUCUGAGAUGCUGGGUACACCGACCAGCCAAGUGUC,21,16,24,19,80
8272,0,URS0000D68075_12908/1-80,GACAUUUGAGGGCAGAAAGGUUCCUGCCGCACCUCGAAAAAGGUAUCUGAGAUGCUGGGUACACCGACCAGCCAAGUGUC,22,15,23,20,80
8273,0,URS0000D6A284_12908/1-80,GACAUUUGAGGGCAGAAAGGUUCCUGCCGCACCUUGAAAAAGGUAUCUGAGAUGCUGGGUACACCGACCAGCCAAUUGUC,22,17,22,19,80
8274,0,URS0000D67E4C_12908/1-80,GACAUUUGAGGGCAGAAAGGUUCCUUCCGCACCUUGAAAAAGGUAUCUGAGAUGCUGGGUACACCGACCAGCCAAGUGUC,22,17,22,19,80
8275,0,URS0000D6C3C4_12908/1-80,GACAUUUGAGGGCAGAAAGGUUCCUGCCGCACCUUGAAAAAGGUAUCUGAGAUGCUGGGUACACCGAGCAGCCAAGUGUC,22,16,24,18,80
8276,0,URS0000D6753E_12908/1-80,GACAUUUGAGGGCAGAAAGGUUCCUGCCGCACCUUGAAAAAGGUAUCUGAGAUGCUGGGUACACCGACCAGCCAAGUGUC,22,16,23,19,80
8277,0,URS0000D6753E_1415765/1-80,GACAUUUGAGGGCAGAAAGGUUCCUGCCGCACCUUGAAAAAGGUAUCUGAGAUGCUGGGUACACCGACCAGCCAAGUGUC,22,16,23,19,80
8278,0,URS0000D6753E_365659/1-80,GACAUUUGAGGGCAGAAAGGUUCCUGCCGCACCUUGAAAAAGGUAUCUGAGAUGCUGGGUACACCGACCAGCCAAGUGUC,22,16,23,19,80
8279,0,URS0000D6753E_1008453/1-80,GACAUUUGAGGGCAGAAAGGUUCCUGCCGCACCUUGAAAAAGGUAUCUGAGAUGCUGGGUACACCGACCAGCCAAGUGUC,22,16,23,19,80
8280,0,URS0000D6753E_1239793/1-80,GACAUUUGAGGGCAGAAAGGUUCCUGCCGCACCUUGAAAAAGGUAUCUGAGAUGCUGGGUACACCGACCAGCCAAGUGUC,22,16,23,19,80
8281,0,URS0000D6AACC_1415758/1-81,GACAUUUGAGGGCAGAAAGGUUCCUGCCACACCUUGCAAAAAGGUAUCUGAGAUGCUGGGUACACCGACCAGCCAAGGGUC,23,15,23,20,81
8282,0,URS0000D6AACC_1054460/1-81,GACAUUUGAGGGCAGAAAGGUUCCUGCCACACCUUGCAAAAAGGUAUCUGAGAUGCUGGGUACACCGACCAGCCAAGGGUC,23,15,23,20,81
8283,0,URS0000D6AACC_1095734/1-81,GACAUUUGAGGGCAGAAAGGUUCCUGCCACACCUUGCAAAAAGGUAUCUGAGAUGCUGGGUACACCGACCAGCCAAGGGUC,23,15,23,20,81
8284,0,URS0000D6AACC_889205/1-81,GACAUUUGAGGGCAGAAAGGUUCCUGCCACACCUUGCAAAAAGGUAUCUGAGAUGCUGGGUACACCGACCAGCCAAGGGUC,23,15,23,20,81
8285,0,URS0000D65EBC_1415761/1-82,GACAUUUGAGGGCAGAAAGGUUCCUGCCACACCUUGCAAAAGGGUAUCUGAGAUGCUGGGUACACCGACCAGCCAAAGGGUC,23,15,24,20,82
8286,0,URS0000D65EBC_1415759/1-82,GACAUUUGAGGGCAGAAAGGUUCCUGCCACACCUUGCAAAAGGGUAUCUGAGAUGCUGGGUACACCGACCAGCCAAAGGGUC,23,15,24,20,82
8287,0,URS0000D6CE07_12908/1-79,AUUCUUUGAGGGCAGAAAGGGUUCCUGCCGCACCUUAUUAGGUACCUGAGAUGCUGGAUACACCGACCAGCCAAGGAAU,21,18,21,19,79
8288,0,URS0000D6B6CD_12908/1-80,AUUCUUUGAGGGCAGAAAUGGUUCCUGCCGCACCUUAUUGAGGUACCUGAGAUGCUGGAUACACCGACCAGCCAAGGAAU,21,19,21,19,80
8289,0,URS0000D65CDB_12908/1-80,AUUCUUUGAGGGCAGAAAGGGUUCCUGCCGCACCUUAUUGAGGUACCUGAGAUGCUGGAUACACCGACCAGCCAAGGAAU,21,18,22,19,80
8290,0,URS0000D65CDB_626369/1-80,AUUCUUUGAGGGCAGAAAGGGUUCCUGCCGCACCUUAUUGAGGUACCUGAGAUGCUGGAUACACCGACCAGCCAAGGAAU,21,18,22,19,80
8291,0,URS0000D69957_12908/1-80,AUUCAUUGAGGGCAGAAAAGGUUCCUGCCGCACCUUAUUGAGGUACCUGAGAUGCUGGAUACACCGACCAGCCAAUGAAU,23,18,20,19,80
8292,0,URS0000D6D360_12908/1-135,AUUAAUUGAGGGCAGAAAGGUUCCUGCCACACCUAACUUGAGGCAUUAAUUAAGAUGUCGGUACUAUUUUAUAGUUGUAAAUCUUGCAUUUACAUAGGUAUCUGAGAUGUUGGGUACACCGUCCAACCAAUUAAU,41,44,27,23,135
8293,0,URS0000D6B7F3_12908/1-135,AUUAAUUGAGGGCAGAAAGGUUCCUGCCGCACCUAACUUGAGGCAUUAAUUAAGAUGUCGGUACUAUUUUAUAGUUGUAAAUCUUGCAUUUACAUAGGUAUCUGAGAUGUUGGGUACACCGUCCAACCAAUUAAU,40,44,28,23,135
8294,0,URS0000D6C0DE_767100/1-81,AGUAGUUGAGGGCAGAAAUGGUUCCUGCCACACCUGCAACAAGGUAUCUGAGAUGUUGGGUACACCGACCAACCGACUACU,23,17,21,20,81
8295,0,URS0000D6BC53_12908/1-81,AGUAGUUGAGGGCAGAAAGGGUUCCUGCCACACCUUGCAAAAGGUAUCUGAGAUGUUGGAUACACCGACCAACCGACUACU,24,17,21,19,81
8296,0,URS0000D6B790_12908/1-81,AGUAGUUGAGGGCAGAAAGGGUUCCUGCCACACCUGUAAUAAGGUAUCUGAGAUGUUGGAUACACCGACCAACCGACUACU,24,18,21,18,81
8297,0,URS0000D69D46_12908/1-79,GUAGUUGAGGGCAGAAAUGGUUCCUGCCACACCUUCAACAAGGUAUCUGAGAUGUUGGAUACACCGACCAACCGACUAC,23,17,19,20,79
8298,0,URS0000D67D61_944565/1-81,GGUAGUUGAGGGCAGAAAUGGUUCCUGCCGCACCUUCAACAAGGUAUCUGAGAUGUUGGAUACACCGACCAACCGACUACU,22,18,21,20,81
8299,0,URS0000D66A9F_12908/1-81,GGUAGUUGAGGGCAGAAAUGGUUCCUGCCGCACCUUCAACAAGGUAUCUGAGAUGUUGGAUACGCCGACCAACCGACUGCU,20,18,23,20,81
8300,0,URS0000D6AD34_12908/1-81,GGUAGUUGAGGGCAGAAAUGGUUCCUGCCGCACCUUCAACAAGGUAUCUGAGAUGUUGGAUACACCGACCAACCGACUGCU,21,18,22,20,81
8301,0,URS0000D6AD34_411465/1-81,GGUAGUUGAGGGCAGAAAUGGUUCCUGCCGCACCUUCAACAAGGUAUCUGAGAUGUUGGAUACACCGACCAACCGACUGCU,21,18,22,20,81
8302,0,URS0000D6BC1A_12908/1-81,AGUAGUUGAGGGCAGAAAAGGUUCCUGCCGCACCUUCAAUUAGGUAUUUGAGAUGUUGGGUACACCGACCAACCGACUACU,22,20,21,18,81
8303,0,URS0000D6934B_12908/1-81,AGUAGUUGAGGGCAGAAAAGGUUCCUGCCGCACCUUCAAUUAGGUAUUUGAGAUGUUGGGUACACCGACCAACCGACUGCU,21,20,22,18,81
8304,0,URS0000D66B16_12908/1-82,UUAGUUUGAGGUGGGAAAUGGUUCCCCAUACGCUAUUAAUUUAGUUAACAGAGAUACAGGAUACACCGCCCUGUCAAACUAA,26,23,17,16,82
8305,0,URS0000D6A77E_12908/1-82,AUAGUUUGAGGUGGGAAAUGGUUCCCCAUACGCUAUUAAUUUAGUUAACAGAGAUACAGGAUACACCGCCCUGUCAAACUAA,27,22,17,16,82
8306,0,URS0000D6B8A0_12908/1-82,AUAGUUUGAGGUGGGAAAUGGUUCCCCAUACGCUAUUAAUUUAGUUAACAGAGAUACAGGAUACACCGCCCUGUCGAACUAU,25,23,18,16,82
8307,0,URS0000D69F98_12908/1-82,AUAGUUUGAGGUGGGAAAUGGUUCCCCAUACGCUAUUAAUUUAGUUAACAGAGAUACAGGAUACACCGCCCUGUCAAACUAU,26,23,17,16,82
8308,0,URS0000D67A3D_12908/1-82,AUAGUUUGAGGUGGGAAAUGGUUCCCCAUACGCUAUUAAUUUAGUUAACAGAGAUACAGGAUACACCGACCUGUCAAACUAG,27,22,18,15,82
8309,0,URS0000D6A497_12908/1-82,AUUAUUUAAGGAUCGGAAAUGGCUUCCGACACGCUACUUUGUAGUAGACAGGUAUGCAGGGUACGCCGUCCUGCCAAAUAAU,23,22,20,17,82
8310,0,URS0000D6D254_1121121/1-75,AAGCGGUGAGGUGGGAAAGGUUCCUCAUGCGCCCUCUGGGUUAAAAGAGAUGCAGGAUACGCCGCCCUGCCAUUU,17,16,24,18,75
8311,0,URS0000D6CAEF_12908/1-79,ACGCUAAGAGGUGGGAAAGGUACCCCACGCGCCCUAGCGGUUAAAAAGAGAUGCGGGAUACGCCGACCCGCCUUAGCGU,21,11,25,22,79
8312,0,URS0000D6584D_12908/1-79,ACGCUAAGAGGUGGGAAAGGUACCCCACGCGCCCUAGCGGUUAAAAAGAGAUGCGGGAUACGCCACCCCGCCUUAGCGU,21,11,24,23,79
8313,0,URS0000D696DF_12908/1-79,ACGCUAAGAGGUGGGAAAGGUACCCCACGCGCCCUAGCGGUUAAAAAGAGAUGCGGGAUACGCCGCCCCGCCUUAGCGU,20,11,25,23,79
8314,0,URS0000D6A70D_12908/1-101,ACGCUAAGAGGUGGGAAAGGUACCCCACGCGCCCUAGCGGUUAACUAGCGGUUAACUAGCGGUUAAAAAGAGAUGCGGGACACGCCGACCCGCCUUAGCGU,27,16,31,27,101
8315,0,URS0000D6728B_12908/1-78,ACGCUAAGAGGUGGGAAAGGUACCCCACGCGCCCUAGAGGUUAACAGAGAUGCGGGAUACGCCGCCCCGCCUUAGCGU,19,11,25,23,78
8316,0,URS0000D69BDA_12908/1-78,ACGCUAAGAGGUGGGAAAGGUACCCCACGCGCCCUAGCGGUUAAAAGAGAUGCGGGAUACGCCGACCCGCCUUAGCGU,20,11,25,22,78
8317,0,URS0000D6C1FC_12908/1-79,ACGCUAAGAGGUGGGAAAGGUACCCCACGCGCCUUUACGGUUAAAAAGAGAUGCGGGAUACGCCGACCCGCCUUAGCGU,21,13,24,21,79
8318,0,URS0000D6CB61_12908/1-79,ACGCUAAGAGGUGGGAAAGGUACCCCACGCGCCUUUACGGUUAAAAAGAGAUGCGGGACACGCCGCCCCGCCUUAGCGU,20,12,24,23,79
8319,0,URS0000D6ABF0_12908/1-79,ACGCUAAGAGGUGGGAAAGGUACCCCACGCGCCUUUACGGUUAAAAAGAGAUGCGGGAUACGCCGCCCCGCCUUAGCGU,20,13,24,22,79
8320,0,URS0000D68696_12908/1-78,ACGCUAAGAGGUGGGAAAGGUACCCCACGCGCCUUUACGGUUAAAAGAGAUGCGGGAUACGCCGACCCGCCUUAGCGU,20,13,24,21,78
8321,0,URS0000D6A9A0_12908/1-90,ACGCUAAGAGGUGGGAAAGGUACCCCACGCGCCCUAGAGGUUAACUAGCGGUUAAAAAGAGAUGCGGGAUACGCCGACCCGCCUUAGCGU,25,14,28,23,90
8322,0,URS0000D6A9A5_12908/1-85,AAUGGCAGAGGACGGAAGGGGCAGCCGUCACCGGAUUGCAUAGGCAUGAGUAGGAGAUGCGGGAACUGUCAACCCGCCUGCCAUU,22,13,30,20,85
8323,0,URS0000D677FC_742814/1-71,AACACUUGAGGAUAGAAAAGGCAGCUAUCGCCCAUGUAGGAAAUGUAGGAAAGGUCGCCCUACCAAGUGUU,24,14,19,14,71
8324,0,URS0000D6B907_1280668/1-80,AGAAGCUGAGGACGGAACAGGCAGCCGUCGCGCCCUAGAGGUCUUAAAAUGAGAUACUGGAUUGUCACCCAGUCUCUUCU,21,17,22,20,80
8325,0,URS0000D6ABE3_12908/1-78,AGUUGACGAGGGCGGAACAGGCAGCCACCACACCCUUUGGGUCUGAAAGAGAUGCAGGAAUGUCGUCCUGCCGGAGCU,19,13,26,20,78
8326,0,URS0000D68B07_12908/1-78,AGUCGACGAGGACGGAACAGGCAGCCGUCGCACCCUAGCGGUUUUAAAGAGAUGUGGGCGGGUCAUCCCACCGGGGCU,17,12,28,21,78
8327,0,URS0000D6B346_12908/1-78,AGUCGACGAGGACGGAACAGGCGGCCGUCGCACCUUAAUGGUCUUAAAGAGAUGCGGGCAGGUCAUCCCGCCGGGGUU,17,13,28,20,78
8328,0,URS0000D68E3F_12908/1-88,AGUCGACGAGGACGGAACAGGCAGCCGUCACACCCCAGGGUUUCCCAGUGGUUUUAAAGAGAUGCGGGCAGGUCAUCCCGCCGUGGCU,19,15,29,25,88
8329,0,URS0000D664EE_12908/1-78,AGUCGACGAGGGCGGAACAGGCAGCCGCCACGCCUUAGUGGUCUUAAAGAGAUGCGGGUAGGUCAUCCCGCCGUGGCU,16,13,28,21,78
8330,0,URS0000D681FE_12908/1-74,GAACCUUGAGGACGGAACGGGCAGCCGUCGCCCCUUAUGGGUAGGAGAUGCGGGAAGGUCACCCGCCGGGUUUC,14,12,28,20,74
8331,0,URS0000D65869_12908/1-80,AAAAAUUGAGGAUAGAACAGGCAGCUAUCACACCUAAUAGGUAUUGAAAGAGAUGUGGGAAGGUCACCCCACCAGUAUUU,30,17,19,14,80
8332,0,URS0000D65869_796937/1-80,AAAAAUUGAGGAUAGAACAGGCAGCUAUCACACCUAAUAGGUAUUGAAAGAGAUGUGGGAAGGUCACCCCACCAGUAUUU,30,17,19,14,80
8333,0,URS0000D69D64_12908/1-85,ACUCACUGAGGGCGGAACUGGCAGCCGCCGCCGGAUAGCUGAAAAGCUUGAUUAGGAGAUGCAGGUUAGUCACCCUGCCUUGAGU,20,17,27,21,85
8334,0,URS0000D672C4_12908/1-141,UAUAUUUGAGGAUAGAACAGGCAGCUAUCACACCUUAUAUUGUAAAAUGUUCCAUGCUCGGUUUUCUAUGAUGGAAAGUAACGCAAGAUGGUCAAUAUAAGGUCUUACAAGAGAUGUAGGAGUGUCGCCCUACCAAAUAUA,47,41,30,23,141
8335,0,URS0000D66631_12908/1-72,AAUAUUAUAGGAUAGAAAUAGUAGCUAUCACCCAUAGUUAGGAGAUAUUGGGGUACUGACCAAUAUAAUAUU,28,22,14,8,72
8336,0,URS0000D69C23_12908/1-72,AAUAUUAUAGGAUAGAAAUAGUAGCUAUCACCCAUAGUUAGGAGAUAUUGGAGUACUGACCAAUAUAAUAUU,29,22,13,8,72
8337,0,URS0000D69D42_12908/1-87,AUUAUUUGAAGAUAGAACAGGCAGCUAUCGCACCUAUAUUAAUAGGUUCAUAAAAGAGAUGCAGGAUACGCCGCCCUGCCAAUUAAU,31,22,17,17,87
8338,0,URS0000D685DB_12908/1-134,UAAGUUGGAGGAUAGAAAGGCAGCUAUCACGCCUAUAAAUAUAAAAUGUUCCUCGCUCGGCUAGUAAUAGCAACGCAAGAAGGUCAUUUAUAGGUCUUGAAAGAGAUGCAGGGUACGCCGACCUGCCCAACUAA,45,30,32,27,134
8339,0,URS0000D68990_12908/1-83,AAAAUCAGAGGAUAGAAAGAGGCAGCUAUCACGCCAGAAAUGGUCUUAAAAGAGAUGCAGGGAACGCCGUCCUGCCUGAUUUA,30,15,22,16,83
8340,0,URS0000D66C84_12908/1-83,AAAAUAAGAGGAUAGAAAGAGGCAGCUAUCACGCCAGAAAUGGUCUUAAAAGAGAUGCAGGGAACGCCGUCCUGCCUGAUUUA,31,15,22,15,83
8341,0,URS0000D6849C_12908/1-72,AGUUUUUGAGGACGGAACAGUUGACCGUCACCCUUGGCUAGGAGAUGUGGAAAGGUCACUCCACCUAAACUU,19,18,19,16,72
8342,0,URS0000D66F45_12908/1-178,AAAGUUUGAGGAUAGAAAGGCAGCUAUCACGCCUAUAAGUGAAAUGCUAAAUUGUCCAGAAUGUGGAUUGUUUUUACAAUCAUCACCUCGUUGUAGCGAGACGGAAAGGUGUAAGUAUAGAGGGUAACAGCUUAAAGGUCUUACAAGAGAUGUGGGGUACGCCGUCCCACCAAGCUUU,56,46,46,30,178
8343,0,URS0000D6D119_12908/1-81,GGUUAUUGAGGAUAGUAAGGCAGCUAUCACGCCAGAGAUGGUCUUUCAAGAGAUGCAGGGUACGCCGUCCUGCCAACAACC,22,17,23,19,81
8344,0,URS0000D68A9D_12908/1-84,GUUAUUUGAGGAUAGAAAGUGGCAGCUAUCACGCCAGAGAUGGUCUUAAAAGCAGAUGUAGGGUACGCCGUCCUACCAAUUAAC,26,20,22,16,84
8345,0,URS0000D6B4D9_12908/1-83,GUUAUUUGAGGAUAGAACAGGCAGCUAUCGCGCCAGAGAUGGUCUUAAAAGAGAUGUUGGGGUACGCCGUCCCACCAAUUAGC,23,19,24,17,83
8346,0,URS0000D65DC2_12908/1-84,GUUAGUUGAGGAUAGAAAGAGGCAGCUAUCACGCCAGAGAUGGUCUUAAAAGAGAUGUUGGGGUACGCCGUCCCACCAAUUAAU,26,19,24,15,84
8347,0,URS0000D6B6E7_12908/1-80,AUUAUUUAAGGAUAGAAAGGCAGCUAUCAAGCCAGAGAUGGUCUAAAAAAGAUGUGGGGUACGCCGUCCCACUAAAUAAU,30,18,19,13,80
8348,0,URS0000D68363_12908/1-81,AUUAUUUAAGGAUAGUAAGGCAGCUAUCACGCCAGAGAUGGUCUUAAAAGAAACGUGGGGAACGCCGUCCCACUAAAUAAU,29,18,19,15,81
8349,0,URS0000D6AC9F_12908/1-81,AUUAUUUAAAGAUAGUAAGGCAGCUAUCACGCCAGAGAUGGUCUUAAAAGAGAUGUGGGGAACGCCGUCCCACUAAAUAAU,29,19,19,14,81
8350,0,URS0000D66E1E_12908/1-81,AUUAUUUAAGGAUAGUAAGGCUGCUAUCACGCCAGAGAUGGUCUUAAAAGAGAUGUGGGGAACGCCGUCCCACUAAAUAAU,27,20,20,14,81
8351,0,URS0000D6C980_12908/1-81,AUUAUUUAAGGAUAGUAAGGCAGCUACCACGCCAGAGAUGGUCUUAAAAGAGAUGUGGGGAACGCCGUCCCACUAAAUAAU,28,18,20,15,81
8352,0,URS0000D67277_12908/1-81,AUUAUUUAAGGAUAGUAAGGCAGCUAUCACGCCAGAGAUGGUCUUAAAAGAGAUGUGGGGAACGCCGUCCCACUAAAUAAU,28,19,20,14,81
8353,0,URS0000D69F50_12908/1-82,UUAUUUUGAGGAUAGAAUAGGCAGCUAUCAAGCCAGAGAUGGUCUUAAAAAAGAUGUGGGGUACGCCGUCCCACCAAAAUAA,29,19,20,14,82
8354,0,URS0000D6A3A5_12908/1-80,GUUAUUUGAGGAUAGAACAGGCAGCUAUCACGCCCUUGGGGUCUUAAAAGAGAUGCCGGAGUGCCGUCCGGUUGAAUAAC,21,19,24,16,80
8355,0,URS0000D6B1D9_12908/1-79,GUUAUUCAAGGAUAGAACAGGCAGCUAUCACGCCCUAGCGGUCUUAAAGAGAUGCCGGAGUGCCACCCGGCUGGAUAAC,22,15,22,20,79
8356,0,URS0000D697A9_12908/1-79,GUUAUUCAAGGAUAGAACAGGCUGCUAUCACGCCCUCGUGGUCUUAAAGAGAUGUCGGAUUGCCACCCGACUGGAUAAC,21,19,20,19,79
8357,0,URS0000D66775_12908/1-79,UUUAUCCAAAAAUAGAACAGGCAGCUAUCACGCCCUAGUGGUCUUAAAGAGAUACCGGAGGACCACUCGGUUGGAUAAU,26,18,18,17,79
8358,0,URS0000D6933A_12908/1-79,UUUAUCCAAAAAUAGAACAGGCAGCUAUCACGCCCUAGUGGUCUUAAAGAGAUACCGGAGUACCACUCGGUUGGAUAAU,26,19,17,17,79
8359,0,URS0000D68058_12908/1-79,AAAUUCCAAGGAUAGAACAGGCAGCUAUCACGCCCUAGUGGUCUUAAAGAGAUACCGGAGUGCCACCCGGUUGGAUAAU,25,16,20,18,79
8360,0,URS0000D6A4B1_12908/1-79,AUUAUCCAAGGAUAGAACAGGCAGCUAUCACGCCCUAGUGGUCUUAAAGAGAUACCGGAGUGUCACCCGGUUGGAGGGU,22,17,23,17,79
8361,0,URS0000D6985B_658082/1-79,AUUAUCCAAGGAUAGAACAGGCAGCUAUCACGCCCUAGUGGUCUUAAAGAGAUACCGGAGUGUCACCCGGUUGGAUGAU,23,18,21,17,79
8362,0,URS0000D67D59_12908/1-80,CUUAUCCAAGGAUAGAACAGGCAGCUAUCACGCCCUUUGUGGUCUUAAAGAGAUACCGGAGUGUCACCCGGUUGGAUAAU,22,20,20,18,80
8363,0,URS0000D68816_12908/1-79,AUUAUCCAAGGAUAGAACAGGCAGCUAUCACGCCCUAGUGGUCUUAAAGAGAUACCGGAGUGUCACCCGGUUGGGUAAU,23,18,21,17,79
8364,0,URS0000D66020_12908/1-79,GUUAUUCAAGGAUAGAACAGGCAGCUAUCACGCCCUCGUGGUCUUAAAGAGAUGUCGGAUUGCCACCCGACUGAAUAAU,23,19,19,18,79
8365,0,URS0000D6A981_12908/1-79,GUUAUUCAAGGAUAGAACAGGCAGCUAUCACGCCCUCGUGGUCUUAAAGAGAUGUCGGAUUGCCACCCGACUGAAUAAC,23,18,19,19,79
8366,0,URS0000D66E8F_411461/1-79,AUUGUCCAAGGAUAGAAAGGCAGCUAUCACACCCUUGUGGUCUUAAAGAAAUGCCGGAGUUGUCGCCCGGCUGGACAAA,23,17,21,18,79
8367,0,URS0000D66E8F_12908/1-79,AUUGUCCAAGGAUAGAAAGGCAGCUAUCACACCCUUGUGGUCUUAAAGAAAUGCCGGAGUUGUCGCCCGGCUGGACAAA,23,17,21,18,79
8368,0,URS0000D66E8F_742765/1-79,AUUGUCCAAGGAUAGAAAGGCAGCUAUCACACCCUUGUGGUCUUAAAGAAAUGCCGGAGUUGUCGCCCGGCUGGACAAA,23,17,21,18,79
8369,0,URS0000D69B4E_12908/1-79,AUUGUCCAAGGAUAGAAAGGCAGCUAUCACACCCUUGUGGUCUUAAAGAGAUGCCGGAGUUGUCACCCGGUUGGACAAA,23,18,21,17,79
8370,0,URS0000D658D7_12908/1-88,AUUAGUCAAGGAUAGAACGGGCAGCUAUCACGCCUACCAACCAAAGUAGGUCUUAAAGAGAUGCAGGGGUGCCAACCUGCUGAUUAAU,29,18,22,19,88
8371,0,URS0000D68FE5_12908/1-88,AUCAGUCAAGGAUAGAACGGGCAGCUAUCACGCCUACCAACCAUAGUAGGUCUUCAAGAGAUGCAGGGGUGCCAACCUGCUGAUUGGU,25,18,24,21,88
8372,0,URS0000D6A19E_12908/1-88,AUCAGUCAAGGAUAGAACGGGCAGCUAUCACGCCUACCAACCAUAGUAGGUCUUCAAGAGAUGCAGGGGUGCCAGCCUGCUGAUUGAU,25,18,24,21,88
8373,0,URS0000D69950_12908/1-84,GUCAUAAGAGGAUAGAACGGGCAGCUAUCACGCCUACUACGUAGGUCUUUUAAGAGAUGCAGGGUUGCCAACCUGCCUUAUGAC,23,20,22,19,84
8374,0,URS0000D6640B_12908/1-79,AAAACUCUGAGGACGGAACUGGUAGCCGUAGCCCAUCGUAAGAUGUAGGAGAUGUGGGAGUACCACCCCACCUAGUUUU,22,17,22,18,79
8375,0,URS0000D6C0F0_12908/1-77,GAGUUCUGAGGACGGAACUGGUAGCCGUAGCCCAUCAUAAGAUGUAGGAGAUGUGGGAGUACCAUCCCACCUAACUC,21,16,22,18,77
8376,0,URS0000D6B197_12908/1-77,AGUUUCUGAGGACGGAACUGGUAGCCGUAGCCCAUCAAAAGAUGUAGGAGAUGUGGGAGUACCACCCCACCUAAACU,23,15,21,18,77
8377,0,URS0000D6678F_12908/1-79,AAGUUUCUGAGGACGGAACUGGUAGCCGUAGCCCAUCAUAAGAUGUAGGAGAUGUGGGAGUACCAACCCACCUAAACUU,24,17,21,17,79
8378,0,URS0000D6B1FC_12908/1-80,UGAAGCAGAGGGCGGAACAGGCGGCCGCCACCCACCAAUUAUCUGGUGUAGGAGAUGUGGAUUGUCACCCACCUACUUCA,20,15,23,22,80
8379,0,URS0000D66048_12908/1-80,AACUGCUGAAGAUAGAACAUGCAGCUAUCGCACCUUUAUGGUUUUAAAGAGAUGUCGGAAACGCCAACCGACCAGCAGUA,27,17,18,18,80
8380,0,URS0000D6572C_1123288/1-89,GACUUUCAGAGGAUGGAACUGGCAGCCUUCGCCGGAUAACCCGAAUGGGUUUGAGUAGGAGAUGCGGGAUAGUCACCCCGCCUAAAGUC,22,18,28,21,89
8381,0,URS0000D684B1_526987/1-82,AAUUGUUGAGGGCGGAACAGGCAGCCGCCACGCCUUUUUAUAAGGUCUUAAAAGAGAUGCAGAUUGCCACCUGCCAAUAAUU,24,20,20,18,82
8382,0,URS0000D6CE0E_12908/1-77,AUUCGCUGAGGGCGGAACAGGCAGCCGCCGCACCUUUAUGGUCUUAAAGAGAUGCAGAUUGUCACCUGCCAGCGGAA,19,15,23,20,77
8383,0,URS0000D65EA4_12908/1-80,ACCUACUGAGGGCAGAACAGGCAACUGCCACACCUUUAUGGUCUUAACGAGAUGCUGGAAAUGCCACCCAGCCAGUAGGA,24,14,20,22,80
8384,0,URS0000D6C291_12908/1-80,ACCUACUGAGGGCAGAACCGGCAGCUGCCGCACCUUUAUGGUCUUAAAGAGAUGCUGGAAACGCCACCCAGCCAGUAGGA,22,13,22,23,80
8385,0,URS0000D67646_12908/1-80,ACCUACUGAGGGCAGAACAGGCAGCUGCCGCACCUUUAUGGUCUUAAAGAGAUGCUGGAAACGCCACCCAGCCAGUAGGA,23,13,22,22,80
8386,0,URS0000D66C75_12908/1-80,ACCUACUGAGGGCAGAACAGGCAGCUGCCGCACCUUUAUGGUCUUAAAGAGAUGCUGGAAACGUCACCCAGCCAGUAGGA,23,14,22,21,80
8387,0,URS0000D6B9F2_12908/1-80,ACCUACUGAGGGCAGAACAGGCAGCUGUCGUACCUUUAUGGUCUUAAAAAGAUGCUGGAAACGCCACCCAGCCAGUAGGA,24,15,21,20,80
8388,0,URS0000D68E71_12908/1-80,ACCUACUGAGGGCAGAACAGGCAGCUGCCGUACCUUUAUGGUCUUAAAAAGAUGCUGGAAACGCCACCCAGCCAGUAGGA,24,14,21,21,80
8389,0,URS0000D6BDA9_12908/1-79,ACCUGCUGAGGGCAGAACAGGCAGCUGCCGCACCUUUACGGUCUUAAAGAGAUGCUGGAAUGUCACCCAGCCAGUAGGA,21,14,23,21,79
8390,0,URS0000D6A546_12908/1-67,UAGUAUAGAGGAUGGAACGGGCAGCCAUCGCCUUUGUGGAGAUGAGGAUUGUCACCCUCCUAUACUU,16,18,19,14,67
8391,0,URS0000D6C437_12908/1-79,AAGCCUUGAGGACGGAACGGGCCGCCGUCGCCCCCAAUUUAGGGUUAGGAGAUGCAGGAAUGUCACCCUGCCAAGGUUG,18,14,26,21,79
8392,0,URS0000D66312_12908/1-79,AAACUUUGAGGACGGAACGGGCCGCCGUCGCCCCAGUUUAUGGGUUCGGAGAUGCAGGAAUUUCACCCUGCCUGAAUUU,17,19,23,20,79
8393,0,URS0000D69686_12908/1-78,UAACAACGAGGGCGGAAGAGGCAGCCGCCGCACCCUCGGGUCUGAAAGAGAUGCAGGACUGUCACCCUGCCGUUGUUU,18,13,25,22,78
8394,0,URS0000D67DE2_1073570/1-78,UAACAACGAGAGCGGAAGAGGUAGCCGCCGCACCUUCGGGUCUGAAAGAGAUGCAGGAUUGUCACCCUGCCGUUGUUU,19,16,24,19,78
8395,0,URS0000D67DE2_264199/1-78,UAACAACGAGAGCGGAAGAGGUAGCCGCCGCACCUUCGGGUCUGAAAGAGAUGCAGGAUUGUCACCCUGCCGUUGUUU,19,16,24,19,78
8396,0,URS0000D67DE2_1073569/1-78,UAACAACGAGAGCGGAAGAGGUAGCCGCCGCACCUUCGGGUCUGAAAGAGAUGCAGGAUUGUCACCCUGCCGUUGUUU,19,16,24,19,78
8397,0,URS0000D67DE2_1263110/1-78,UAACAACGAGAGCGGAAGAGGUAGCCGCCGCACCUUCGGGUCUGAAAGAGAUGCAGGAUUGUCACCCUGCCGUUGUUU,19,16,24,19,78
8398,0,URS0000D696DD_1051074/1-78,UAACAACGAGAGCGGAAGAGGUAGCCGCCGCACCUUCGGGUCUGAAAGAGAUGCAGGAUUGUCAUCCUGCCGUUGUUU,19,17,24,18,78
8399,0,URS0000D696DD_767463/1-78,UAACAACGAGAGCGGAAGAGGUAGCCGCCGCACCUUCGGGUCUGAAAGAGAUGCAGGAUUGUCAUCCUGCCGUUGUUU,19,17,24,18,78
8400,0,URS0000D68AB6_1046629/1-78,UAACAACGAGGGCGGAAGAGGCAGCCGCCGCACCUUCGGGUCUGAAAGAGAUGCAGGACUGUCACCCUGCCGUUGUUU,18,14,25,21,78
8401,0,URS0000D68AB6_596322/1-78,UAACAACGAGGGCGGAAGAGGCAGCCGCCGCACCUUCGGGUCUGAAAGAGAUGCAGGACUGUCACCCUGCCGUUGUUU,18,14,25,21,78
8402,0,URS0000D68AB6_1200793/1-78,UAACAACGAGGGCGGAAGAGGCAGCCGCCGCACCUUCGGGUCUGAAAGAGAUGCAGGACUGUCACCCUGCCGUUGUUU,18,14,25,21,78
8403,0,URS0000D68AB6_12908/1-78,UAACAACGAGGGCGGAAGAGGCAGCCGCCGCACCUUCGGGUCUGAAAGAGAUGCAGGACUGUCACCCUGCCGUUGUUU,18,14,25,21,78
8404,0,URS0000D68AB6_1316410/1-78,UAACAACGAGGGCGGAAGAGGCAGCCGCCGCACCUUCGGGUCUGAAAGAGAUGCAGGACUGUCACCCUGCCGUUGUUU,18,14,25,21,78
8405,0,URS0000D68AB6_1048332/1-78,UAACAACGAGGGCGGAAGAGGCAGCCGCCGCACCUUCGGGUCUGAAAGAGAUGCAGGACUGUCACCCUGCCGUUGUUU,18,14,25,21,78
8406,0,URS0000D68AB6_347253/1-78,UAACAACGAGGGCGGAAGAGGCAGCCGCCGCACCUUCGGGUCUGAAAGAGAUGCAGGACUGUCACCCUGCCGUUGUUU,18,14,25,21,78
8407,0,URS0000D68AB6_1157946/1-78,UAACAACGAGGGCGGAAGAGGCAGCCGCCGCACCUUCGGGUCUGAAAGAGAUGCAGGACUGUCACCCUGCCGUUGUUU,18,14,25,21,78
8408,0,URS0000D68AB6_435842/1-78,UAACAACGAGGGCGGAAGAGGCAGCCGCCGCACCUUCGGGUCUGAAAGAGAUGCAGGACUGUCACCCUGCCGUUGUUU,18,14,25,21,78
8409,0,URS0000D6A6FE_12908/1-78,UAACAACGAGGGCGGAAGAGGCAGCCGCCGCACCUUCGGGUCUGAAAGAGAUGCAGGAUUGUCCCCCUGCCGUUGUUU,17,15,25,21,78
8410,0,URS0000D6A6FE_889206/1-78,UAACAACGAGGGCGGAAGAGGCAGCCGCCGCACCUUCGGGUCUGAAAGAGAUGCAGGAUUGUCCCCCUGCCGUUGUUU,17,15,25,21,78
8411,0,URS0000D664BB_1415776/1-78,UAACAACGAGAGCGGAAGAGGUAGCCGCCGCACCUUCGGGACUGAAAGAGAUGCAGGACUGUCACCCUGCCGUUGUUU,20,14,24,20,78
8412,0,URS0000D664BB_1423145/1-78,UAACAACGAGAGCGGAAGAGGUAGCCGCCGCACCUUCGGGACUGAAAGAGAUGCAGGACUGUCACCCUGCCGUUGUUU,20,14,24,20,78
8413,0,URS0000D664BB_322159/1-78,UAACAACGAGAGCGGAAGAGGUAGCCGCCGCACCUUCGGGACUGAAAGAGAUGCAGGACUGUCACCCUGCCGUUGUUU,20,14,24,20,78
8414,0,URS0000D6D2CF_12908/1-79,AAACAUUGAGGGCGGAACAGGCAGCCGCCACACCCUUUGGGUCUGAAAGAGAUGUAAGAUUGUCACCUUACCUUUGUUU,21,20,20,18,79
8415,0,URS0000D67CDA_12908/1-79,AAAUAAUAAGGACGGAACAGGCAGCCGUCACGCCCUCGUGGUCUUAAAGAGAUGUGGGAAGGUCACCCCACUAUUAUUU,24,17,20,18,79
8416,0,URS0000D66856_1121917/1-70,GGAUUUCCGAGGACGGAACAGGCAGCCGUCGCCGCGGUGGAGAUCCGGGAGUGGCACCCCGCCGGAAUCC,13,8,27,22,70
8417,0,URS0000D69D3E_491915/1-71,AGCUUUCAGAGGAUGGAACAGGCAGCCAUCGCCCUUGUUGGAGAUGCGGGAGUGCCACCCCGCCUAAAGCU,16,13,22,20,71
8418,0,URS0000D6B05D_665952/1-71,GAUUUUCUGAGGAUGGAACAGGCAGCCAUCGCCCUUGGUGGAGAUGCGGGAGUGCCACCCCGCCUAAAAUC,16,14,22,19,71
8419,0,URS0000D6609B_1177186/1-72,GGAUUUCUGAGGAUGGAACAGGCAGCCAUCACCCUAUGUUGGAGAUGCGGGAGUGCCACCCCGCCUAAAUCC,17,14,21,20,72
8420,0,URS0000D6609B_1423/1-72,GGAUUUCUGAGGAUGGAACAGGCAGCCAUCACCCUAUGUUGGAGAUGCGGGAGUGCCACCCCGCCUAAAUCC,17,14,21,20,72
8421,0,URS0000D6B100_12908/1-71,GGAUUUCUGAGGAUGGAACAGGCAACCAUCGCCCAUGUUGGAGAUGCGGGAAUGUCACCCCGCCUAAAUUC,18,15,20,18,71
8422,0,URS0000D680F3_12908/1-85,AAAUAUUGAGGACGGAACAGGCAGCCGUCACGCCAUACUUAUUAUGGUCUUAAAGAGAUGUAGGAGUGUCAACCUACCAAUAUUU,28,22,19,16,85
8423,0,URS0000D6BF5A_293826/1-84,AUUAUUUGAGGACGGAACAGGCAGCCGUCACGCUACCUAUGGUGGUCUUAAAAGAGAUGUGGGAGGGUCACCCCACCAAGUAAU,24,18,24,18,84
8424,0,URS0000D667A5_12908/1-80,AAUCUCCAGAGGACGGAACAGGCAGCCGUCGCCCGUCAAAAGACGUUAGGAGAUGCAGGAUGGUCACCCUGCCGGAGAUU,22,12,25,21,80
8425,0,URS0000D6718E_12908/1-72,AAUCUUUGAGGACGGAACAGGCAGCCGUCGCCCAGAGUUAGGAGAUGCAGGAUUGCCACCCUGCCAACGAUU,19,13,21,19,72
8426,0,URS0000D69E38_12908/1-101,AAUUUCAGAGGACGGAACGGGCCGCCGUCGCCCCCACCACCAUCCGAGGGUGCAGUGGUAAUAUGGGCUGGAGAUGCAGGAGUGUCGCCCUGCCUGAACUU,21,18,33,29,101
8427,0,URS0000D69B3F_12908/1-101,AGAUUUAGAGGACGGAACGGGCCGCCGUCGCCCCCGCCACCAUCCGAGGGUGUAGUGGCAACAUGGGUUGGAGAUGCAGGAGUGUCGCCCUGCCUAAAUUU,21,19,34,27,101
8428,0,URS0000D6B2FE_12908/1-101,AAGUUUAGAGGACGGAACGGGCCGCCGUCGCCCCCGCCACCAUCUGAGGGUGCAGUGGCAUUAUGGGUUGGAGAUGCAGGAGUGUCGCCCUGCCUAAAUUU,20,21,34,26,101
8429,0,URS0000D65850_12908/1-84,AGAAUUAGAGGGCGGAACGGGCAGCCGCCACCAUGUACAUUACGUACAGUAGGAGAUGUGGGAAUAGUCACCCCACCUGAUUCA,25,15,24,20,84
8430,0,URS0000D66787_12908/1-72,AAACAUUGAGGACGGAACGGGCAGCCGUCGCCUUUAUUUGGAGAUGCAGGGAACGUCAUCCUGCCAAUGUUU,18,17,21,16,72
8431,0,URS0000D65AB6_12908/1-87,GAUUUACUGAGGGCGGAACUGGCAGCCGCCGCCGGAUAGUCGAAAGACUUGAUUAGGAGAUGCAGGAUAGUCACCCUGCCUUAAAUC,23,18,26,20,87
8432,0,URS0000D66B8D_12908/1-84,UGAAUCAGAGGACAGAACGGGCAGCUGUCGCCGGAUGGAUUUAAUCCUGAUUAGGAGAUGUGGGAAUGUCACCCCACCUAUUCA,23,19,24,18,84
8433,0,URS0000D682A9_12908/1-84,UGAAGUAGAGGACAGAACGGGCAGCUGUCGCCGGAUGGAGUUAAUCCUGAUUAGGAGAUGUGGGAAUGUCACCCCACCUAUUCA,23,18,26,17,84
8434,0,URS0000D65E37_12908/1-80,AGUAACUGAGGACGGAACGGGCAGCCGUCACCCCUUGCAAAAAGGUUAGGAGAUGUGGGAAAUGUCACCCCACCUUUACU,23,15,22,20,80
8435,0,URS0000D6945A_12908/1-73,AACGCUAGAGGAUAGAACAGGCAGCUAUCGCCCAUCGUUAGGAGAUGCGGGAACCGUCACCCCGCCUAGCUUU,19,13,20,21,73
8436,0,URS0000D6A8A3_12908/1-101,AAACCUUGAGGACGGAACGGGCAGCCGUCGCCCCUCGGAACAACUCUGUGUACAAGAGCCGAGGUUAGGAGAUGUGGGAAAAAGUCACCCCACCUAGGUGU,28,16,31,26,101
8437,0,URS0000D68518_12908/1-80,UAUGGCAGAGGACGGAAUGGGCGGCCGUCGCCCCUCACAAGAGGUUAGGAGAUGUGGGAGAUGUCACCCCACCUGUCUAA,19,14,27,20,80
8438,0,URS0000D6A162_12908/1-80,UUUCUUAGAGGACGGAACAGGCAGCCGUCACGCCCUAGUGGUCUUAAAAGAGAUGUGGGCCAGCCACCCCACCUAAGAAU,22,15,21,22,80
8439,0,URS0000D6BF05_12908/1-87,AAGGUUCUGAGGACGGAACGGGCAGCCGUCGCUGGAUAGUCGAAAGACUUGAUUAAGAGAUGCAGGAAUGUCACCCUGCCAAACCUU,25,17,26,19,87
8440,0,URS0000D6BF71_1262980/1-89,UGAAUAAGAGGACGGAACGGGUAGCCGUCGCCGGAUAAGGUGCAAGACCUUUGAGUAGGAGAUGUGGGAGUGUCGCCCCACCUUAGUUU,22,19,31,17,89
8441,0,URS0000D6B0AF_12908/1-101,GGGAUUAACGAGGACGGAACGGGCUGCUGUCGCCCUCCGACAAAGCCCAUGCGCAGGGUUCGGAGUUAGGAGAUGUGGGAAUGGUCGCCCCACCUAAUCCC,22,17,34,28,101
8442,0,URS0000D6C43E_12908/1-101,GGGAUUAACGAGGACGGAACGGGCUGCUGUCGCCCUCCGACAAAACCCACGCGCGGGGUUCGGAGUUAGGAGAUGUGGGAAUGGCCGCCCCACCUAAUCCC,22,15,34,30,101
8443,0,URS0000D6CEB0_12908/1-77,GAACGCUGAGGGCGGAACAGGCAGCCGCCAUCCAGAGCAAUCCGCAGGAGAUGUGGGAGCGUCACCCCACCUCGUUC,18,9,25,25,77
8444,0,URS0000D687AD_12908/1-87,AGAAUUAAAGGACGGAACAGGCAGCCGUCACCCUGUAUGUAUCGCAUACGGUUAGGAGAUGUGGGAAUAGUCACCCUGCUUAAUUCU,25,21,23,18,87
8445,0,URS0000D6CF29_12908/1-83,GAAAACUGAGGGCGGAACAGGCGGCCGCCACCGGAGAGCAUCAGCUCGAUUAGGAGAUGUGGGAUUGUCACCCCACCUUUUUC,20,15,26,22,83
8446,0,URS0000D66324_12908/1-87,GAGAAUCAGAGGACGGAACGGGCAGCCGUCGCCAGAUGGUCGAGUGACCUGAAUAGGAGAUGCAGGAAUGUCACCCUGCCUAUUCUC,23,15,28,21,87
8447,0,URS0000D6AC34_12908/1-87,GAGAAUCAGAGGACGGAACGGGCAGCCGUCGCCAGAUGGUCGAAUGACCUGAAUAGGAGAUGCAGGAAUGUCGCCCUGCCUAUUCUC,23,15,28,21,87
8448,0,URS0000D6BD7F_12908/1-87,GAGAAUCAGAGGACGGAACGGGCAGCCGUCGCCAGAUGGUCGAAUGACCUGAAUAGGAGAUGCAGGAAUGUCACCCUGCCUAUUCUC,24,15,27,21,87
8449,0,URS0000D6B747_12908/1-86,AGAAGCAGAGGACGGAACGGGCAGCCGUCGCCGGAGGGUCGCAAGACCCGAGUAGGAGAUGCAGGAAUCGCCACCCUGCCUAUUCU,22,10,30,24,86
8450,0,URS0000D67464_12908/1-86,AGAAGCAGAGGACGGAACGGGCAGCCGUCGCCGGAGGGUCACAAGACCUGAGUAGGAGAUGCAGGAAUCGCCACCCUGCCUAUUCU,23,11,29,23,86
8451,0,URS0000D6B53A_12908/1-85,AGAAGCAGAGGACGGAACGGGCAGCCGUCACCGGAUGGUCGAAAGACCUGAGUAGGAGAUGCAGGAAUGUCACCCUGCCUAUUCU,24,13,28,20,85
8452,0,URS0000D6B53A_679201/1-85,AGAAGCAGAGGACGGAACGGGCAGCCGUCACCGGAUGGUCGAAAGACCUGAGUAGGAGAUGCAGGAAUGUCACCCUGCCUAUUCU,24,13,28,20,85
8453,0,URS0000D683F9_12908/1-85,AGAAUCAGAGGACGGAACGGGCAGCCGUCACCGGAUGGUCGAAAGACCUGAGUAGGAGAUGCAGGAAUGUCACCCUGCCUAUUCU,24,14,27,20,85
8454,0,URS0000D6D25D_706434/1-84,AGAAUCUGAGGACGGAACGGGCAGCCGUCGCCAGAAGGUCAUCGACCUGAAUAGGAGAUGCGGGAAUGUCACCCCGCCAAUUCU,23,13,26,22,84
8455,0,URS0000D6D25D_861450/1-84,AGAAUCUGAGGACGGAACGGGCAGCCGUCGCCAGAAGGUCAUCGACCUGAAUAGGAGAUGCGGGAAUGUCACCCCGCCAAUUCU,23,13,26,22,84
8456,0,URS0000D6B8CC_12908/1-78,GUGCUUUGAGGACGGAACGGGCAGCCGUCGCCCCUCAUUGAGGUUAGGAGAUGUGGGAGUGUCACCCCACCAAAACAC,18,14,25,21,78
8457,0,URS0000D6B829_12908/1-79,UGCUUUUGAGGACGGAACGGGCAGCCGUGGCCCCUCGCAAGAGGUUAGGAGAUGUGGGAGUGUCGCCCCACCAAAAAUA,19,14,27,19,79
8458,0,URS0000D67E92_12908/1-79,UGCUUUUGAGGACGGACCGGGCAGCCGUUGCCCCUCGCAAGAGGUUAGGAGAUGUGGGAGUGUCGCCCCGCCAAAAACA,17,14,27,21,79
8459,0,URS0000D6D381_12908/1-79,UGCUUUUGAGGACGGAACGGGCAGCCGUUGCCCCUCGCAAGAGGUUAGGAGAUGUGGGAGUGUCGCCCCACCAAAAACA,19,14,26,20,79
8460,0,URS0000D68961_12908/1-79,AGUUUUUGAGGACGGAACGGGUAGCCGUUGCCCCUCGCAAGAGGUUAGGAGAUGUGGGAGUGUCGCCCCACCAAAAACA,20,15,26,18,79
8461,0,URS0000D6BA4F_12908/1-102,AGAAUAAACGAGGACGGAACGGGCAGCCGUCGCCACUUGAAACAAACCCACGGCCGGGGUUCAAGGUAGGAGAUGUGGGAACAGGUCGCCCCACCUUAUUCU,29,15,31,27,102
8462,0,URS0000D6B5C4_12908/1-70,AUGGAUUGAGGACGGAACAGGCAGCCGUCGCCCUAGUUGGAGAUGUGGGAGUGUCGCCCCACCAUUUCAU,15,15,23,17,70
8463,0,URS0000D6C627_12908/1-73,UAGUCACUGAGGACGGAACGGGCAGCCGUCACCCAUUGUUAGGAGAUGUAGGAGUGUCACCCUACCUUGACUA,18,16,21,18,73
8464,0,URS0000D6AAE8_12908/1-79,GAAAUCUGAGGACGGAACAGGCAGCCGUCACGCCAUUGUGGUCUAAAAGAGAUGUGGGAUUGCCACCCCACCUGAUUUU,21,17,22,19,79
8465,0,URS0000D657BD_12908/1-73,UCCGCCAGAGGACGGAACAGGCAGCCGUCACCCUUUGUUUGGAGAUGCGGGAAGCGUCACCCCGCCUGGCAAU,15,12,23,23,73
8466,0,URS0000D659D7_12908/1-73,UCCGCCAGAGGACGGAACAGGCAGCCGUCACCCUUUGUUUGGAGAUGCGGGAAGCGUCACUCCGUCUGGCAUU,14,15,23,21,73
8467,0,URS0000D6D03D_12908/1-102,ACAAACAGAGGACGGAACGGGCAGCCGUCGCCCCUCGGAACAACUCUUACAGCUGGGAGCCGAGGUUCGGAGAUGCGGGAAAAGUCACCCCGCCUGUUUUGC,25,15,32,30,102
8468,0,URS0000D66698_12908/1-70,AAAGAUAGAGGACGGAACGGGCAGCCGUCGCCUUUAUUGGAGAUGCGGGAGUGUCGCCCCGCCUAUUUUU,15,16,23,16,70
8469,0,URS0000D6BA33_12908/1-70,GAAAUGUGAGGACGGAACGGGCAGCCGUCGCCCUUGUUGGAGAUGUAGGAGUGUCGCCCUACCAUAUUUU,15,17,23,15,70
8470,0,URS0000D6CA3E_12908/1-71,GAAAUUUGAGGACGGAACUGGCAGCCGUCGCCCAUGCUAGGAGAUGUGGGAAUGUCACCCCACCAAAUUUC,19,14,20,18,71
8471,0,URS0000D693B4_12908/1-85,AGAAUUAGAGGACGGAACGGGCAGCCGUCGCUAUACUUCCAAAAGAAGUAGUUGGAGAUGUGGGAAUGUCACCCCACCUAAUUCU,26,18,23,18,85
8472,0,URS0000D6B6A8_12908/1-86,AGGAUUUGAGGACGGAACGGGCAGCCGUCGCCAGAUAGCGGAAACGCUUGAAUAGGAGAUGUGGGAUUGUCACCCCACCUUAUUCU,22,18,27,19,86
8473,0,URS0000D66BA8_12908/1-86,AGAAUUUGAGGACGGAACGGGCAGCCGUCGCCAGAUAGCAGAAACGCUUGAAUAGGAGAUGUGGGAUUGUCACCCCACCUUAUUCU,24,18,25,19,86
8474,0,URS0000D67008_1123313/1-72,GAAUGCUGAGGGCGGAACAGGCAGCCGCCACCCAUUGUUAGGAGAUGUAGGAAUCGUCACCCUACCUCAUUC,18,14,20,20,72
8475,0,URS0000D67796_12908/1-80,AGUAGUAGAGGACGGAACGGGCGGCCGUCGCCCCUUGCAAAAGGUUAGGAGAUGUGGGAAUUGUCACCCCACCUAUUGCU,19,16,26,19,80
8476,0,URS0000D6AD75_12908/1-80,AGUAGUAGAGGACGGAACGGGCGGCCGUCGCCCCUUGCAAAAGGUUAGGAGAUGUGGGAACUGUCACCCCACCUAUUACU,20,15,25,20,80
8477,0,URS0000D6AADE_12908/1-78,GAAAAUAGAGGACGGAACGGGCAGCCGUCGCCCCCGAAAGGGAUAGGAGAUGUGGGAAAUGUCACCCCACCUAUUUUU,23,13,24,18,78
8478,0,URS0000D67CCF_12908/1-78,AAAAAUAGAGGACGGAACGGGCAGCCGUCGCCCCCGUAAGGGAUAGGAGAUGUGGGAAAUGUCACCCCACCUAUUUUU,23,14,23,18,78
8479,0,URS0000D6833C_12908/1-78,AGAAAUAGAGGACGGAACGGGCAGCCGUCGCCCCCGAAAGGGUUAGGAGAUGUGGGAAUCGUCACCCCACCUAUUUCU,21,13,24,20,78
8480,0,URS0000D6D05B_12908/1-88,AAAGGCAGAGGACGGAACAGGCAGCCGUCGCUCCUGACUUAAAUCAGGUCUUGUUAAGAGAUGUGGGAAUGUCACCCCACCUACUUUC,24,19,23,22,88
8481,0,URS0000D6CF26_12908/1-87,UAAAAUCUGAGGACGGAACAGGCGGCCGUCGCCAGAAAACCACAUGGUUUGAGUAGGAGAUGUGGGAAUGUCACCCCACCUAUUUUA,26,18,24,19,87
8482,0,URS0000D67F7E_12908/1-98,AAUAAACGAGGACGGAACGGGCAGCCGUCGCCACUUGGGUUAAACUCUUGGCCAGAGUCCAAGGUAGGAGAUGUGGGAACAGGUCGCCCCACCUUAUU,26,18,30,24,98
8483,0,URS0000D6BF29_12908/1-102,AGAAUAAACGAGGACGGAACGGGCAGCCGUCGCCACUUGGGUCAAACUCUAGGCCAGAGUCCAAGGUAGGAGAUGUGGGAACAGGUCGCCCCACCUUAUUCU,28,17,31,26,102
8484,0,URS0000D6ACF1_12908/1-72,AGAAUUAGAGGACGGAACGGGCAGCCGUCGCCCUAAGCUCGGAGAUGUGGGAGUGUCGCCCCACCUAAGGCA,18,10,25,19,72
8485,0,URS0000D6A7EC_12908/1-73,AUCACCGGAGGACGGAACAGGCAGCCGUCACCCAUCGUUCGGAGAUGUGGGGAGUGUCACCCCGCCCGGUUUC,14,12,24,23,73
8486,0,URS0000D67179_12908/1-73,AUCACCGGAGGACGGAACAGGCAGCCGUCACCCAUCGUUCGGAGAUGUGGGAAGUGUCACCCCGCCCGGUUUC,15,12,23,23,73
8487,0,URS0000D67E84_12908/1-73,AAAACCGGAGGACAGAACAGGCAGCCGUCGCCCAUCGUUCGGAGAUGUGGGAAGUGUUACCCCGCCUGGUUUC,17,13,23,20,73
8488,0,URS0000D6B673_12908/1-73,AGAACCGGAGGACGGAACAGGCAGCCGUCACCCUUUGUUUGGAGAUGCGGGAAGCGUCCCCCCGCCCGGUUUC,14,12,24,23,73
8489,0,URS0000D6B68E_12908/1-70,GGGAUUUGAGGACGGAACCGGCAGCCGUCGCCCUUGUUGGAGAUGUAGGAGUGUCGCCCUACCAAGUCUU,13,16,24,17,70
8490,0,URS0000D69FCA_12908/1-70,GGGAUUUGAGGACGGAACGGGCAGCCGUCGCCCUCGUUGGAGAUGCGGGAGUGUCGCCCUACCAAGUCUU,12,14,26,18,70
8491,0,URS0000D678D2_12908/1-70,GGGAUUUGAGGACGGAACGGGCAGCCGUCACCCUUGUUGGAGAUGUGGGAGUGUCACCCCACCAAAUCCC,15,13,23,19,70
8492,0,URS0000D68718_12908/1-70,GGAAUCAGAGGACGGAACGGGCAGCCGUCGCCCUUGUUGGAGAUGUGGGGGUGUCGCCCCACCUGAUUCU,12,14,26,18,70
8493,0,URS0000D67545_12908/1-70,GGAAUUAAAGGACGGAACGGGCAGCCGUCGCCCUUGUUGGAGAUGUGGGAGUGUCGCCCCACUUAAUUCC,15,15,23,17,70
8494,0,URS0000D67F12_12908/1-70,AGAAUUAAAGGACGGAACGGGCAUCCGUCACCCUAGUUGGAGAUGUGGGAGUGUCGCCCCACUUAAUUCU,18,16,20,16,70
8495,0,URS0000D679A0_12908/1-78,GGGAUUAGAGGACGGAACGGGCAGCCGUCACCCCUCGAAAGAGGUUAGGACAUGUGGGAAUGUCACCCCCCUAAUUCC,20,13,24,21,78
8496,0,URS0000D6CBEB_12908/1-79,GGGAUUAGAGGACGGAACGGGCAGCCGUCACCCCUCGAAAGAGGUUAGGACAUGUGGGAAUGUCGCCCCACCUAAUUCC,20,13,25,21,79
8497,0,URS0000D6B82F_12908/1-79,GAGGUUAGAGGACGGAACGGGCAGCCGUCACCCCUCGAAAGAGGUUAGGACAUGUGGGAAUGUCGCCCCACCUAAUUCC,20,13,25,21,79
8498,0,URS0000D6AED0_12908/1-79,GGAAUUAAAGGACGGAACGGGCAGCCGUCACCCCUCGUGUGAGGUUUGGAGAUGUGGGAAUGUCACCCCACUUAAUUCC,19,17,24,19,79
8499,0,URS0000D6612F_12908/1-80,GAAGUUAAAGGACGGAACAGGCAGCCGUCACCCCUCGCAAGAGGUUAGGAGAUGUGGGAAUUGUCACCCCACUUAAUUUC,23,16,22,19,80
8500,0,URS0000D66209_12908/1-80,GAAGUUAAAGGACGGAACAGGCAACCGUCACCCCUCGCAAGAGGUUAGGAGAUGUGGGAAUUGUCACCCCACUUAAUUUC,24,16,21,19,80
8501,0,URS0000D6BA6A_12908/1-79,GGAAUUAAAGGACGGAACAGGCAGCCGUCACCCCUCGCAAGAGGUUAGGAGAUGUGGGAAUGUCACCCCACUUAAUUUC,23,15,22,19,79
8502,0,URS0000D677E3_12908/1-72,UGAAACUGAGGACAGAAAAGGCAGCCGUCGCCCAUUGUUAGGAGAUGUGGGAAAUGUCACCCCACCUUUUCA,21,15,19,17,72
8503,0,URS0000D65BAF_1262761/1-72,UGAAACUGAGGGCAGAAAAGGCAGCCGUCGCCCAUUGUUAGGAGAUGUGGGAAAUGUCACCCCACCUUUUCA,20,15,20,17,72
8504,0,URS0000D65BAF_12908/1-72,UGAAACUGAGGGCAGAAAAGGCAGCCGUCGCCCAUUGUUAGGAGAUGUGGGAAAUGUCACCCCACCUUUUCA,20,15,20,17,72
8505,0,URS0000D65F8C_12908/1-72,UGAAACUGAAGACAGAAAAGGCAGCCGUCGCCCAUUGUUAGGAGAUGUAGGAAAUGUCACCCCACCUUUUCA,23,15,17,17,72
8506,0,URS0000D6ADB7_1262825/1-69,GGAAUCUGAGGACGGAACAGGCGGCCGUCACCCAUUGUUAGGAGAUGUGGAUUGUCACCCACCUAUUCC,16,15,20,18,69
8507,0,URS0000D6ADB7_12908/1-69,GGAAUCUGAGGACGGAACAGGCGGCCGUCACCCAUUGUUAGGAGAUGUGGAUUGUCACCCACCUAUUCC,16,15,20,18,69
8508,0,URS0000D6618D_12908/1-69,GAAAGCAGAGGACGGAACGGGCAGCCGUCACCCUAGUUGGAGAUGUGGGAAUGUCACCCCACCUAUUUC,18,12,21,18,69
8509,0,URS0000D657AC_12908/1-87,AGAACUAGAGGACGGAACGGGCAGCCGUCACCGGAUAGCCGCAAGGCUUGAUUAGGAGAUGUGGGAGACGUCACCCCACCUAAUUCU,24,14,27,22,87
8510,0,URS0000D65777_12908/1-87,AGAACUAGAGGACGGAACGGGCAGCCGUCACCGGAUAGCCGCAAGGCUUGAUUAGGAGAUGUGGGAAGCGUCACCCCACCUAAUUCU,24,14,27,22,87
8511,0,URS0000D6BFB1_12908/1-70,GAAAUCUGAGGACGGAACGGGCAGCCGUCACCCUUGUUGGAGAUGUGGGAAUGUCACCCCCACCUAUUUC,16,15,20,19,70
8512,0,URS0000D675F3_12908/1-70,GAAAUCUGAGGACGGAACGGGCAGCCGUCACCCUAGUUGGAGAUGUGGGAAUGUCACCCCCACCUAUUUC,17,14,20,19,70
8513,0,URS0000D67899_12908/1-71,UGAAAUCAGAGGACGGAACGGGCAACCGUCACCCUAGUUGGAGAUGUGGAAAUGUCACCCCACCUAUUUCA,21,14,18,18,71
8514,0,URS0000D69F4B_12908/1-71,UGAAAUCUGAGGACGGAACGGGCAGCCGUCACCCUUGUUGGAGAUGUGGGAAUGUCACCCCACCUACUUCA,17,15,20,19,71
8515,0,URS0000D67416_12908/1-71,UGAAAUCAGAGGACGGAACGGGCAGCCGUCACCCUUGUUGGAGAUGUGGGAAUGUCACCCCACCUAUUUCA,18,15,20,18,71
8516,0,URS0000D662DC_12908/1-70,UGAAAUCUGAGGACGGAACGGGCAGCCGUCACCCUUGUUGGAGAUGUGGGAAUGUCACCCACCUAUUUCA,17,16,20,17,70
8517,0,URS0000D65E72_12908/1-69,GAAAUCUGAGGACGGAACGGGCAGCCGUCACCCUAGUUGGAGAUGUGGGAAUGUCACCCCACCUAUUUC,17,14,20,18,69
8518,0,URS0000D6A4F2_12908/1-69,GAAAUCUGAGGACGGAACGGGCAGCCGUCACCCUUGUUUGAGAUGUGGGAAUGUCACCCCACCUAUUUC,16,16,19,18,69
8519,0,URS0000D6C0AB_12908/1-69,GAAAUCUGAGGACGGAACGGGCAGCCGUCACCCUUGUUGGAGAUGUGGGAAUGUCACCCCACCUAUUUC,16,15,20,18,69
8520,0,URS0000D6C0AB_1263077/1-69,GAAAUCUGAGGACGGAACGGGCAGCCGUCACCCUUGUUGGAGAUGUGGGAAUGUCACCCCACCUAUUUC,16,15,20,18,69
8521,0,URS0000D689F7_12908/1-69,GAAAUCUGAGGACGGAACGGGCAGCCGUCACCCUUGUUGGAGAUGUGGGAAUGUCACCCCACCUAUUNN,16,14,20,17,69
8522,0,URS0000D6916A_12908/1-71,UGAAAGCAGAGGACGGAACGGGCAGCCGUCACCCUAGUUGGAGAUGUGGGAAGGUCACCCCACCUAUUUCA,19,12,22,18,71
8523,0,URS0000D66FA6_12908/1-71,GAAAUCUGAGGACGGAACGGGCAGCCGUCGCCCAUUGUUAGGAGAUGCGGGAAUGUCACCCCACCAGUUUC,17,13,22,19,71
8524,0,URS0000D67E26_12908/1-73,GGAAAUCAGAGGACGGAACGGGCACCCGUCGCCCAUUGUUAGGAGAUGCGGGAAUGUCACCCCACCAGUUUCA,19,12,22,20,73
8525,0,URS0000D66870_12908/1-73,UGAAAGCAGAGGGCGGAACGGGCAGCCGUCACCCAUUGUUAGGAGAUGUGGGAAUGUCACCCCACCUAUUUCA,19,14,22,18,73
8526,0,URS0000D6B72E_12908/1-74,UGAAAGCAGAGGACGGAACGGGCAGCCGUCGCCCAUUGUUAGGAGAUGUGGGAAUUGUCACCCCACCUAUUUCA,19,15,22,18,74
8527,0,URS0000D6B899_12908/1-73,UGAAAGCAGAGGACGGAACGGGCAGCCGUCGCCCAUUGUUAGGAGAUGUGGGAAUGUCACCCCACCUAUUUCA,19,14,22,18,73
8528,0,URS0000D68329_12908/1-73,UGAAAGCAGAGGGCGGAACAGGCGGCCGCCACCCAUUGUUAGGAGAUGUGGGAGUGUCACCCCACCUAUUUCA,18,13,23,19,73
8529,0,URS0000D6B7FC_12908/1-71,GGAGUUUGAGGACGGAACGGGCAGCCGUCGCCCUUGUUAGGAGAUGUGGGAGUGUCGCCCCGCCAAAUUCU,13,15,26,17,71
8530,0,URS0000D671C1_12908/1-72,AGCAACGGAGGACGGAACAGGCAGCCGUCGCCCAGCGUUAGGAGAUGUGGGAAGCGUCACCCCACCCUUGCU,17,9,24,22,72
8531,0,URS0000D65B99_12908/1-73,AGAACCAGAGGACGGAACAGGCAGCCGUCGCCCAUUGUUAGGAGAUGCGGGAAGCGUCACCCCGCCUGAUUCU,18,11,23,21,73
8532,0,URS0000D6A737_12908/1-72,AGCAACGGAGGACGGAACAGGCAGCCGUCGCCCAUUGUUAGGAGAUGUGGGAAUCGUCCCCCCCCCCUUGCU,15,12,22,23,72
8533,0,URS0000D6999F_12908/1-73,AGCAACGGAGGACGGAACAGGCAGCCGUCGCCCGGUGUUAGGAGAUGUGGGAAUCGUCACCCCCACCCUUGCU,16,11,24,22,73
8534,0,URS0000D6A27A_12908/1-72,AGCAACGGAGGACGGAACAGGCAGCCGUCGACCUUUGUUAGGAGAUGUGGGAAUCGUCACCCCACCCUUGCU,17,13,22,20,72
8535,0,URS0000D697D2_12908/1-73,AGCAACGGAGGACGGAACAGGCAGCCGUCGCCCAUUGUUAGGAGAUGUGGGAAUCGUCACCCCACCUAUUUCU,18,14,21,20,73
8536,0,URS0000D67CB1_12908/1-72,AGCAACGGAGGACGGAACAGGCAGCCGUCGCCCAUUGUUAGGAGAUGUGGGAAUCGUCACCCCACCCUUGCU,17,12,22,21,72
8537,0,URS0000D67CB1_411485/1-72,AGCAACGGAGGACGGAACAGGCAGCCGUCGCCCAUUGUUAGGAGAUGUGGGAAUCGUCACCCCACCCUUGCU,17,12,22,21,72
8538,0,URS0000D6B049_12908/1-73,AGAACCAGAGGGCAGAACAGGCAGCUGCCGCCCAUUGUUAGGAGAGGCGGGAGACGUCACCCCGCCUGAUUCU,18,10,24,21,73
8539,0,URS0000D68081_12908/1-73,AGAACCAGAGGGCAGAACAGGCAGCUGCCGCCCAUCGUUAGGAGAUGCGGGAAACGUCACCCCGCCUGAUUCU,19,10,22,22,73
8540,0,URS0000D68554_12908/1-73,AGAACCAGAGGGCAGAACAGGCAGCUGCCGCCCAUUGUUAGGAGAUGCGGGAAAUGUCACCCCGCCUGAUUCU,19,12,22,20,73
8541,0,URS0000D660DC_12908/1-73,AGAACCAGAGGGCAGAACAGGCAGCUGCCGCCCAUUGUUAGGAGAUGCGGGAAACGUCACCCCGCCUGAUUCU,19,11,22,21,73
8542,0,URS0000D6AB20_12908/1-73,AGAACCAGAGGACGGAACAGGCAGCCGUCACCCAUCGUUAGGAGAUGCGGGAAGCGUCACCCCGCCUGAUUCU,19,10,22,22,73
8543,0,URS0000D65993_12908/1-73,AGAACCAGAGGACGGAACAGGCAGCCAUCACCCAUCGUUAGGAGAUGCGGGAAGCGUCACCCCGCCUGAUUCU,20,10,21,22,73
8544,0,URS0000D66BAB_12908/1-73,AGGAUUAGAGGACGGAACAGGCAGCCGUCGCCCAUUGUUAGGAGAUGUGGGAAUAGUCACCCCACCUAAUUCU,20,15,21,17,73
8545,0,URS0000D670AA_12908/1-73,AGAAUCAGAGGACGGAACAGGCAGCCGUCGCCCAUUGUUAGGAGAUGCGGGAAUCGUCACCCCGCCUGAUUCU,18,13,22,20,73
8546,0,URS0000D6CE39_12908/1-73,AGAAUCGGAGGACGGAACAGGCAGCCGUCGCCCAUUGUUAGAAGAUGCGGGAAUCGUCACCCCGCCUGAUUCU,18,13,22,20,73
8547,0,URS0000D66837_12908/1-73,AGGAUCAGAGGACGGAACAGGCAGCCGUCACCCAUUGUUAGGAGAUGCGGGAAUCGUCACCCCGCCUGAUUCU,18,13,22,20,73
8548,0,URS0000D6A4D4_12908/1-73,AGGAUUAGAGGACGGAACAGGCAGCCGUCGCCCAUUGUUAGGAGAUGCGGGAAUCGUCACCCCGCCUGAUUCU,17,14,23,19,73
8549,0,URS0000D6964A_12908/1-73,AGGAUCAGAGGACGGAACAGGCAGCCGUCGCCCAUUGUUAGGAGAUGCGGGAAUCGUCACCCCGCCUGAUUCU,17,13,23,20,73
8550,0,URS0000D6930F_12908/1-73,AGGAUUGGAGGACGGAACAGGCAGCCGUCGCCCAUUGUUAGGAGAUGCGGGAAUCGUCACCCCGCCUGAUUCU,16,14,24,19,73
8551,0,URS0000D6B26A_12908/1-73,AGGAUCGGAGGACGGAACAGGCAGCCGUCGCCCAUUGUUAGGAGAUGCGGGAAUCGUCACCCCGCCUGAUUCU,16,13,24,20,73
8552,0,URS0000D676C6_12908/1-73,AGGAUCGGAGGAUGGAACAGGCAGCCGUCGCCCAUUGUUAGGAGAUGCGGGAAUCGUCACCCCGCCUGAUUCU,16,14,24,19,73
8553,0,URS0000D6CC03_12908/1-73,AGGAUCGGAGGACGGAACAGGCAGCCGUCGCCCAUUGUUAGGAGAUGCGGGAAUCGUCACCCCGCGUGAUUCU,16,13,25,19,73
8554,0,URS0000D6BE2E_12908/1-73,AGAAACAGAGGACGGAACAGGCAGCCGUCGCCCGGUGUUAGGAGAUGCGGGAAACAUUACCCCGCCUGUUUCU,19,12,23,19,73
8555,0,URS0000D6D090_12908/1-73,AGAAACAGAGGACGGAACAGGCAGCCGUCACCCGGUGUUAGGAGAUGCGGAAAACGUCACCCCGCCUGUUUCU,20,11,22,20,73
8556,0,URS0000D6C6E1_12908/1-73,AGAAACAGAGGACGGAACAGGCAACCGUCGCCCGGUGUUAGGAGAUGCGGGAAACGUCACCCCGCCUGUUUCU,19,11,23,20,73
8557,0,URS0000D6C741_12908/1-73,AGAAACAGAGGACGGAACAGGCAGCCGUCGCCCGGUGUUAGGAGAUGCGGGAAACGUCACCCCGCCUGUUUCU,18,11,24,20,73
8558,0,URS0000D6C276_12908/1-73,AAAAACAGAGGACGGAACAGGCAGCCGUCGCCCGGUGUUAGGAGAUGCGGGAAACGUCACCCCGCCUGUUUCU,19,11,23,20,73
8559,0,URS0000D66634_12908/1-73,AGAAACAGAGGACGGAACAGGCAGCCGUCGCCCGGUGUUAGGAGAUGUGGGAAACGUCACCCCGCCUGUUUCU,18,12,24,19,73
8560,0,URS0000D698DD_12908/1-73,AGAAACAGAGGACGGAACAGGCAGCCGUCGCCCGGUGUUAGGAGAUGCGGGAAACGUCCCCCCGCCUGUUUCU,17,11,24,21,73
8561,0,URS0000D68D3C_12908/1-73,AGAAACAGAGGACGGAACAGGCAGCCGUCGCCCGGUGUUAGGAGAUGCGGGAAAUGUCAACCCGCCUGUUUCU,19,12,24,18,73
8562,0,URS0000D6B44A_12908/1-73,AGAAACAGAGGACGGAACAGGCAGCCGUCGCCCGGUGUUAGGAGAUGCGGGAAAGGUCAACCCGCCUGUUUCU,19,11,25,18,73
8563,0,URS0000D6AED3_12908/1-73,AGAAACAGAGGACGGAACAGGCAGCCGUUGCCCGGUGUUAGGAGAUGCGGGAAACGUCAACCCGCCUGUUUCU,19,12,24,18,73
8564,0,URS0000D6B90B_12908/1-73,AGAAACAGAGGACGGAACAGGCAGCCAUCGCCCGGUGUUAGGAGAUGCGGGAAACGUCAACCCGCCUGUUUCU,20,11,23,19,73
8565,0,URS0000D65738_12908/1-73,AGAAACAGAGGACGGAACAGGCAGCCGUCGCCCGGUGUUAGGAGAUGAGGGAAACGUCAACCCGCCUGUUUCU,20,11,24,18,73
8566,0,URS0000D6808E_12908/1-73,AGAAAUAGAGGACGGAACAGGCAGCCGUCGCCCGGUGUUAGGAGAUGAGGGAAACGUCAACCCGCCUGUUUCU,20,12,24,17,73
8567,0,URS0000D67377_12908/1-73,AGAAACAGAGGACGGAACAGGCAGCCGUCGCCCGGUGUUAGGAGAUGCGGGAAACGUCAACCCGCCUGUUUCU,19,11,24,19,73
8568,0,URS0000D67377_411483/1-73,AGAAACAGAGGACGGAACAGGCAGCCGUCGCCCGGUGUUAGGAGAUGCGGGAAACGUCAACCCGCCUGUUUCU,19,11,24,19,73
8569,0,URS0000D6C149_12908/1-71,AGAAUUAGAGGACGGAAGGGGCAGCCGUCACCCUUGUUAGGAGAUGCGGGAGUGUCGCCCCGCCUAGUUCU,15,14,25,17,71
8570,0,URS0000D6A548_12908/1-71,AGAACUAGAGGACGGAACGGGCAGCCGUCACCCUUGUUAGGAGAUGUGGGAGCGUCGCCCCACCUAGUUCU,16,13,23,19,71
8571,0,URS0000D6AEBE_12908/1-71,AGGACUAGAAGACGGAACGGGCAGCCGUCGCCCUUGUUAGGAGAUGUGGGAGCGUCGCCCCACCUAGUUCU,15,13,24,19,71
8572,0,URS0000D691D8_12908/1-71,AGGAUUAGAGGACGGAACGGGCAGCCGUCGCCCUUGUUAGGAGAUGUGGGAGUGUCGCCCCACCUAAUUCU,15,15,24,17,71
8573,0,URS0000D67A52_12908/1-73,AGAACCAGAGGACGGAACAGGCAGCCGUCACCCAUUGUCAGGAGAUGUGGGGAGUGUCAUCCCACCUGAUUCU,19,13,22,19,73
8574,0,URS0000D69381_12908/1-73,AGAAACAGAGGACGGAACAGGCAGCCGUCGCCCAUUGUCAGGAGAUGUGGGGAGUGUCAUCCCACCUGAUUCU,19,13,23,18,73
8575,0,URS0000D68A94_12908/1-73,AGAACCAGAGGACGGAACAGGCAGCCGUCGCCCAUUGUCAGGAGAUGUGGGGAGUGUCAUCCCACCUGAUUCU,18,13,23,19,73
8576,0,URS0000D68A94_1262898/1-73,AGAACCAGAGGACGGAACAGGCAGCCGUCGCCCAUUGUCAGGAGAUGUGGGGAGUGUCAUCCCACCUGAUUCU,18,13,23,19,73
8577,0,URS0000D66792_12908/1-73,AGAGCCAGAGGACGGAACAGGCAGCCGUCGCCCAUUGUCAGGAGAUGUGGGGAGUGUCAUCCCACCUGAUUCU,17,13,24,19,73
8578,0,URS0000D6ACFD_12908/1-73,AGAACCAGAGGACGGAACAAGUAGCCGUCGCCCCUUGUCAGGAGAUGUGGGGAGUGUCAUCCCACCUGAUUCU,18,14,22,19,73
8579,0,URS0000D6CF43_12908/1-72,UCAAGUAGAGGACGGAACGGGCAGCCGUCGCCCAUUGUUAGGAGAUGUGGGAAUGUCACCCCACCUGCUUGU,16,15,23,18,72
8580,0,URS0000D6D3D0_12908/1-72,UCAAGCAGAGGACGGAACUGGCGGCCGUCGCCCAUUGUUAGGAAAUGUGGGAGUGCCACCCCACCUGCUUGU,15,14,23,20,72
8581,0,URS0000D6A842_12908/1-79,GAAAUCUGAGGACGGAACAGGCAGCCGUCACGCCCUUGUGGUCUAAAAGAGAUGUGGGAUUGCCACCCCACCUGUUUCA,20,16,22,21,79
8582,0,URS0000D6A8F4_12908/1-81,UGGAAUCUGAGGACGGAACAGGCAGCCGUCACGCCCCAGUGGUCUUAAAAGAGAUGUGGGAUUGCCACCCCACCUAUUUCA,21,16,22,22,81
8583,0,URS0000D6A854_12908/1-79,GAAAUCUGAGGACGGAACAGGCAGCCGUCACGCCCUUGUGGUCUUUAAAGAGAUGUGGGAUUGCCACCCCACCUAUUUC,19,18,21,21,79
8584,0,URS0000D68CC1_12908/1-80,UGAAAUCUGAGGACGGAACAGGCAGCCGUCACGCCCUUUGGGUCUUAAAGAGAUGUGGGAUUGUCACCCCACCUAUUUCA,20,19,21,20,80
8585,0,URS0000D692D9_12908/1-81,UGAAAUCUGAGGACGGAACAGGCAGCCGUCACGCCCUUUGUGGUCUUAAAGAGAUGUGGGAUUGUCACCCCACCUAUUUCA,20,20,21,20,81
8586,0,URS0000D692D9_1262785/1-81,UGAAAUCUGAGGACGGAACAGGCAGCCGUCACGCCCUUUGUGGUCUUAAAGAGAUGUGGGAUUGUCACCCCACCUAUUUCA,20,20,21,20,81
8587,0,URS0000D6759C_12908/1-80,GAAAGCAGAGGACGGAACAGGCAGCCGUCACGCCCUAGUGGUCUUUAAAGAGAUGUAGGAUUGUCACCCUACCUAUUUCA,23,17,21,19,80
8588,0,URS0000D66BD1_12908/1-80,UGAAAUCUGAGGACGGAACAGGCAGCCGUCACGCCCUUGUGGUCUUAAAGAGAUGUGGGAUUGUCACCCCACCUAUUUCA,20,19,21,20,80
8589,0,URS0000D6B988_12908/1-81,UGAAAGCAGAGGACGGAACAGGCAGCCGUCACGCCCUAGUGGUCUUAAAAGAGAUGUGGGAGGGUCACCCCACCUAUUUCA,23,14,24,20,81
8590,0,URS0000D6C2C2_12908/1-71,GAACGUAGAGGACGGAACGGGCAGCCGUCGCCCAUUGUUAGGAGAUGUGGGAGUGUCACCCCACCUAUUUC,16,14,23,18,71
8591,0,URS0000D69BF1_657314/1-80,AAAAUCUGAGGACGGAACAGGCAGCCGUCGCGCCAUAUGGGUCUUAAAAGAGAUGUAGGAUUGUCACCCUACCUAUUUUA,24,19,20,17,80
8592,0,URS0000D66655_12908/1-71,AGUUUCAGAGGGCGGAACAGGCAGCCGCCACCCGUUGUUAGGAGAUGUAGGAAGGUCACCCUACCUAAGCU,18,13,22,18,71
8593,0,URS0000D6AC1D_12908/1-71,AGUUUCUGAGGGCGGAACAGGCAGCCGCCACCCAUUGUUAGGAGAUGUAGAAAUGUCAAACUACCUAAACU,22,15,18,16,71
8594,0,URS0000D6BA53_12908/1-73,AAGUUUCUGAGGGCGGAACAGGCAGCCGCCACCCGUUGUUAGGAGAUGUAGGAAGGUCACCCUACCUAAACUU,19,15,21,18,73
8595,0,URS0000D67830_12908/1-73,AAGUUUCUGAGGGCGGAACAGGCAGCCGCCACCCAUAGUUAGGAGAUGUAGGAAGGUCAACCUACCUAAACUU,22,14,20,17,73
8596,0,URS0000D67830_1262812/1-73,AAGUUUCUGAGGGCGGAACAGGCAGCCGCCACCCAUAGUUAGGAGAUGUAGGAAGGUCAACCUACCUAAACUU,22,14,20,17,73
8597,0,URS0000D69301_12908/1-71,AGUUUCUGAGGGCGGAACAGGCAGCCGCCACCCGUAGUUAGGAGAUGUAGGAAGGUCAACCUACCUAAACU,20,13,21,17,71
8598,0,URS0000D689F2_12908/1-71,GGAUUGAGAGGACGGAACGGGCAGCCGUCGCCCUUAGUUGGAGAUGCGGGAGUGUCGCCCCGCCUCAGUCC,12,12,27,20,71
8599,0,URS0000D68C78_12908/1-69,AGGAUUUGAGGGCAGAACGGGCAUCUGCCGCCUAGAUGGAGAUGCAGGAGUGUCGCCCUGCCAAACCUU,16,13,23,17,69
8600,0,URS0000D69939_12908/1-81,AGUAUUUGAGGAUAGAAAAGGUAGCUAUCAGUCGUUUUUUAAAAAUGUAACAAAUGUGGGAGUGCCACCCCACCAAAUACU,29,22,17,13,81
8601,0,URS0000D69025_12908/1-78,AGUAUUUGAGGAUAGAAAAGGUAGCUAUCAGUCAUUUCUGAAAUGUACAAAUGUGGGAGUACCACCCCACCAAAUACU,28,20,16,14,78
8602,0,URS0000D6B75D_12908/1-81,AGUAUUUGAGGAUAGAAAAGGUAGCUAUCGGUCAUUUUUUUAAAAUGUAACAAAUGUGGGAGUACCACCCCACCAAAUACU,29,23,16,13,81
8603,0,URS0000D6B904_12908/1-78,AGUAUUUGAGGAUAGAAAAGGUAGCUAUCAGUCAUUUCUAAAAUGUACAAAUGUGGGAGUACCACCCCACCAAAUACU,29,20,15,14,78
8604,0,URS0000D66839_12908/1-72,UUAAUUUGAGGAUAGAAAAGUCAGCUAUCACCCUAGUUUAGGAGAUACAGGAGUGGCGACCUGUCUUAUUAA,23,21,17,11,72
8605,0,URS0000D6A12B_12908/1-71,UUAAUUUGAGGAUAGAAAAGUCAGCUAUCACCCUAGUUAGGAGAUACAGGAGUGGCGACCUGUCUUAUUAA,23,20,17,11,71
8606,0,URS0000D6C587_12908/1-70,UUAAUUUGAGGAUAGAAAGUCAGCUAUCACCCUAGUUAGGAGAUACAGGAGUGGCGACCUGUCUUAUUAA,22,20,17,11,70
8607,0,URS0000D65C23_12908/1-72,UUAAUUUUGAGGAUAGAAAAGUCAGCUAUCACCCUAGUUAGGAGAUACAGGAGUGGCGACCUGUCUUAUUAA,23,21,17,11,72
8608,0,URS0000D65A6A_12908/1-72,UUAAUUUGAGGAUAGAAAAGUCAGCUAUCACCCUAGUUAGGAGAUACAGGAAGUGGCGACCUGUCUUAUUAA,24,20,17,11,72
8609,0,URS0000D66B17_12908/1-72,UUAAUUUGAGGUAUAGAAAAGUCAGCUAUCACCCUAGUUAGGAGAUACAGGAGUGGCGACCUGUCUUAUUAA,23,21,17,11,72
8610,0,URS0000D66D7D_12908/1-71,UAAAUUUGAGGAUAGAAAAGUCAGCUAUCGCCCUUGUUAGGAGAUGUAGGAGUGACGCCCUACCAAAUUAU,23,19,17,12,71
8611,0,URS0000D6B48F_12908/1-72,UAGUAUUGAGGAUAGAAAAGGCAGCUAUCACCCUUGUUAGGAGAUAUGGGAAGGGUCACCCCAUCUUUACUA,22,19,18,13,72
8612,0,URS0000D6B48F_999414/1-72,UAGUAUUGAGGAUAGAAAAGGCAGCUAUCACCCUUGUUAGGAGAUAUGGGAAGGGUCACCCCAUCUUUACUA,22,19,18,13,72
8613,0,URS0000D6B48F_469607/1-72,UAGUAUUGAGGAUAGAAAAGGCAGCUAUCACCCUUGUUAGGAGAUAUGGGAAGGGUCACCCCAUCUUUACUA,22,19,18,13,72
8614,0,URS0000D6B48F_556264/1-72,UAGUAUUGAGGAUAGAAAAGGCAGCUAUCACCCUUGUUAGGAGAUAUGGGAAGGGUCACCCCAUCUUUACUA,22,19,18,13,72
8615,0,URS0000D65822_12908/1-71,AGUAUUUGAGGAUAGAAAAGGCAGCUAUCACCCUUGUUAGGAGAUAUGGGAAAUGUCGUCCCAUCUUUACU,21,21,17,12,71
8616,0,URS0000D6D000_12908/1-72,UAGUAUUGAGGAUAGAAAAGGCAGCUAUCACCCUUGUUAGGAGAUAUGGGAAAUGUUGUCCCAUCUUUACUA,22,22,17,11,72
8617,0,URS0000D69DE1_12908/1-72,UAGUAUUGAGGAUAGAAAAGGCAGCUAUCACCCUUGUUAGGAGAUAUGGGAAAUGUCGUCCCAUCUUUACUA,22,21,17,12,72
8618,0,URS0000D65E9B_12908/1-72,UAGUAUUGAGGAUAGAAAAGGCAGCUAUCACCCUAGUUAGGAGAUAUGGGAGUGCCACCCCAUCUAAUACUA,24,17,17,14,72
8619,0,URS0000D6C25F_1316587/1-72,UAGUAUUGAGGAUAGAAAAGGCAGCUAUCACCCUCGUUAGGAGAUGUGGAAAAUGUCGCUCCACCUUUACUA,22,19,17,14,72
8620,0,URS0000D6C25F_12908/1-72,UAGUAUUGAGGAUAGAAAAGGCAGCUAUCACCCUCGUUAGGAGAUGUGGAAAAUGUCGCUCCACCUUUACUA,22,19,17,14,72
8621,0,URS0000D6C25F_1216362/1-72,UAGUAUUGAGGAUAGAAAAGGCAGCUAUCACCCUCGUUAGGAGAUGUGGAAAAUGUCGCUCCACCUUUACUA,22,19,17,14,72
8622,0,URS0000D6A8B1_12908/1-78,UAGCAUUUGAGGAUAGAAAUGCGGCAGCUAUCACCCUCUAUGUUAGGAGAUACGGGAAAAGUCGACCCGUCUAUGCUA,23,19,20,16,78
8623,0,URS0000D6C866_12908/1-71,AGUAUUUGAGGAUAGAAAAGGCAGCUAUCACCCUUGUUAGGAGAUAUGGGAGUGCCAUCCCAUCUAAUACU,22,19,17,13,71
8624,0,URS0000D6C1F1_12908/1-71,AGUAUUUGAGGAUAGAAAAGGCAGCUAUCACCCUCGUUAGGAGAUAUGGGAGUGCCACCCCAUCUAAUACU,22,17,17,15,71
8625,0,URS0000D6C369_12908/1-71,AGUAUUUGAGGAUAGAAAAGGCAGCUAUCACCCUUGUUAGGAGAUAUGGGAGUGCCACCCCAUCUAAUACU,22,18,17,14,71
8626,0,URS0000D66984_12908/1-71,AGUAUUUGAGGAUAGAAAAGGCAGCUAUCACCCUAGUUAGGAGAUAUGGGAGUGCCACCCCAUCUAAUACU,23,17,17,14,71
8627,0,URS0000D6CE3F_12908/1-74,AGUAUUUGAGGAUAGAAAAGGUAGCUAUCACCUAUGUUAGAAGAUAUAGGAGUGCUGCUACCUCAUCUAAUACU,25,22,16,11,74
8628,0,URS0000D69612_12908/1-74,AGUAUUUGAGGAUAGAAAAGGUAGCUAUCACCUAUGUUAGAAGAUAUGGGAGUGCUGCUACCUCAUCUAAUACU,24,22,17,11,74
8629,0,URS0000D68134_12908/1-73,AGUAUUUGAGGAUAGAAAAGGUAGCUAUCACCUAUGUUAGAAGAUAUGGGAGUGUGCUACCUCAUCUAAUACU,24,22,17,10,73
8630,0,URS0000D6737D_12908/1-75,AGCAUUAGAGGAUAGAAAUGGCAGCUAUCGCACAUUAUGUUAUGAGAUGCAGGAAUUGUCGCCCUGCCUAAUGUA,23,20,19,13,75
8631,0,URS0000D66B5E_12908/1-73,AGCAUUAGAGGAUAGAAAUGGCAGCUAUCGCACAUUGUUAUGAGAUGCAGGAAUUGUCGCCCUGCCUAAUGCU,21,19,19,14,73
8632,0,URS0000D68ED3_12908/1-73,AGCAUUAGAGGAUAGAAAUGGCAGCUAUCGCACAAUGUUAUGAGAUGCAGGAAUUGUCGCCCUGCCUAAUGCA,23,17,19,14,73
8633,0,URS0000D68B83_12908/1-73,AGCAUUAGAGGAUAGAAAUGGCAGCUAUCGCACAUUGUUAUGAGAUGCAGGAAUUGUCGCCCUGCCUAAUGCA,22,18,19,14,73
8634,0,URS0000D6602A_12908/1-74,AGCAUUAGAGGAUAGAAAUGGCAGCUAUCGCACAUUUGUUAUGAGAUGCAGGAAUUGUCGCCCUGCCUAAUGCA,22,19,19,14,74
8635,0,URS0000D6BEB8_12908/1-73,UGUAUUUGAGGAUAGAAAUGGCAGCUAUCGCCCAUUGUUAGGAGAUACAGGAUUCGUCGCCCUGUCUUAUACA,19,22,18,14,73
8636,0,URS0000D675BC_12908/1-72,AGCAUUUGAGGAUAGAAAUGGCAGCUAUCACCCAUUGUUAGGAGAUACAGGAAGGUCAACCUGUCUUAUGCU,22,19,18,13,72
8637,0,URS0000D69225_12908/1-73,AGCAUUAGAGGAUGGAAAUGGCAUCCAUCGCCCAAUGUUAGGAGAUGCAGGAAAAGUCGCCCUGCCUAAUGCA,23,14,20,16,73
8638,0,URS0000D68FE8_12908/1-73,AGCAUUAGAGGAUAGAAAUGGCAGCUAUCACCCAAUGUUAGGAGAUGCAGGAAAAGUCGCCCUGCCUUAUGCU,23,16,19,15,73
8639,0,URS0000D68FE8_634994/1-73,AGCAUUAGAGGAUAGAAAUGGCAGCUAUCACCCAAUGUUAGGAGAUGCAGGAAAAGUCGCCCUGCCUUAUGCU,23,16,19,15,73
8640,0,URS0000D6CA71_12908/1-73,AGUAUUAGAGGAUAGAAAUGGCAGCUAUCACCCAAUGUUAGGAGAUGCAGGAAAAGUCGCCCUGCCUUAUGCU,23,17,19,14,73
8641,0,URS0000D68B1B_872024/1-82,AUUACUUGAGGGCAGAACAGGCAGCUGCCACGCCACUUUGUGGUCUUUCAAGAGAUGUAGGGGUGCCAACCUACCAAGUAAU,22,19,22,19,82
8642,0,URS0000D698E7_12908/1-81,GUUAUUUGAGGGCAGAACGGGCGGCUGCCACGCCAGCAAUGGUCUUUAAAGAGAUGUAGGGUUGCCAACCUACCGAAUAGC,21,17,25,18,81
8643,0,URS0000D6B5DF_545243/1-85,AUUAUUGAAGGGCAGAACGGGCAGCUGCCACGCCUUAGAAAUAAGGUCUUUCAAGAGAUGUAGGGUUGCCAACCUACUCAGUAAU,26,20,22,17,85
8644,0,URS0000D68604_12908/1-84,AUUAUUUGAGGACAGAACAGGCAUCUGUCGCACCACAAAUGUGGUUUGGAAAGAGAUGUGGGAUACGCCGCCCCACCAAAUAAU,27,18,21,18,84
8645,0,URS0000D6CD8E_537010/1-81,GUUAUUUGAGGACAGAACAGGCAUCUGUCACGCCCUUGUGGUUUGGAAAGAGAUGUGGGAUACGCCACCCCACCAAAUAAC,23,18,21,19,81
8646,0,URS0000D6CD8E_272564/1-81,GUUAUUUGAGGACAGAACAGGCAUCUGUCACGCCCUUGUGGUUUGGAAAGAGAUGUGGGAUACGCCACCCCACCAAAUAAC,23,18,21,19,81
8647,0,URS0000D6A5C8_12908/1-81,AUUACUUGAGGGCAGAACAGGCAGCUGCCGCACCCUUGUGGUCUGAAAAGAGAUGUAGGGUACGCCUUCCUACCAAAUAAU,23,18,21,19,81
8648,0,URS0000D6BCE6_12908/1-70,GAUUAUUGAGGACAGAACAGGCAUCUGUCGCCCUUGUGGAGAUGUAGGACACGCCGCCCUACCAAUAAUC,19,15,18,18,70
8649,0,URS0000D6C878_12908/1-141,CUUUACUGAGGGUAGAAACACUGAGCCUUCUUUUAUAAACGCAUGGUCGGCUCAGCACUAGGCCAGCGGGCCGUCGAGGCAUCUACCGCACCCAACUCCAGGGUAUAAAGAGAUGUGGGACACGCCGCCCCACCAGUAAUU,36,28,36,41,141
8650,0,URS0000D6CDE6_12908/1-83,GAUUAUUGAGGAUAGGAUAGGCAUCUAUCGCACCCAACUUCAGGGUAUAAAGAGAUGUGGGAUACGCCUCCCCACCAAUAAUC,26,19,19,19,83
8651,0,URS0000D6604E_12908/1-79,GAUUAUUGAGGGUAGAACAGGCAUCUACCGCACCUUCAAGGUAUAAAGAGAUGUGGGACACGCCGCCCCACCAAUAAUC,25,15,19,20,79
8652,0,URS0000D691F7_12908/1-83,GAUUAUUGAGGGUAGAACAGGCAUCUACCGCACCCUUAAGCAGGGUAUAAAGAGAUGUGGGAUACGCCGCCCCACCAAUAAUC,26,16,21,20,83
8653,0,URS0000D69E56_12908/1-143,GAUUAUUGAGGGUAGAAACGCUGAGCCUUCUUUUAUAAACGCAUGGUCGGCUCAGCACUAGGCUCAGCGGGGCCGUCGAGGCAUCUACCGCACCCUUAAACAGGGUAUAAAGAGAUGUGGGACACGCCGCCCCACCAAUAAUC,38,29,38,38,143
8654,0,URS0000D65A1F_12908/1-79,GAUUAUUGAGGGUAGAACAGGCAUCUACCGCACCCUUAGGGUAUAAAGAGAUGUGGGACACGCCGCCCCACCAAUAAUC,24,15,20,20,79
8655,0,URS0000D65C4E_12908/1-79,GAUUAUUGAGGGUAGAACAGGCAGCUACCGCACCCUUUGGGUAUAAAGAGAUGUGGGACACGCCGCCCCACCAGUAUUC,21,16,22,20,79
8656,0,URS0000D6A35F_12908/1-79,GAUUAUUGAGGGUAGAACAGGCAGCUACCGCACCCUUUGGGUAUAAAGAGAUGUGGGACACGCCGCCCCACCAAUAUUC,22,16,21,20,79
8657,0,URS0000D68117_12908/1-79,GAUUAUUGAGGGUAGAACAGGCAGCUACCGCACCCUUUGGGUAUAAAGAGAUGUGGGACACGCCGCCCCACCAAUAAUC,23,15,21,20,79
8658,0,URS0000D66994_12908/1-141,GGUUAUUGAGGGUAGAAACGCUGAGCCUUCUUUUAUAAACGCAUGGUCGGCUCAGCACUAGGCCAGCGGGCCGUCGAGGCAUCUACCGUACCCAACUUUAGGGUAUAAAAAGAUGUGGGAUACGCCGCCCCACCAAUAAUC,37,31,37,36,141
8659,0,URS0000D6AC06_12908/1-141,GAUUAUUGAGGGUAGAAACGCUGAGCCUUCUUUUGUAAACGCAUGGUCGGCUCAGCACUAGGCCAGCGGGCCGUCGAGGCAUCUACCGCACCCAACUUCAGGGUAUAAAGAGAUGUGGGAUACGCCGCCCCACCAAUAAUC,36,29,38,38,141
8660,0,URS0000D69E32_12908/1-141,AAUUAUUGAGGGUAGAAACGCUGAGCCUUCUUUUGUAAACGCAUGGUCAGCUCAGCAUUAGGCCAACGGGCCGUCGAGGCAUCUACCGCACCCAACUUCAGGGUAUAAAGAGAUGUGGGAUACGCCGCCCCACCAAUAAUC,39,30,35,37,141
8661,0,URS0000D6768E_12908/1-83,GAUUAUUGAGGGUAGAACAGGCAUCUACCGCACCCAACUCCAGGGUAUAAAGAGAUGUGGGACACGCCGCCCCACCAAUAAUC,26,14,20,23,83
8662,0,URS0000D67969_12908/1-83,GAUCAUUGAGGGUAAAACAGGCAUUUACCGCACCCAACUUUAGGGUAUAAAGAGAUGUGGGAUACGCCGCCCCACCAAUAAUC,27,17,19,20,83
8663,0,URS0000D670EE_12908/1-79,AAUCACAGAGGGCAGAACAGGCAGCUGCCGCACCUUUUGGGUUUAAAGAGAUGUGGGACACGCCGCCCCACCUGUGAUU,20,15,23,21,79
8664,0,URS0000D6C47F_12908/1-85,AAUUAUAAGAGGGUAGAACAGGCAACUGCCGCGCCACUUUGUGGUCUGAUAAAGAGAUGUAGGGUACGCCGUCCUACCUAUAAUU,25,21,22,17,85
8665,0,URS0000D6B282_12908/1-69,AUUAUCUGAGGACAGAACGGGCAUCUGUCGCCCUUUGUUGGAGAUGUAGGAAUGUCACCUACCUAUAAU,18,20,17,14,69
8666,0,URS0000D6D1A0_12908/1-67,AACUGAUGAAGUUGGAACAGGUAGCCAACACCUUUAUGGAGAUGCAGAUUACCACCUGCCAUCAGUU,21,16,15,15,67
8667,0,URS0000D6CDA9_12908/1-84,AAUUAUCGAGGAUAGAACAGGCAGCUAUCACUCCUACUUAUGUAGGUCUUAAAGAGAUGUGGACGUGCCAAUCCACCGAUAAUA,28,21,18,17,84
8668,0,URS0000D6928A_12908/1-85,AAUUAUCGAGGAUAGAACAGGCAGCUAUCACUCCUACUUAUGUAGGUCUUAAAAGAGAUGUGGACGUGCCAAUCCACCGAUAAUA,29,21,18,17,85
8669,0,URS0000D6BD61_12908/1-79,GAACAUUGAGGAUAGAACAGGCAGCUAUCGCACCCUUGUGGUCUGAAAGAGAUGUGGAAAGGUCACUCCACCAAUGUUC,24,17,21,17,79
8670,0,URS0000D67663_12908/1-85,AAGUGCAGAGGAUGGAACGGGCAGCCAUCGCCGGAUAGCCGCAAGAUUGAAUAGAGAUGCAGGAACUGUCAACCUACCUGUAAAA,29,13,25,18,85
8671,0,URS0000D6727F_999411/1-83,GUUUUUUAAGGAUAGAAAGGCUUCUAUCACGCUACAAUCAAGUAGUUGCCAGAGAUGUAGGGUACGCCGUCCUACUAUUUAAC,24,25,18,16,83
8672,0,URS0000D66CBE_12908/1-124,UGAAAUAGAGGUAGAAAAGGUUCUCUACACGCUUAGAUGCGUUAGGCAUAUGUCUUAUCUAAGUUACCAGAGAUGUGGGGAGGAAUGGAAUUUUCCACUCGUCAAUGCCGUCCCACCUAUUUCA,35,36,29,24,124
8673,0,URS0000D682C6_12908/1-81,GCUACUCGAGGUAGACAAGGUUCUCUACACGCAACGUAAGUUGUUAUCAGGGAUGAAGGGUUGACCGUCCUUCCGGAUAGC,20,20,23,18,81
8674,0,URS0000D68D31_12908/1-81,GGUUAUUGAGGUAGAAAAGGUUCUCUACACGCUACGAGAGUAGUCAACAGAAAUGAAGGGUUUGCCGUCCUUCCUCUAGUC,22,22,21,16,81
8675,0,URS0000D6A71F_12908/1-81,GAUUAUUGAGGUAGAAAAGGUUCUCUACGCGCUACGAGAGUAGUUAACAGAAAUGAAGGGUUUGCCGUCCUUCCUUUAGUC,22,24,21,14,81
8676,0,URS0000D65C4C_12908/1-81,AGCUAUUGAGGUAGAAAAGGUUCUCUACACGCAACUUCGGUUGUUAUCAGAGAUGAGGGGUUGACCGUCCUUCCAAUAGCA,22,22,21,16,81
8677,0,URS0000D6D142_12908/1-109,AUUAAGAGAGGUGGAAAUAUGGACAUCCACAAGCCUUAUACCCUUUGGCAUUUAUGCAGGGCAGUAUUGGUAUAAGAGAGAUGCAGGGCGAGUCCUCCUGCCUCUUAAU,31,29,28,21,109
8678,0,URS0000D67992_527021/1-111,GACUGUUGAGGUAGAACAGGUAGCUACACGCUUGAAUAUGUAUUGAACAGUUCGAGUCUUAAAAAAAGCUUAAUUGCUAAGAGAUGCGGGAUUACCACCCCACCAACAGUC,37,27,25,22,111
8679,0,URS0000D6805D_1121865/1-86,AGGAAUAGAAGUAGAAAAAUAUCGGUCGCACACGCACCAAUUCGUUGGUAUCUGAGAGGUGGGGAAGGGCCGUCCCACCUAUUCCU,25,18,24,19,86
8680,0,URS0000D690BA_527021/1-85,UUUCAUAGAGGUAGACAAGGUUCUCUACACGCUUAGUAAUAACUAAGUCACCAGAGAUGAGGGAUAUGCCGACCCUCCUAUGAUA,27,22,18,18,85
8681,0,URS0000D68E76_541229/1-112,GAUCUUUGAGGUGGGAAAGGUUCCCCACGCGCUUAUCUAACCGCCGUUCUCAAGCAUUUGAUUGGCUAGGUAAGUUACCAGAGAUGUAGGAUACGCCGCCCUACCAACGAUC,27,28,28,29,112
